# Swedish multiwords (MWEs) used for chunking
#separatorRegExp=[\t;]
...	ELLIPS
. . .	ELLIPS
Bottniska viken	PM:NOM
Bottniska vikens	PM:GEN
Costa Rica	PM:NOM
Costa Ricas	PM:GEN
Dominikanska republiken	PM:NOM
Dominikanska republikens	PM:GEN
Förenade arabemiraten	PM:NOM
Förenade arabemiratens	PM:GEN
Falu frigymnasium	PM:NOM
Falu frigymnasiums	PM:GEN
Kap Verde	PM:NOM
Kap Verdes	PM:GEN
Los Angeles	PM:GEN
Los Angeles	PM:NOM
Lilla Edet	PM:NOM
Lilla Edets	PM:GEN
New York	PM:NOM
New Yorks	PM:GEN
Nya Zeeland	PM:NOM
Nya Zeelands	PM:GEN
San Francisco	PM:NOM
San Franciscos	PM:GEN
Sri Lanka	PM:NOM
Sri Lankas	PM:GEN
Sierra Leone	PM:NOM
Sierra Leones	PM:GEN
ad acta	AB
ad hoc	AB
ad notam	AB
aja baja	IN
au pair	NN:OF:SIN:NOM:UTR
au pairs	NN:OF:SIN:GEN:UTR
au pairen	NN:BF:SIN:NOM:UTR
au pairens	NN:BF:SIN:GEN:UTR
au pairer	NN:OF:PLU:NOM:UTR
au pairers	NN:OF:PLU:GEN:UTR
au pairerna	NN:BF:PLU:NOM:UTR
au pairernas	NN:BF:PLU:GEN:UTR
de facto	AB
en passant	NN:OF:SIN:NOM:UTR
en passants	NN:OF:SIN:GEN:UTR
en passanten	NN:BF:SIN:NOM:UTR
en passantens	NN:BF:SIN:GEN:UTR
en passanter	NN:OF:PLU:NOM:UTR
en passanters	NN:OF:PLU:GEN:UTR
en passanterna	NN:BF:PLU:NOM:UTR
en passanternas	NN:BF:PLU:GEN:UTR
mest gladfärgade	JJ:S:BF:M
hin håle	NN:OF:SIN:NOM:UTR
hin håles	NN:OF:SIN:GEN:UTR
hux flux	AB
in absurdum	AB
vice versa	AB

