amhainn=abhainn
amhainneanna=aibhneacha
Chóngo=Chongó
Cóngo=Congó
gCóngo=gCongó
fhéin=féin
drama=dráma
deán=déan
grádh=grá
ghrádh=ghrá
ngrádh=ngrá
bhúr=bhur
carta=cárta
charta=chárta
gcarta=gcárta
ata=atá
méan=meán
mhéan=mheán
leitir=litir
inne=inné
deire=deireadh
dheire=dheireadh
ndeire=ndeireadh
imeasc=i measc
éalódh=éalú
dhó=dó
damh=dom
cunta=cúnta
chunta=chúnta
gcunta=gcúnta
riabh=raibh|riamh
thairgeadh=tháirgeadh
stáid=staid
ruadh=rua
óm=ó mo
