# A POS tag dictionary that's used as an addition (or as a fix) to catalan.dict
# These words are candidates to be added (or fixed) in catalan.dict in the future
# File Encoding: UTF-8
# Format: fullform baseform postags (tab separated)
########## Dictionary fixes ##########
########## Additions ##########
Abramovich	Abramovich	NPCNSP0
Abramóvitx	Abramóvitx	NPCNSP0
Borodianka	Borodianka	NPCSG00
Butxa	Butxa	NPCSG00
CaixaForum	CaixaForum	NPMNO00
Cortázar	Cortázar	NPCNSP0
FreeHand	FreeHand	NPMSO00
Kaczynski	Kaczynski	NPCNSP0
Kaczyński	Kaczyński	NPCNSP0
Laclau	Laclau	NPCNSP0
Larousse	Larousse	NPCNO00
MWC	MWC	NPMSO00
Minnelli	Minnelli	NPCNSP0
Scholz	Scholz	NPCNSP0
W3C	W3C	NPMSO00
Wesley	Wesley	NPCNSP0
Zapata	Zapata	NPCNSN0
artisticoburocràtic	artisticoburocràtic	AQ0MS0
artisticoburocràtica	artisticoburocràtic	AQ0FS0
artisticoburocràtics	artisticoburocràtic	AQ0MP0
artisticoburocràtiques	artisticoburocràtic	AQ0FP0
artisticocultural	artisticocultural	AQ0CS0
artisticoculturals	artisticocultural	AQ0CP0
artisticodocumental	artisticodocumental	AQ0CS0
artisticodocumentals	artisticodocumental	AQ0CP0
artisticogastronòmic	artisticogastronòmic	AQ0CS0
artisticogastronòmics	artisticogastronòmic	AQ0CP0
artisticoindustrial	artisticoindustrial	AQ0CS0
artisticoindustrials	artisticoindustrial	AQ0CP0
artisticoliterari	artisticoliterari	AQ0MS0
artisticoliteraris	artisticoliterari	AQ0MP0
artisticoliterària	artisticoliterari	AQ0FS0
artisticoliteràries	artisticoliterari	AQ0FP0
artisticomercantil	artisticomercantil	AQ0CS0
artisticomercantils	artisticomercantil	AQ0CP0
artisticomusical	artisticomusical	AQ0CS0
artisticomusicals	artisticomusical	AQ0CP0
artisticopolític	artisticopolític	AQ0MS0
artisticopolítica	artisticopolític	AQ0FS0
artisticopolítics	artisticopolític	AQ0MP0
artisticopolítiques	artisticopolític	AQ0FP0
artisticopoètic	artisticopoètic	AQ0MS0
artisticopoètica	artisticopoètic	AQ0FS0
artisticopoètics	artisticopoètic	AQ0MP0
artisticopoètiques	artisticopoètic	AQ0FP0
artisticosocial	artisticosocial	AQ0CS0
artisticosocials	artisticosocial	AQ0CP0
augustiniana	augustinià	NCFS000
augustinianes	augustinià	NCFP000
augustinians	augustinià	NCMP000
compatrícia	compatrici	NCFS000
compatrícies	compatrici	NCFP000
ecoauditoria	ecoauditoria	NCFS000
ecoauditories	ecoauditoria	NCFP000
ecoblanqueig	ecoblanqueig	NCMS000
ecofeminista	ecofeminista	AQ0CS0
ecofeministes	ecofeminista	AQ0CP0
ecogestions	ecogestió	NCFP000
ecogestió	ecogestió	NCFS000
economicocomptable	economicocomptable	AQ0CS0
economicocomptables	economicocomptable	AQ0CP0
economicocultural	economicocultural	AQ0CS0
economicoculturals	economicocultural	AQ0CP0
economicofamiliar	economicofamiliar	AQ0CS0
economicofamiliars	economicofamiliar	AQ0CP0
economicofilosòfic	economicofilosòfic	AQ0MS0
economicofilosòfica	economicofilosòfic	AQ0FS0
economicofilosòfics	economicofilosòfic	AQ0MP0
economicofilosòfiques	economicofilosòfic	AQ0FP0
economicofinacer	economicofinacer	AQ0MS0
economicofinacera	economicofinacer	AQ0FS0
economicofinaceres	economicofinacer	AQ0FP0
economicofinacers	economicofinacer	AQ0MP0
economicogeogràfic	economicogeogràfic	AQ0MS0
economicogeogràfica	economicogeogràfic	AQ0FS0
economicogeogràfics	economicogeogràfic	AQ0MP0
economicogeogràfiques	economicogeogràfic	AQ0FP0
economicojurídic	economicojurídic	AQ0MS0
economicojurídica	economicojurídic	AQ0FS0
economicojurídics	economicojurídic	AQ0MP0
economicojurídiques	economicojurídic	AQ0FP0
economicomatrimonial	economicomatrimonial	AQ0CS0
economicomatrimonials	economicomatrimonial	AQ0CP0
economiconatural	economiconatural	AQ0CS0
economiconaturals	economiconatural	AQ0CP0
economicopoliticoadministratiu	economicopoliticoadministratiu	AQ0MS0
economicopoliticoadministratius	economicopoliticoadministratiu	AQ0MP0
economicopoliticoadministrativa	economicopoliticoadministratiu	AQ0FS0
economicopoliticoadministratives	economicopoliticoadministratiu	AQ0FP0
economicoproductiu	economicoproductiu	AQ0MS0
economicoproductius	economicoproductiu	AQ0MP0
economicoproductiva	economicoproductiu	AQ0FS0
economicoproductives	economicoproductiu	AQ0FP0
economicosociocultural	economicosociocultural	AQ0CS0
economicosocioculturals	economicosociocultural	AQ0CP0
ecoturístic	ecoturístic	AQ0MS0
ecoturística	ecoturístic	AQ0FS0
ecoturístics	ecoturístic	AQ0MP0
ecoturístiques	ecoturístic	AQ0FP0
elxana	elxà	FS
elxanes	elxà	FP
elxans	elxà	MP
elxà	elxà	MS
geograficoadministratiu	geograficoadministratiu	AQ0MS0
geograficoadministratius	geograficoadministratiu	AQ0MP0
geograficoadministrativa	geograficoadministratiu	AQ0FS0
geograficoadministratives	geograficoadministratiu	AQ0FP0
geograficocultural	geograficocultural	AQ0CS0
geograficoculturals	geograficocultural	AQ0CP0
geograficoeconòmic	geograficoeconòmic	AQ0MS0
geograficoeconòmica	geograficoeconòmic	AQ0FS0
geograficoeconòmics	geograficoeconòmic	AQ0MP0
geograficoeconòmiques	geograficoeconòmic	AQ0FP0
geograficohistòric	geograficohistòric	AQ0MS0
geograficohistòrica	geograficohistòric	AQ0FS0
geograficohistòrics	geograficohistòric	AQ0MP0
geograficohistòriques	geograficohistòric	AQ0FP0
geograficopolític	geograficopolític	AQ0MS0
geograficopolítica	geograficopolític	AQ0FS0
geograficopolítics	geograficopolític	AQ0MP0
geograficopolítiques	geograficopolític	AQ0FP0
geograficoterritorial	geograficoterritorial	AQ0CS0
geograficoterritorials	geograficoterritorial	AQ0CP0
gigafactoria	gigafactoria	NCFS000
gigafactories	gigafactoria	NCFP000
historicoal·legòric	historicoal·legòric	AQ0MS0
historicoal·legòrica	historicoal·legòric	AQ0FS0
historicoal·legòrics	historicoal·legòric	AQ0MP0
historicoal·legòriques	historicoal·legòric	AQ0FP0
historicoambiental	historicoambiental	AQ0CS0
historicoambientals	historicoambiental	AQ0CP0
historicoanecdòtic	historicoanecdòtic	AQ0MS0
historicoanecdòtica	historicoanecdòtic	AQ0FS0
historicoanecdòtics	historicoanecdòtic	AQ0MP0
historicoanecdòtiques	historicoanecdòtic	AQ0FP0
historicoarquitectònic	historicoarquitectònic	AQ0MS0
historicoarquitectònica	historicoarquitectònic	AQ0FS0
historicoarquitectònics	historicoarquitectònic	AQ0MP0
historicoarquitectòniques	historicoarquitectònic	AQ0FP0
historicoarxivístic	historicoarxivístic	AQ0MS0
historicoarxivística	historicoarxivístic	AQ0FS0
historicoarxivístics	historicoarxivístic	AQ0MP0
historicoarxivístiques	historicoarxivístic	AQ0FP0
historicobibliogràfic	historicobibliogràfic	AQ0MS0
historicobibliogràfica	historicobibliogràfic	AQ0FS0
historicobibliogràfics	historicobibliogràfic	AQ0MP0
historicobibliogràfiques	historicobibliogràfic	AQ0FP0
historicobiològic	historicobiològic	AQ0MS0
historicobiològica	historicobiològic	AQ0FS0
historicobiològics	historicobiològic	AQ0MP0
historicobiològiques	historicobiològic	AQ0FP0
historicocientífic	historicocientífic	AQ0MS0
historicocientífica	historicocientífic	AQ0FS0
historicocientífics	historicocientífic	AQ0MP0
historicocientífiques	historicocientífic	AQ0FP0
historicocognitiu	historicocognitiu	AQ0MS0
historicocognitius	historicocognitiu	AQ0MP0
historicocognitiva	historicocognitiu	AQ0FS0
historicocognitives	historicocognitiu	AQ0FP0
historicocomparatiu	historicocomparatiu	AQ0MS0
historicocomparatius	historicocomparatiu	AQ0MP0
historicocomparativa	historicocomparatiu	AQ0FS0
historicocomparatives	historicocomparatiu	AQ0FP0
historicocomunitari	historicocomunitari	AQ0MS0
historicocomunitaris	historicocomunitari	AQ0MP0
historicocomunitària	historicocomunitari	AQ0FS0
historicocomunitàries	historicocomunitari	AQ0FP0
historicoconstructiu	historicoconstructiu	AQ0MS0
historicoconstructius	historicoconstructiu	AQ0MP0
historicoconstructiva	historicoconstructiu	AQ0FS0
historicoconstructives	historicoconstructiu	AQ0FP0
historicocrític	historicocrític	AQ0MS0
historicocrítica	historicocrític	AQ0FS0
historicocrítics	historicocrític	AQ0MP0
historicocrítiques	historicocrític	AQ0FP0
historicodescriptiu	historicodescriptiu	AQ0MS0
historicodescriptius	historicodescriptiu	AQ0MP0
historicodescriptiva	historicodescriptiu	AQ0FS0
historicodescriptives	historicodescriptiu	AQ0FP0
historicodoctrinal	historicodoctrinal	AQ0CS0
historicodoctrinals	historicodoctrinal	AQ0CP0
historicodocumental	historicodocumental	AQ0CS0
historicodocumentals	historicodocumental	AQ0CP0
historicodogmàtic	historicodogmàtic	AQ0MS0
historicodogmàtica	historicodogmàtic	AQ0FS0
historicodogmàtics	historicodogmàtic	AQ0MP0
historicodogmàtiques	historicodogmàtic	AQ0FP0
historicoeducatiu	historicoeducatiu	AQ0MS0
historicoeducatius	historicoeducatiu	AQ0MP0
historicoeducativa	historicoeducatiu	AQ0FS0
historicoeducatives	historicoeducatiu	AQ0FP0
historicoestructural	historicoestructural	AQ0CS0
historicoestructurals	historicoestructural	AQ0CP0
historicoetnogràfic	historicoetnogràfic	AQ0MS0
historicoetnogràfica	historicoetnogràfic	AQ0FS0
historicoetnogràfics	historicoetnogràfic	AQ0MP0
historicoetnogràfiques	historicoetnogràfic	AQ0FP0
historicoevolutiu	historicoevolutiu	AQ0MS0
historicoevolutius	historicoevolutiu	AQ0MP0
historicoevolutiva	historicoevolutiu	AQ0FS0
historicoevolutives	historicoevolutiu	AQ0FP0
historicofantàstic	historicofantàstic	AQ0MS0
historicofantàstica	historicofantàstic	AQ0FS0
historicofantàstics	historicofantàstic	AQ0MP0
historicofantàstiques	historicofantàstic	AQ0FP0
historicofilològic	historicofilològic	AQ0MS0
historicofilològica	historicofilològic	AQ0FS0
historicofilològics	historicofilològic	AQ0MP0
historicofilològiques	historicofilològic	AQ0FP0
historicofilosòfic	historicofilosòfic	AQ0MS0
historicofilosòfica	historicofilosòfic	AQ0FS0
historicofilosòfics	historicofilosòfic	AQ0MP0
historicofilosòfiques	historicofilosòfic	AQ0FP0
historicofolklòric	historicofolklòric	AQ0MS0
historicofolklòrica	historicofolklòric	AQ0FS0
historicofolklòrics	historicofolklòric	AQ0MP0
historicofolklòriques	historicofolklòric	AQ0FP0
historicogeogràfic	historicogeogràfic	AQ0MS0
historicogeogràfica	historicogeogràfic	AQ0FS0
historicogeogràfics	historicogeogràfic	AQ0MP0
historicogeogràfiques	historicogeogràfic	AQ0FP0
historicohumorístic	historicohumorístic	AQ0MS0
historicohumorística	historicohumorístic	AQ0FS0
historicohumorístics	historicohumorístic	AQ0MP0
historicohumorístiques	historicohumorístic	AQ0FP0
historicoidentitari	historicoidentitari	AQ0MS0
historicoidentitaris	historicoidentitari	AQ0MP0
historicoidentitària	historicoidentitari	AQ0FS0
historicoidentitàries	historicoidentitari	AQ0FP0
historicoideològic	historicoideològic	AQ0CS0
historicoideològics	historicoideològic	AQ0CP0
historicoinstitucional	historicoinstitucional	AQ0CS0
historicoinstitucionals	historicoinstitucional	AQ0CP0
historicojurídic	historicojurídic	AQ0MS0
historicojurídica	historicojurídic	AQ0FS0
historicojurídics	historicojurídic	AQ0MP0
historicojurídiques	historicojurídic	AQ0FP0
historicolegal	historicolegal	AQ0CS0
historicolegals	historicolegal	AQ0CP0
historicoliterari	historicoliterari	AQ0MS0
historicoliteraris	historicoliterari	AQ0MP0
historicoliterària	historicoliterari	AQ0FS0
historicoliteràries	historicoliterari	AQ0FP0
historicollegendari	historicollegendari	AQ0MS0
historicollegendaris	historicollegendari	AQ0MP0
historicollegendària	historicollegendari	AQ0FS0
historicollegendàries	historicollegendari	AQ0FP0
historicomemorístic	historicomemorístic	AQ0MS0
historicomemorística	historicomemorístic	AQ0FS0
historicomemorístics	historicomemorístic	AQ0MP0
historicomemorístiques	historicomemorístic	AQ0FP0
historicomilitar	historicomilitar	AQ0CS0
historicomilitars	historicomilitar	AQ0CP0
historicomitològic	historicomitològic	AQ0MS0
historicomitològica	historicomitològic	AQ0FS0
historicomitològics	historicomitològic	AQ0MP0
historicomitològiques	historicomitològic	AQ0FP0
historicomundial	historicomundial	AQ0CS0
historicomundials	historicomundial	AQ0CP0
historicomuseogràfic	historicomuseogràfic	AQ0MS0
historicomuseogràfica	historicomuseogràfic	AQ0FS0
historicomuseogràfics	historicomuseogràfic	AQ0MP0
historicomuseogràfiques	historicomuseogràfic	AQ0FP0
historicomèdic	historicomèdic	AQ0MS0
historicomèdica	historicomèdic	AQ0FS0
historicomèdics	historicomèdic	AQ0MP0
historicomèdiques	historicomèdic	AQ0FP0
historicomític	historicomític	AQ0MS0
historicomítica	historicomític	AQ0FS0
historicomítics	historicomític	AQ0MP0
historicomítiques	historicomític	AQ0FP0
historiconacional	historiconacional	AQ0CS0
historiconacionals	historiconacional	AQ0CP0
historiconatural	historiconatural	AQ0CS0
historiconaturals	historiconatural	AQ0CP0
historiconobiliari	historiconobiliari	AQ0MS0
historiconobiliaris	historiconobiliari	AQ0MP0
historiconobiliària	historiconobiliari	AQ0FS0
historiconobiliàries	historiconobiliari	AQ0FP0
historicopatriòtic	historicopatriòtic	AQ0MS0
historicopatriòtica	historicopatriòtic	AQ0FS0
historicopatriòtics	historicopatriòtic	AQ0MP0
historicopatriòtiques	historicopatriòtic	AQ0FP0
historicoperiodístic	historicoperiodístic	AQ0MS0
historicoperiodística	historicoperiodístic	AQ0FS0
historicoperiodístics	historicoperiodístic	AQ0MP0
historicoperiodístiques	historicoperiodístic	AQ0FP0
historicopolèmic	historicopolèmic	AQ0MS0
historicopolèmica	historicopolèmic	AQ0FS0
historicopolèmics	historicopolèmic	AQ0MP0
historicopolèmiques	historicopolèmic	AQ0FP0
historicopolític	historicopolític	AQ0MS0
historicopolítica	historicopolític	AQ0FS0
historicopolítics	historicopolític	AQ0MP0
historicopolítiques	historicopolític	AQ0FP0
historicopositiu	historicopositiu	AQ0MS0
historicopositius	historicopositiu	AQ0MP0
historicopositiva	historicopositiu	AQ0FS0
historicopositives	historicopositiu	AQ0FP0
historicopoètic	historicopoètic	AQ0MS0
historicopoètica	historicopoètic	AQ0FS0
historicopoètics	historicopoètic	AQ0MP0
historicopoètiques	historicopoètic	AQ0FP0
historicopsicològic	historicopsicològic	AQ0MS0
historicopsicològica	historicopsicològic	AQ0FS0
historicopsicològics	historicopsicològic	AQ0MP0
historicopsicològiques	historicopsicològic	AQ0FP0
historicoreligiosa	historicoreligiós	AQ0FS0
historicoreligioses	historicoreligiós	AQ0FP0
historicoreligiosos	historicoreligiós	AQ0MP0
historicoreligiós	historicoreligiós	AQ0MS0
historicoromàntic	historicoromàntic	AQ0MS0
historicoromàntica	historicoromàntic	AQ0FS0
historicoromàntics	historicoromàntic	AQ0MP0
historicoromàntiques	historicoromàntic	AQ0FP0
historicosalvífic	historicosalvífic	AQ0MS0
historicosalvífica	historicosalvífic	AQ0FS0
historicosalvífics	historicosalvífic	AQ0MP0
historicosalvífiques	historicosalvífic	AQ0FP0
historicosimbòlic	historicosimbòlic	AQ0MS0
historicosimbòlica	historicosimbòlic	AQ0FS0
historicosimbòlics	historicosimbòlic	AQ0MP0
historicosimbòliques	historicosimbòlic	AQ0FP0
historicosociològic	historicosociològic	AQ0MS0
historicosociològica	historicosociològic	AQ0FS0
historicosociològics	historicosociològic	AQ0MP0
historicosociològiques	historicosociològic	AQ0FP0
historicotemporal	historicotemporal	AQ0CS0
historicotemporals	historicotemporal	AQ0CP0
historicoterritorial	historicoterritorial	AQ0CS0
historicoterritorials	historicoterritorial	AQ0CP0
historicourbana	historicourbà	AQ0FS0
historicourbanes	historicourbà	AQ0FP0
historicourbans	historicourbà	AQ0MP0
historicourbà	historicourbà	AQ0MS0
jedi	jedi	NCCN000
juridicoassessor	juridicoassessor	AQ0MS0
juridicoassessora	juridicoassessor	AQ0FS0
juridicoassessores	juridicoassessor	AQ0FP0
juridicoassessors	juridicoassessor	AQ0MP0
juridicocivil	juridicocivil	AQ0CS0
juridicocivils	juridicocivil	AQ0CP0
juridicoconstitucional	juridicoconstitucional	AQ0CS0
juridicoconstitucionalista	juridicoconstitucionalista	AQ0CS0
juridicoconstitucionalistes	juridicoconstitucionalista	AQ0CP0
juridicoconstitucionals	juridicoconstitucional	AQ0CP0
juridicoconsultiu	juridicoconsultiu	AQ0MS0
juridicoconsultius	juridicoconsultiu	AQ0MP0
juridicoconsultiva	juridicoconsultiu	AQ0FS0
juridicoconsultives	juridicoconsultiu	AQ0FP0
juridicodisciplinari	juridicodisciplinari	AQ0MS0
juridicodisciplinaris	juridicodisciplinari	AQ0MP0
juridicodisciplinària	juridicodisciplinari	AQ0FS0
juridicodisciplinàries	juridicodisciplinari	AQ0FP0
juridicoeclesiàstic	juridicoeclesiàstic	AQ0MS0
juridicoeclesiàstica	juridicoeclesiàstic	AQ0FS0
juridicoeclesiàstics	juridicoeclesiàstic	AQ0MP0
juridicoeclesiàstiques	juridicoeclesiàstic	AQ0FP0
juridicofamiliar	juridicofamiliar	AQ0CS0
juridicofamiliars	juridicofamiliar	AQ0CP0
juridicofilosòfic	juridicofilosòfic	AQ0MS0
juridicofilosòfica	juridicofilosòfic	AQ0FS0
juridicofilosòfics	juridicofilosòfic	AQ0MP0
juridicofilosòfiques	juridicofilosòfic	AQ0FP0
juridicofinancer	juridicofinancer	AQ0MS0
juridicofinancera	juridicofinancer	AQ0FS0
juridicofinanceres	juridicofinancer	AQ0FP0
juridicofinancers	juridicofinancer	AQ0MP0
juridicoformal	juridicoformal	AQ0CS0
juridicoformals	juridicoformal	AQ0CP0
juridicogenealògic	juridicogenealògic	AQ0MS0
juridicogenealògica	juridicogenealògic	AQ0FS0
juridicogenealògics	juridicogenealògic	AQ0MP0
juridicogenealògiques	juridicogenealògic	AQ0FP0
juridicointernacional	juridicointernacional	AQ0CS0
juridicointernacionals	juridicointernacional	AQ0CP0
juridicolegislatiu	juridicolegislatiu	AQ0MS0
juridicolegislatius	juridicolegislatiu	AQ0MP0
juridicolegislativa	juridicolegislatiu	AQ0FS0
juridicolegislatives	juridicolegislatiu	AQ0FP0
juridicolingüístic	juridicolingüístic	AQ0MS0
juridicolingüística	juridicolingüístic	AQ0FS0
juridicolingüístics	juridicolingüístic	AQ0MP0
juridicolingüístiques	juridicolingüístic	AQ0FP0
juridicomaterial	juridicomaterial	AQ0CS0
juridicomaterials	juridicomaterial	AQ0CP0
juridicomercantil	juridicomercantil	AQ0CS0
juridicomercantils	juridicomercantil	AQ0CP0
juridicomilitar	juridicomilitar	AQ0CS0
juridicomilitars	juridicomilitar	AQ0CP0
juridicopolicíac	juridicopolicíac	AQ0MS0
juridicopolicíaca	juridicopolicíac	AQ0FS0
juridicopolicíacs	juridicopolicíac	AQ0MP0
juridicopolicíaques	juridicopolicíac	AQ0FP0
juridicoprivada	juridicoprivat	AQ0FS0
juridicoprivades	juridicoprivat	AQ0FP0
juridicoprivat	juridicoprivat	AQ0MS0
juridicoprivats	juridicoprivat	AQ0MP0
juridicoprocessal	juridicoprocessal	AQ0CS0
juridicoprocessals	juridicoprocessal	AQ0CP0
juridicopúblic	juridicopúblic	AQ0MS0
juridicopública	juridicopúblic	AQ0FS0
juridicopúblics	juridicopúblic	AQ0MP0
juridicopúbliques	juridicopúblic	AQ0FP0
juridicoreligiosa	juridicoreligiós	AQ0FS0
juridicoreligioses	juridicoreligiós	AQ0FP0
juridicoreligiosos	juridicoreligiós	AQ0MP0
juridicoreligiós	juridicoreligiós	AQ0MS0
juridicosacerdotal	juridicosacerdotal	AQ0CS0
juridicosacerdotals	juridicosacerdotal	AQ0CP0
juridicosocial	juridicosocial	AQ0CS0
juridicosocials	juridicosocial	AQ0CP0
juridicoteològic	juridicoteològic	AQ0MS0
juridicoteològica	juridicoteològic	AQ0FS0
juridicoteològics	juridicoteològic	AQ0MP0
juridicoteològiques	juridicoteològic	AQ0FP0
lacrosse	lacrosse	NCMS000
patrícia	patrici	NCFS000
patrícies	patrici	NCFP000
politicoartístic	politicoartístic	AQ0MS0
politicoartística	politicoartístic	AQ0FS0
politicoartístics	politicoartístic	AQ0MP0
politicoartístiques	politicoartístic	AQ0FP0
politicoburgesa	politicoburgès	AQ0FS0
politicoburgeses	politicoburgès	AQ0FP0
politicoburgesos	politicoburgès	AQ0MP0
politicoburgès	politicoburgès	AQ0MS0
politicoburgés	politicoburgès	AQ0MS0
politicoburocràtic	politicoburocràtic	AQ0MS0
politicoburocràtica	politicoburocràtic	AQ0FS0
politicoburocràtics	politicoburocràtic	AQ0MP0
politicoburocràtiques	politicoburocràtic	AQ0FP0
politicocadministratiu	politicocadministratiu	AQ0MS0
politicocadministratius	politicocadministratiu	AQ0MP0
politicocadministrativa	politicocadministratiu	AQ0FS0
politicocadministratives	politicocadministratiu	AQ0FP0
politicocientífic	politicocientífic	AQ0MS0
politicocientífica	politicocientífic	AQ0FS0
politicocientífics	politicocientífic	AQ0MP0
politicocientífiques	politicocientífic	AQ0FP0
politicocivil	politicocivil	AQ0CS0
politicocivils	politicocivil	AQ0CP0
politicocomercial	politicocomercial	AQ0CS0
politicocomercials	politicocomercial	AQ0CP0
politicocomunicatiu	politicocomunicatiu	AQ0MS0
politicocomunicatius	politicocomunicatiu	AQ0MP0
politicocomunicativa	politicocomunicatiu	AQ0FS0
politicocomunicatives	politicocomunicatiu	AQ0FP0
politicoconstitucional	politicoconstitucional	AQ0CS0
politicoconstitucionals	politicoconstitucional	AQ0CP0
politicodemocràtic	politicodemocràtic	AQ0MS0
politicodemocràtica	politicodemocràtic	AQ0FS0
politicodemocràtics	politicodemocràtic	AQ0MP0
politicodemocràtiques	politicodemocràtic	AQ0FP0
politicodinàstic	politicodinàstic	AQ0MS0
politicodinàstica	politicodinàstic	AQ0FS0
politicodinàstics	politicodinàstic	AQ0MP0
politicodinàstiques	politicodinàstic	AQ0FP0
politicodiplomàtic	politicodiplomàtic	AQ0MS0
politicodiplomàtica	politicodiplomàtic	AQ0FS0
politicodiplomàtics	politicodiplomàtic	AQ0MP0
politicodiplomàtiques	politicodiplomàtic	AQ0FP0
politicoeclesiàstic	politicoeclesiàstic	AQ0MS0
politicoeclesiàstica	politicoeclesiàstic	AQ0FS0
politicoeclesiàstics	politicoeclesiàstic	AQ0MP0
politicoeclesiàstiques	politicoeclesiàstic	AQ0FP0
politicoeconomicosocial	politicoeconomicosocial	AQ0CS0
politicoeconomicosocials	politicoeconomicosocial	AQ0CP0
politicoemocional	politicoemocional	AQ0CS0
politicoemocionals	politicoemocional	AQ0CP0
politicoempresarial	politicoempresarial	AQ0CS0
politicoempresarials	politicoempresarial	AQ0CP0
politicoesportiu	politicoesportiu	AQ0MS0
politicoesportius	politicoesportiu	AQ0MP0
politicoesportiva	politicoesportiu	AQ0FS0
politicoesportives	politicoesportiu	AQ0FP0
politicoestatal	politicoestatal	AQ0CS0
politicoestatals	politicoestatal	AQ0CP0
politicoestratègic	politicoestratègic	AQ0MS0
politicoestratègica	politicoestratègic	AQ0FS0
politicoestratègics	politicoestratègic	AQ0MP0
politicoestratègiques	politicoestratègic	AQ0FP0
politicofamiliar	politicofamiliar	AQ0CS0
politicofamiliars	politicofamiliar	AQ0CP0
politicofilosòfic	politicofilosòfic	AQ0MS0
politicofilosòfica	politicofilosòfic	AQ0FS0
politicofilosòfics	politicofilosòfic	AQ0MP0
politicofilosòfiques	politicofilosòfic	AQ0FP0
politicofiscal	politicofiscal	AQ0CS0
politicofiscals	politicofiscal	AQ0CP0
politicogovernamental	politicogovernamental	AQ0CS0
politicogovernamentals	politicogovernamental	AQ0CP0
politicohistòric	politicohistòric	AQ0MS0
politicohistòrica	politicohistòric	AQ0FS0
politicohistòrics	politicohistòric	AQ0MP0
politicohistòriques	politicohistòric	AQ0FP0
politicoindustrial	politicoindustrial	AQ0CS0
politicoindustrials	politicoindustrial	AQ0CP0
politicojudicial	politicojudicial	AQ0CS0
politicojudicials	politicojudicial	AQ0CP0
politicoliterari	politicoliterari	AQ0MS0
politicoliteraris	politicoliterari	AQ0MP0
politicoliterària	politicoliterari	AQ0FS0
politicoliteràries	politicoliterari	AQ0FP0
politicomafiosa	politicomafiós	AQ0FS0
politicomafioses	politicomafiós	AQ0FP0
politicomafiosos	politicomafiós	AQ0MP0
politicomafiós	politicomafiós	AQ0MS0
politicomoral	politicomoral	AQ0CS0
politicomorals	politicomoral	AQ0CP0
politicomunicipal	politicomunicipal	AQ0CS0
politicomunicipals	politicomunicipal	AQ0CP0
politicomusical	politicomusical	AQ0CS0
politicomusicals	politicomusical	AQ0CP0
politicomusicològic	politicomusicològic	AQ0MS0
politicomusicològica	politicomusicològic	AQ0FS0
politicomusicològics	politicomusicològic	AQ0MP0
politicomusicològiques	politicomusicològic	AQ0FP0
politicoorganitzatiu	politicoorganitzatiu	AQ0MS0
politicoorganitzatius	politicoorganitzatiu	AQ0MP0
politicoorganitzativa	politicoorganitzatiu	AQ0FS0
politicoorganitzatives	politicoorganitzatiu	AQ0FP0
politicopatriòtic	politicopatriòtic	AQ0MS0
politicopatriòtica	politicopatriòtic	AQ0FS0
politicopatriòtics	politicopatriòtic	AQ0MP0
politicopatriòtiques	politicopatriòtic	AQ0FP0
politicoracial	politicoracial	AQ0CS0
politicoracials	politicoracial	AQ0CP0
politicoreformista	politicoreformista	AQ0CS0
politicoreformistes	politicoreformista	AQ0CP0
politicoretòric	politicoretòric	AQ0MS0
politicoretòrica	politicoretòric	AQ0FS0
politicoretòrics	politicoretòric	AQ0MP0
politicoretòriques	politicoretòric	AQ0FP0
politicorevolucionari	politicorevolucionari	AQ0MS0
politicorevolucionaris	politicorevolucionari	AQ0MP0
politicorevolucionària	politicorevolucionari	AQ0FS0
politicorevolucionàries	politicorevolucionari	AQ0FP0
politicosanitari	politicosanitari	AQ0MS0
politicosanitaris	politicosanitari	AQ0MP0
politicosanitària	politicosanitari	AQ0FS0
politicosanitàries	politicosanitari	AQ0FP0
politicosatíric	politicosatíric	AQ0MS0
politicosatírica	politicosatíric	AQ0FS0
politicosatírics	politicosatíric	AQ0MP0
politicosatíriques	politicosatíric	AQ0FP0
politicosemàntic	politicosemàntic	AQ0MS0
politicosemàntica	politicosemàntic	AQ0FS0
politicosemàntics	politicosemàntic	AQ0MP0
politicosemàntiques	politicosemàntic	AQ0FP0
politicosexual	politicosexual	AQ0CS0
politicosexuals	politicosexual	AQ0CP0
politicosimbòlic	politicosimbòlic	AQ0MS0
politicosimbòlica	politicosimbòlic	AQ0FS0
politicosimbòlics	politicosimbòlic	AQ0MP0
politicosimbòliques	politicosimbòlic	AQ0FP0
politicosocietari	politicosocietari	AQ0MS0
politicosocietaris	politicosocietari	AQ0MP0
politicosocietària	politicosocietari	AQ0FS0
politicosocietàries	politicosocietari	AQ0FP0
politicotelevisiu	politicotelevisiu	AQ0MS0
politicotelevisius	politicotelevisiu	AQ0MP0
politicotelevisiva	politicotelevisiu	AQ0FS0
politicotelevisives	politicotelevisiu	AQ0FP0
politicoteològic	politicoteològic	AQ0MS0
politicoteològica	politicoteològic	AQ0FS0
politicoteològics	politicoteològic	AQ0MP0
politicoteològiques	politicoteològic	AQ0FP0
politicouniversitari	politicouniversitari	AQ0MS0
politicouniversitaris	politicouniversitari	AQ0MP0
politicouniversitària	politicouniversitari	AQ0FS0
politicouniversitàries	politicouniversitari	AQ0FP0
politicourbanístic	politicourbanístic	AQ0MS0
politicourbanística	politicourbanístic	AQ0FS0
politicourbanístics	politicourbanístic	AQ0MP0
politicourbanístiques	politicourbanístic	AQ0FP0
politicoètic	politicoètic	AQ0MS0
politicoètica	politicoètic	AQ0FS0
politicoètics	politicoètic	AQ0MP0
politicoètiques	politicoètic	AQ0FP0
portadista	portadista	NCCS000
portadistes	portadista	NCCP000
postpèrdua	postpèrdua	AQ0CN0
postpèrdua	postpèrdua	NCFS000
prestissimo	prestissimo	RG
romeva	romeu	NCFS000
romeves	romeu	NCFP000
superdona	superdona	NCFS000
superdones	superdona	NCFP000
superfantàstic	superfantàstic	AQ0MS0
superfantàstica	superfantàstic	AQ0FS0
superfantàstics	superfantàstic	AQ0MP0
superfantàstiques	superfantàstic	AQ0FP0
supermicrobi	supermicrobi	NCMS000
supermicrobis	supermicrobi	NCMP000
ultrasecret	ultrasecret	AQ0MS0
ultrasecreta	ultrasecret	AQ0FS0
ultrasecretes	ultrasecret	AQ0FP0
ultrasecrets	ultrasecret	AQ0MP0
ésAdir	ésAdir	NPMSO00
