caiteamh=caitheamh
Tang=An Teanga
Virgo=Maighdean
Pentateuch=Peintiteoch
Knock=An Cnoc
Kilreekil=Cill Rícill
colas=eolas
taistriúchán=t-aistriúchán
Maori=Maorach
Manulla=Maigh Nulla
Glencar=Gleann Chárthaigh|Gleann an Chairthe
Gaelgeoirí=Gaeilgeoirí
sochreite=sochreidte
suimuil=suimiúil
Corroy=Corr Ráithe
speisealta=speisialta
praicticiúil=praiticiúil
Scottish=Na hAlbanaigh
afháil=a fháil
Trion=An Trian
Kilcommon=Cill Chuimín
Rinnafarset=Rinn na Feirste
Minos=Míonós
Inch=An Inis|Inse
Ballynahinch=Baile na hInse
Roundstone=Cloch na Rón
Argos=Argas
Aghnacliff=Achadh na Cloiche
Torah=Tórá
Sneferu=Sneifearú
Pollux=Pollacs
Glenisland=Gleann Aoláin
Boghadoon=Both an Dúin
Emlaghmore=An tImleach Mór
Tuosist=Tuath Ó Siosta
Guernsey=Geansaí
Curraghroe=An Currach Rua
Piraeus=Pioraes
Feiriste=Feirste
Cranny=An Chrannaigh
Drumgeely=Drom Gaibhle
Loughduff=An Lathaigh Dhubh
Kilmorna=Coill Mhaonaigh
Anthesteria=Antaistéiria
Loughlinn=Loch Glinne
Tartary=An Tartair
Scylla=Sciolla
Sinai=Síonáí
Gondwanaland=Gonduanalainn
Carrowbeby=Ceathrú Bheithí
Ballinafad=Béal an Átha Fada
corfhocal=corrfhocal
Exchequer=Státchiste
anamh=annamh
Camp=An Com
Anglophone=Béarlóir
Rosmore=Ros Mór
godriopásach=go driopásach
fadbhreathnaiteach=fadbhreathnaitheach
aimisigh=aimsigh
Zealand=An tSéalainn
Lycia=An Licia
Banba=Banbha
Ballintogher=Baile an Tóchair
Milltown=Baile an Mhuilinn
Titus=Tiotas
Ennisitimon=Inis Díomáin
Crossreagh=An Chros Riabhach
Iphitus=Ífiteas
Shanvaus=An Seanmhás
Fenian=Fínín
Doonogan=Dún Ógáin
Rhodes=Ródas
Sophocles=Sofaicléas
Kabardino-Balkaria=Cabairdín-Bhalcáir
anmhór=an-mhór
Britain=An Bhreatain
Tooreen=An Tuairín
Pleiades=An Phléadach|An Streoillín|An Tréidín|An tÉillín
Cliffony=Cliafuine
Guinea-Bissau=Guine Bhissau
Astarte=Astarta
Derryvohy=Doire Bhoithe
Tagheen=Teach Chaoin
moráis=mór-ais
gaeltachta=Gaeltachta
inaghaidh=in aghaidh
Killeagh=Cill Ia
Goidel=Gael
Corrandulla=Cor an Dola
Newtownpark=Páirc an Bhaile Nua
Longwood=Maigh Dearmhaí
Scots=Béarla na hAlban
Chechnya=Seisnia
Euridanus=Eoradánas
aistriúchá=aistriúchán
Kiltormer=Cill Tormóir
Glenvar=Gleann Bhairr
Skull=An Scoil
Oceania=An Aigéine
Borris=An Bhuiríos
Christianity=Críostaíocht|Críostúlacht
Ballinameen=Béal an Átha Mín
Killour=Cill Odhar
Toormore=An Tuar Mór
Glenderry=Gleann Doire
ginerálta=ginearálta
Ballymitty=Baile Uí Mhitigh
Ballycarra=Baile na Cora
Aghavas=Achadh an Mheasa
Antioch=Aintíoc
Sarajevo=Sairéavó
Cepheus=Ceiféas
Crossdoney=Cros Domhnaigh
Amulius=Amúileas
amáin=amháin
Antilles=Aintillí|Na hAintillí
Dowth=Dubhadh
Letterbarra=Leitir Beara
doman=domhan
Basutoland=An Bhasútlainn
Ballybrack=An Baile Breac
gaeltachtaí=Gaeltachtaí
Rangoon=Rangún
Halloween=Oíche Shamhna
Dolla=An Doladh
Venus=Véineas
Capewell=Tobar an Chaipín
Kilbrogan=Cill Brógáin
Inchicore=Inse Chór
Lissardagh=Lios Ardachaidh
Gaelige=Gaeilge
Canterbury=Cantarbaraí
Lixnaw=Leic Snámha
Cloonlara=Cluain Lára
Turkestan=An Turcastáin
Liscasey=Lios Uí Chathasaigh
Mastergeehy=Máistir Gaoithe
Cothon=Cotón
Raheens=Na Ráithíní
Glasnevin=Glasnaíon
Dunaff=Dún Damh
Mantua=An Móinteach
Aristophanes=Arastofainéas
Doonsallagh=Dún Salach
Olympiad=Oilimpiad
Pythia=Pitia
Kincaslough=Cionn Caslach
gael=Gael
Unionhall=Bréantrá
Raheen=An Ráithín
Poles=Na Pollaí
Aughrim=Eachroim
Woodford=An Ghráig
Kildare=Cill Dara
teilfís=teilifís
Gaius=Gáias
Communion=Comaoin
Carrickaboy=Carraigigh Bhuí
Loughros=Luacharos
Pope=Pápa
Galbally=An Gallbhaile
Dane=Danar
saigdiúirí=saighdiúirí
Silesia=An tSiléis
bfhuil=bhfuil
nahÉireann=na hÉireann
Templeshanbo=Teampall Seanbhoth
Doogary=An Dúgharraí
Rhodesia=An Róidéis
Friesland=An Fhreaslainn
speárbhean=spéirbhean
Tiberius=Tibéirias
Newtowncunningham=An Baile Nua
Romulus=Rómalas
Rathlin=Reachlainn
Burnfoot=Bun na hAbhann
ionnannas=ionannas
Nurney=An Urnaí
Latin=Laidin
braonín=braonán
Milestone=Cloch an Mhíle
oscalite=oscailte
specialta=speisialta
Napoleon=Napóilean
Culleens=Na Coillíní
Portnoo=Port Nua
Rylane=Réileán
Cloverhill=Droim Caiside
Lyceum=Licéam
Carlingford=Cairlinn
Merrion=Muirfin
Ballynaclogh=Baile na Cloiche
Dunlewy=Dún Lúiche
Caherconlish=Cathair Chinn Lis
taire=tAire
Killea=Cill Shléibhe
Abdera=Aibdéire
Lettermullan=Leitir Mealláin
achmhainn=acmhainn
contac=contae
bhaintamach=bhaint amach
Carrigatogher=Carraig an Tóchair
Shronowen=Srón Abhann
Nakhichevan=An Nacaiseaváin
Ummoon=Iomún
Bellacorick=Béal Átha Chomhraic
Killyneill=Coill Uí Néill
Drumandoora=Drom an Dúdhoire
Mercury=Mearcair
Killinick=Cill Fhionnóg
Caribbean=An Mhuir Chairib
Moldavia=An Mholdáiv
comhgairdeas=comhghairdeas
Theseus=Téiséas
Lucretius=Lúicréitias
Ballycolla=Baile Cholla
Antichrist=Ainchríost
Strand=An Trá
Epiphany=Eipeafáine|Lá Chinn|Lá Nollag Beag
Beltane=Bealtaine
Cromane=An Cromán
tabairt=tabhairt
Irishwoman=Gael
Croesus=Créasas
Annestown=Bun Abha
Menkaure=Meancabhra
Svein=Sveidhn
Kilrane=Cill Ruáin
Cashmere=An Chaismír
Agamemnon=Agaimeimneon
Toomard=Tuaim Ard
Timor=Tíomór
Rathkenny=Ráth Cheannaigh
Kincon=Cionn Con
Belderg=Béal Deirg
Saar=Sár
Lavagh=Leamhach
Kerry=Ciarraí
Flanders=Flóndras
Clonegall=Cluain na nGall
Ballyhugh=Bealach Aodha
Martinstown=Baile Mháirtín
arsa'n=arsa an
Conghial=Conghail
agaidh=aghaidh
Castile=An Chaistíl
Azores=Oileáin Asóir
Blacksod=An Fód Dubh
Tourmakeady=Tuar Mhic Éadaigh
Glentogher=Gleann Tóchair
ionnanais=ionannais
Glantane=An Gleanntán
Boherlahan=An Bóthar Leathan
Croom=Cromadh
Greenans=Na Grianáin
Ballyhoge=Baile Uí Cheog
Enlightenment=Eagnaíocht|Soilsiú
taon=t-aon
deirneach=deireanach
Inishfree=Inis Fraoigh
Uranus=Úránas
éireann=Éireann
Dartrey=Dartraí
Garranard=Garrán Ard
Renaissance=Athbheochan
Lauragh=An Láithreach
Chrommyum=Cróimiam
Carrowbeg=An Cheathrú Bheag
Admete=Aidméité
Zaire=An tSáír|Poblacht Dhaonlathach an Chongó
NuaGhaeilge=Nua-Ghaeilge
Kilfree=Cill Fraoigh
Avoca=Abhóca
Carthage=An Chartaig
beagánín=beagáinín
Ballinaclashet=Baile na Claise
Vice-Chancellor=Leas-Seansailéir
Mullinacuff=Muileann Mhic Dhuibh
Templeogue=Teach Mealóg
Ryefield=Achadh an tSeagail
ariam=riamh
macnamh=machnamh
bhaineannle=bhaineann le
Toornafulla=Tuar na Fola
achh=ach
Karelia=An Chairéil
eolaíchta=eolaíochta
Hapy=Hapaí
Herdsman=Aoire
ainilís=anailís
Pict=Piocht
Hannibal=Hannabal
Autonoe=Átanae
Gàidhlige=Gaeilge na hAlban
Wilkinstown=Baile Uilcín
túdarás=t-údarás
Ballysadare=Baile Easa Dara
October=Deireadh Fómhair|Mí Dheireadh Fómhair
Dromina=Drom Aidhne
Kilmanahan=Cill Mainchín
Tullycoe=Tulaigh Chuach
Colehill=Cnoc na Góla
chonachtas=chonacthas
Imhotep=Imeotap
Templemartin=Teampall Mártan
infhilte=infhillte
Areopagus=Cnoc Airéis
Hadrian=Haidrian
Aquarius=Iompróir an Uisce|Uisceadóir
Knockalisheen=Cnoc an Lisín
Buryatia=Buiriáit
lenan-áirítear=lena n-áirítear
Knockmore=An Cnoc Mór
feidm=feidhm
Lisacul=Lios an Choill
Kilmeage=Cill Maodhóg
Bogay=Both Ghé
Coroibus=Coróbas
Boherboy=An Bóthar Buí
Khufu=Cúfú
Brahman=Bráman
grinneal=grinneall
Ballyvaghan=Baile Uí Bheacháin
Feohanagh=An Fheothanach
téan=t-éan
Killucan=Cill Liúcainne
borann=borrann
Killerrig=Cill Dheirge
Antarctica=An Antartaice
seachtainiúl=seachtainiúil
Patagonia=An Phatagóin
Clonbulloge=Cluain Bolg
Buddha=Búda
Gaeilgoirí=Gaeilgeoirí
iarriadh=iarraidh
Rosslare=Ros Láir
Monilea=An Muine Liath
cadé=cad é
Whitsun=An Chincís
Pantheon=Paintéón
Achonry=Achadh Conaire
Lattin=Laitean
Kilmurvy=Cill Mhuirbhigh
Hanoi=Hanáí
Gortgarrigan=Gort Geargáin
Carrigrohane=Carraig Ruacháin
néiríonn=n-éiríonn
Juno=Iúnó
Furies=Fúire
tháinigh=tháinig
Drumanespick=Droim an Easpaig
Fennor=Fionnúir
Kilbrackan=Coill Bhreacán
Calcutta=Calcúta
Fivealley=An Chúirt
neamhghlaolmhara=neamhghaolmhara
Ballinagleragh=Baile na gCléireach
Brasil=An Bhrasaíl
chomhmaith=chomh maith
Keel=An Caol
Corriga=Carraigigh
Scartaglen=Scairteach an Ghlinne
Millford=Baile na nGallóglach
toideachas=t-oideachas
Killadoon=Coill an Dúin
bfhéidir=b'fhéidir
Gibraltar=Giobráltar
Roscahill=Ros Cathail
Hestia=Heistia
Fennagh=Fionnmhach
Coolea=Cúil Aodha
Repeal=Reipéil
Welsh=Breatnaigh
Park=An Pháirc
Templeorum=Teampall Fhothram
Sothis=Sótas
Augustine=Agaistín
Cloonfallagh=Cluain Falach
Tonregee=Tóin re Gaoth
nuir=nuair
Kilflyn=Cill Flainn
aithine=aithne
Inisheer=Inis Oírr
néirí=n-éirí
Midfield=An Trian Láir
Ballinasloe=Béal Átha na Sluaighe
riomphost=ríomhphost
Kilfinnane=Cill Fhíonáin
Twomileborris=Buiríos Léith
bliantiúil=bliantúil
Lyra=Lir
Angelus=Fáilte an Aingil
Screen=An Scrín
gobhfuil=go bhfuil
Apollo=Apaill|Apolló
Bunnyconnellan=Muine Chonalláin
Iarchonnachta=Iar-Chonnachta
Donadea=Domhnach Dheá
mileanna=milleanna
ao'chor=aon chor
Sionnaine=Sionainne
aus=agus
Bishopstown=Baile an Easpaig
d'aineoinn=d'ainneoin
Down=An Dún
oiliúnt=oiliúint
O'Briensbridge=Droichead Uí Bhriain
Catalonia=An Chatalóin
Menlough=Mionlach
Lucifer=Lúicifir
Roonagh=Rú an Átha
Drumakill=Droim na Coille
Summerhill=Cnoc an Línsigh
fuarathas=fuarthas
Inishcrone=Inis Crabhann
Burren=Boirinn
Sabbatarian=Sabóidire
Breaghwy=Bréachmhaigh
Spáinis=Spáinnis
Iberia=An Ibéir
Annagary=Anagaire
fe=faoi
Camross=Camros
Aretus=Airéiteas
Ovens=Na hUamhanna
Odysseus=Odaiséas
feidhmniú=feidhmiú
eacnamíocht=eacnamaíocht
Carran=An Carn
Boru=Bóirmhe
Kylemore=An Choill Mhóir
Charybdis=Cairíbdis
agá=ag a
ambeidh=a mbeidh
Meenlaragh=Mín Lárach
Callownamuck=Caladh na Muc
Kesh=An Chéis
Rome=An Róimh
Stentor=Steintear
Saxony=An tSacsain
polatúil=polaitiúil
brothal=brothall
Lisserlough=Liosar Locha
Darius=Dáirias
asholáthar=a sholáthar
Ballyroan=Baile Átha an Róine
Killybrone=Coillidh Brón
Ratharney=Rath Fhearna
Dostyevsky=Dostaighéavscaí
Ballymote=Baile an Mhóta
Hippolyte=Hipilité
Wolfhill=Cnocán na Mactíre
Hinduism=Hiondúchas
Taurus=Tarbh
Finea=Fiodh an Átha
athbreithniú=athbhreithniú
December=Mí na Nollag|Nollaig
Lima=Líoma
Bweeng=Na Boinn
Cappadocia=An Chapadóic|Chapadóic
Polyphemus=Polaiféamas
Glencairn=Baile an Gharráin
Udmurt=Udmairt
Killateeaun=Coill an tSiáin
adhmhála=admhála
Ljubljana=Liúibleána
chualthas=chualathas
Loki=Láca
difiriúil=difriúil
Alcoran=Córan
Minorca=Mionarca
Ballygawley=Baile Uí Dhálaigh
oiriúnt=oiriúint
Murneen=Muirnín
samradh=samhradh
Rosakill=Ros na Cille
n'eiri=n-éirí
Islandbridge=Droichead na hInse
Drumfree=Droim Fraoigh
Orangeman=Fear Buí
Brownstown=Baile an Bhrúnaigh
Kilmainham=Cill Mhaighneann
Colmanstown=Baile Uí Chlúmháin
Arabia=An Araib
Ceres=Ceiréas
compháirtíochta=comhpháirtíochta
Kiribati=Cireabaití
Bosporus=An Bosparas
Requiem=Aifreann na marbh|Aifreann éagnairce
Niasaland=An Niasalainn
Kilworth=Cill Uird
Ballytruckle=Baile Throcail
Carrickroe=An Charraig Rua
Pharaoh=Faró|Forann
Kilranelagh=Cill Rannaileach
Border=Teorainn
tiocfadh=thiocfadh
Clontuskert=Cluain Tuaiscirt
oifigúil=oifigiúil
Ardmore=Aird Mhór
Carrowkeel=An Cheathrú Chaol
Candlemas=Lá Fhéile Muire na gCoinneal
deontaisi=deontais
Upperchurch=An Teampall Uachtarach
Linos=Lineas
Tahiti=Taihítí
Coolrain=Cúil Ruáin
Abderus=Aibdéireas
Tawny=An Tamhnaigh
Poulanargid=Poll an Airgid
Loughmoe=Luachma
Neptune=Neiptiún
Colchis=Coilcís
Greencastle=An Caisleán Nua
Whiteboy=Buachaill Bán
Denreenargan=Doirín Argan
Hellenic=Heilléinic
Tullycoly=Tulaigh an Chuaille
Derrada=Doire Fhada
comhgairdeachas=comhghairdeas
Castlefreke=Ráth an Bharraigh
Aquila=Iolar
innui=inniu
Bohemia=An Bhoihéim
túdar=t-údar
Ardcrony=Ard Cróine
Lombardy=An Lombaird
Kerensky=Ceireinscí
Reformation=Reifirméisean
Corrofin=Cora Finne
Ballybrophy=Baile Uí Bhróithe
Templar=Teamplóir
Tomhaggard=Teach Moshagard
Fairymount=Mullach na Sí
Zeus=Séas
Tedavnet=Tigh Damhnata
inúchadh=iniúchadh
Clovis=Clóvas
Wikipedian=Vicipéideoir
Gaelicization=Gaelú
Hindustan=Hiondustáin
Ballynoe=An Baile Nua
Tobercurry=Tobar an Choire
fadthéarmach=fadtéarmach
Pisces=Éisc
dechuid=de chuid
Carrigans=An Carraigín
codhladh=codladh
Greenanstown=Baile Uí Ghrianáin
Attimachugh=Ait Tí Mhic Aodha
Ringsend=An Rinn
Bacchus=Bacais|Bacas
Oechalia=Éacail
Ostend=Ostainn
Gobi=Góibí
Bothermore=An Bóthar Mór
Bhutan=An Bhútáin
Calydon=Caladón
Ballymagan=Baile Mhic Cionaoith
Bashkir=Baiscír
Germanic=Gearmáinic
Londonderry=Doire
Corlismore=Corrlios Mór
Fardrum=Fardroim
Carrick=An Charraig
Khentika=Ceintice
Arctic=An tArtach
Whig=Fuig
Caheragh=Cathrach
Olympia=Oilimpia
reamhrádh=réamhrá
Dunsany=Dún Samhnaí
dhruite=dhruidte
Knockanillaun=Cnoc an Oileáin
Amosis=Amósas
diuitethe=diúitéithe
Mallaranny=An Mhala Raithní
héireann=hÉireann
noileán=n-oileán
Geb=Geib
teatarc=teatrarc
Mercator=Mearcatór
churchun=chur chun
Currabeha=An Chorr Bheithe
Baluchistan=An Bhalúcastáin
Doocastle=Caisleán an Dumha
Farranree=Fearann an Rí
Losset=An Losaid
Andes=Na hAindéis
Killaloe=Cill Dalua
Bunnahowen=Bun na hAbhna
Kilclone=Coill Chluana
Camolin=Cam Eolaing
Narmer=Narmar
Manila=Mainile
inscine=inscne
feicail=feiceáil
Ballyheelan=Bealach an Chaoláin
comphobail=comhphobail
Sahara=An Sahára
Maghery=An Machaire
Durrow=Darú
Midwest=Meán-Iarthar
denamh=déanamh
arfad=ar fad
xéareáise=xéaráise
Rathkea=Ráth Cae
Kilmactranny=Cill Mhic Treana
Pyrenees=Na Piréiní
Bithynia=An Bhitín
Crossmaglen=Crois Mhic Lionnáin
aguis=agus
Ballymaconry=Baile Conraoi
Knockvicar=Cnoc an Bhiocáire
Drummullin=Droim an Mhuilinn
Hekat=Heiceat
Ardlougher=Ard Luachra
tráthclár=tráthchlár
Gaeilgoir=Gaeilgeoir
Gurmukhi=Gurmúcaí
scátheagra=scátheagraíocht
Darndale=Darndál
Cloghboley=Clochbhuaile
Eucharist=Eocairist
Clonskeagh=Cluain Sceach
Stonyford=Áth Stúin
Fybagh=An Fhadhbach
Zeeland=An tSéalainn
Somaliland=An tSomáil
Beograd=Béalgrád
Clarina=Clár Aidhne
Kilroosky=Coill na Rúscaí
Napoléon=Napóilean
Euclid=Eoiclídéas
Fivemilebourne=Abhainn an Chartúin
Grange=An Ghráinseach
Hollyford=Áth an Chuilinn
Spa=An Spá
sciomram=sciomraím
igcrích=i gcrích
Gallimh=Gaillimh
Rosmackowen=Ros Mhic Eoghain
Barnatra=Barr na Trá
Killegar=Coill an Ghairr
Keadew=Céideadh
fobairt=forbairt
achmhainní=acmhainní
Shangarry=An Seangharraí
Srah=An tSraith
pictuir=pictiúr
Alcmene=Ailcméiné
Python=Píotón
Achill=Acaill
Aghatubrid=Achadh Tiobraid
Checkpoint=Pointe na Síge
Rover=Ródaí
Clonalvy=Cluain Ailbhe
Templederry=Teampall Doire
Europe=An Eoraip|Mór-Roinn
tarringím=tarraingím
Sulawesi=An tSulaivéis
Grenagh=Greanach
ostáin=óstlainne|óstlanna
agusan=agus an
Laurencetown=An Baile Mór
beathnaiséisí=beathaisnéisí
Hathor=Határ
Coolkenna=Cúil Uí Chionaoith
Orchardton=Baile an Úlloird
Lisgrea=Lios Cré
amlaidh=amhlaidh
Connemara=Conamara
Curacao=Curasao
Polaris=An Réalta Thuaidh
Togher=An Tóchar
Baugi=Babhgaí
Artemis=Artaimís
Kilmacud=Cill Mochuda
fondúireac=fondúireacht
Xenophon=Seineafón
Meanus=Méanas
tairring=tarraing
amhráinni=amhráin
Killoscully=Cill Ó Scolaí
larua=iaró
cóireál=cóireáil
madir=maidir
miliún=milliún
Killann=Cill Anna
Ballybeg=An Baile Beag
doicméid=doiciméid
Aeacus=Aecas
taispeán=taispeáin
Gilgamesh=Giolgamais
Tibet=An Tibéid
Sagitta=Saighde|Saighead
Castlecoote=Baile Mhic Oireachtaigh
Yakutsk=Iacútsc
Oeneus=Éinéas
Quixote=Cíochótae
Ballindangan=Baile an Daingin
Ballymaourly=Baile Mhic Thorlaigh
Utopia=Útóipe
Kilsallaghan=Cill Shalcháin
Saturn=Satarn
Corsica=An Chorsaic
Glooskap=Glúscap
t'fhios=tá a fhios
tiomlán=t-iomlán
Dromard=An Droim Ard
spesialta=speisialta
Ballyneety=Baile an Fhaoitigh
Connaught=Connacht
July=Iúil|Mí Iúil
Cloonloogh=Cluain Lua
Cloghore=Cloich Óir
Idumea=An Iodúimé
ilgnéitheach=ilghnéitheach
Glencolumkille=Gleann Cholm Cille
measíní=meaisíní
Culfadda=Coill Fhada
Crosserlough=Crois ar Loch
Reens=Roighne
Doohat=Dútháite
Sappho=Safó
Lissinagroagh=Lisín na gCruach
Kilrean=Cill Riáin
teaghmáil=teagmháil
chuigan=chuig an
Andromeda=Andraiméide
Czechoslovakia=An tSeicslóvaic
Dromkeen=Drom Caoin
Wellingtonbridge=Droichead Eoin
Ossetia=Óiséit
Inishbiggle=Inis Bigil
Annayalla=Eanaigh Gheala
Dring=Droing
Shantonagh=Seantonnach
Messiah=Meisias
Gusserane=Ráth na gCosarán
Marshalstown=Baile Mharascail
Curreeny=Na Coirríní
Cupid=Cúipid
Cornwall=Corn na Breataine
Aherlow=Eatharlach
Minoan=Mionóch
Caherdavin=Cathair Dháibhín
bhíuil=bhfuil
Capparoe=An Cheapach Rua
sábáilte=sábháilte
Kilcotty=Cill Chota
céadatán=céatadán
riomphoist=ríomhphoist
tríthí=trithí|tríthi
Pleiads=An Phléadach|An Streoillín|An Tréidín|An tÉillín
Hera=Héara|Héire
Coolock=An Chúlóg
Ballaghkeen=An Bealach
Ballynagore=Béal Átha na nGabhar
frid=tríd
Wiktionary=Vicífhoclóir
Karakalpak=Cara-Chalpáic
Brownsgrove=Ceathrú na Lathaí
Aughnasheelan=Achadh na Síleann
Dunglow=An Clochán Liath
Chaffpool=Loch na Cáithe
Corrawaleen=Corr an Mhailín
Bactria=Baictria
Epimetheus=Eipiméitéas
Manetho=Manató
Cortown=An Baile Corr
Lisdeen=Lios Duibhinn
Cloghjordan=Cloch Shiurdáin
Dromore=An Droim Mór
Drimoleague=Drom dhá Liag
Drumacrib=Droim Mhic Roib
toileán=t-oileán
Tullynahinnera=Tulaigh na hInneora
Gormanston=Baile Mhic Gormáin
Khons=Cons
Bechuanaland=An Bheachuanlainn
Kinsalebeg=Baile an Phoill
Derrylane=Doire Leathan
Italic=Iodáilic
Mogeely=Maigh Dhíle
Crusades=Cogaí na Croise
Gortaroo=Gort an Rú
polatíocht=polaitíocht
Rathdrum=Ráth Droma
afhorbairt=a fhorbairt
Srahmore=An Srath Mór
Demosthenes=Déamóstainéas
lonsaí=ionsaí
Inishbofin=Inis Bó Finne
Kilconly=Cill Chonla
Curraglass=Cora Ghlas
Gattabaun=An Geata Bán
Broadhaven=Cnocán na Líne
Gogol=Gógoil
Correllstown=Baile Mhic Cearúill
treor=treoir
Audumla=Ódamla
Innisfail=Inis Fáil
Scythia=Scitia
Kinvarra=Cinn Mhara
Johnstown=Baile Eoin|Baile Sheáin|Cill Sheanaigh
Brideswell=Tobar Bríde
Derrynacaheragh=Doirín na Cathrach
éirinn=Éirinn
Anubis=Anúbas
Chiron=Céarón
Delhi=Deilí
compléasc=coimpléasc
ceistenna=ceisteanna
Christmas=Lá Nollag|Nollaig
Merikare=Meireacara
Hesperides=Heispirídí
Leckemy=Leic Éime
Gaothdobhair=Gaoth Dobhair
Glenmore=An Gleann Mór
Tashkent=Taiscint
chuichí=cluichí
Balder=Baldar
Kilcarn=Cill an Chairn
Chernobyl=Searnóbail
adhéanamh=a dhéanamh
August=Lúnasa|Mí Lúnasa
Clonfinlough=Cluain Fionnlocha
Kilross=Cill Ros
Tirol=An Tioróil
Scorpio=Scairp
Bahamas=Na Bahámaí
Sirius=Réalta an Mhadra
Haulbowline=Inis Sionnach
Quakers=Cumann na gCairde
Eastertide=Cáisc
Capricorn=Gabhar
déirigh=d'éirigh
Kilronan=Cill Rónáin
Rumania=An Rómáin
Fore=Baile Fhobhair
Gaelic=Gaeilge na hAlban
Tonyduff=An Tonnaigh Dhubh
Garvagh=Garbhach
Ladon=Ladóin
Donaghmoyne=Domhnach Maighean
Glenealy=Gleann Fhaidhle
Knockalough=Cnoc an Locha
Curraghboy=An Currach Buí
Rathluirc=An Ráth
Nofret=Nofrat
Saturnalia=Féile Satairn
Killinardrish=Cill an Ard-dorais
Ballymackey=Baile Uí Mhacaí
Knockatallan=Cnoc an tSalainn
Aghinagh=Achadh Fhíonach
Ballycogly=Baile Uí Choigligh
Dunmore=Dún Mór
anbhródúil=an-bhródúil
Breenagh=Na Bruíneacha
Keimaneigh=Céim an Fhia
Glenmaquin=Gleann Mhic Coinn
Ghàidhlig=Ghaeilge na hAlban
Ferns=Fearna
Calypso=Cailíopsó
fresin=freisin
Sonvolaun=Sanúlán
chuna=chun a
Damocles=Dámaicléas
cuirdach=cuardach
Hephaestus=Héafaestas
haithle=aithle
Ballyduff=An Baile Dubh
Urhin=Iorthan
Septuagesima=Seaptuaigéas
Duagh=Dubháth
Erythia=Eirit
Augustus=Águstas
Jenkinstown=Baile Sheinicín|Corclach
bliaintúil=bliantúil
Narcissus=Nairciseas
Dromin=Droim Ing
Chuvash=An tSuvais
feistisí=feisteas
Saturday=Satharn
nathruithe=n-athruithe
daois=d'aois
Tallow=Tulach an Iarainn
nadaoine=na daoine
Carlanstown=Droichead Chearbhalláin
Anguilla=Angaíle
Errislanan=Iorras Fhlannáin
Bunnacurry=Bun an Churraigh
Mornington=Baile Uí Mhornáin
Butlerstown=Baile an Bhuitléaraigh
coimpléasach=coimpléascach
Rahan=Raithean
Manius=Máinias
tóstóir=t-óstóir
Nicippe=Nicipé
Newry=Iúr Chinn Trá
Ballydahin=Baile Dáithín
Dunany=Dún Áine
tuarim=tuairim
Bogota=Bogatá
babhtha=babhta
Evenor=Eiveanóir
Aurelius=Áiréilias
deréir=de réir
Twomilehouse=Teach an dá Mhíle
Kindrum=Cionn Droma
Ballysakeery=Baile Easa Caoire
Francophone=Frainciseoir
imo=i mo
Celebes=An Cheilibéis|An tSulaivéis
Cahermore=Cathair Mhór
tángadar=thángadar
Whitechurch=An Teampall Geal
déanmh=déanamh
Minoa=Mionó
said=siad
Malin=Málainn
Clonea=Cluain Fhia
Draco=Dragan
Cinderella=Luaithríona
Houy=Húí
Sennedjem=Seinnidim
imhe=inmhe
Lathnamard=Leacht na mBard
Iolaus=Ialás
Hogmanay=Oíche Chinn Bhliana
aimn=ainm
Hawaii=Haváí
Lissatava=Lios an tSamhaidh
Lisnageer=Lios na gCaor
Caher=An Chathair
Inishkeen=Inis Caoin
Pliny=Plinias
Ares=Airéas|Airéis
Gortnahoo=Gort na hUamha
figúirí=figiúirí
ngairthí=ngairtí
Garrydoolis=Garraí Dúlas
pagh=pá
Carrigkerry=Carraig Chiarraí
Lerna=Leirné
Dnieper=An Dnípir
Indus=An Iondúis
Augeas=Áigéas|Áigéis
Scramoge=Scramóg
Donnycarney=Domhnach Cearna
Siberia=An tSibéir
Ignatius=Iognáid
Labrador=Labradar
Latinist=Laidineoir
Ballingarrane=Baile an Gharráin
Olympics=Cluichí Oilimpeacha
d'féadfadh=d'fhéadfadh
Kilshanny=Cill Seanaigh
Celadon=Cheileadóin
másé=más é
Vesuvius=Veasúiv
Tasmania=An Tasmáin
Tunis=Túinis
Carrigahorig=Carraig an Chomhraic
Clones=Cluain Eois
Connamara=Conamara
Cloghbrack=An Chloch Bhreac
noibríonn=n-oibríonn
Shannakae=Seanachae
Mulhuddart=Mullach Eadrad
measín=meaisín
cadiad=cad iad
Caherdaniel=Cathair Dónall
Stillorgan=Stigh Lorgan
Coole=An Chúil
aineoinn=ainneoin
Reykjavik=Réicivíc
comisiún=coimisiún
bfuil=bhfuil
Scandinavia=Lochlainn
Ballineen=Béal Átha Fhínín
stratéis=straitéis
Chaldea=Caildé
April=Aibreán|Mí Aibreáin
Lurga=An Lorgain
Jesus=Íosa
neascleanúint=nascleanúint
gaeilge=Gaeilge
fadbhanna=fadhbanna
Constantine=Chonstaintín|Constaintín
Bunane=An Bunán
Mauricemills=Muilte Mhuiris
Autolycus=Átailíceas
ofigiúil=oifigiúil
Cameroons=Camarúin
Cuilmore=An Choill Mhór
statistic=staitistic
Taliban=Talaban
Owning=Ónainn
infrastruchtúr=infreastruchtúr
Roman=Rómhánach
Bucharest=Búcairist
Atlantis=Atlantas
Muhamad=Mahamad
Cromwell=Chromail|Cromail
Statius=Stáitias
Carrickboy=An Charraig Bhuí
Brannockstown=Baile na mBreatnach
Walderstown=Baile Bháltair
Tutankhamon=Tútancáman
Pegasus=Peigeasas
Ymir=Ímir
taitheantas=t-aitheantas
Slade=An Slaod
Ballybane=Baile Bán
comisinéir=coimisinéir
Juvenal=Iúvanal
roint=roinnt
tádh=t-ádh
leathnach=leathanach
máithair=máthair
Thracia=An Tráicia
Clonkeen=Cluain Chaoin
Termon=An Tearmann
Carrigan=An Carraigín
Michaelmas=Lá Fhéile Michíl
Cloonminda=Cluain Mionda
Screggan=An Screagán
Horace=Horás
Nereid=Néiriad
tríchasach=tríchosach
Newinn=Loch Ceann
nn=ann
Convoy=Conmhaigh
Ballinfull=Baile an Phoill
Kampuchea=An Champúis
Shaker=Séicire
Monday=Luan
Sthenelus=Steinileas
Crucifixion=Céasadh
Persia=An Pheirs
Greenland=An Ghraonlainn
núdarás=n-údarás
Rathcabban=Ráth Cabáin
morais=mór-ais
agom=agam
Finny=Fionnaithe
Mayfield=Baile na mBocht
England=Sasana
tairgead=t-airgead
coma=corna
Ceylon=An tSiolóin
Drummartin=Droim Máirtín
Loghill=Leamhchoill
Maecenas=Maecéanas
Bellanaboy=Béal Átha na Buí
achur=a chur
Ballycoog=Baile Chuag
aigneachtaí=aighneachtaí
Morocco=Maracó
Antaeus=Antaes
Gaelge=Gaeilge
Glennamaddy=Gleann na Madadh
Ballingarry=Baile an Gharraí
Peterswell=Tobar Pheadair
Monkstown=Baile an Mhanaigh|Baile na Manach
Dooagh=Dumha Acha
Nebamun=Neibeamún
Saladin=Saladan
Helvetia=An Eilvéis
Friday=Aoine
naisceanna=naisc
Longford=An Longfort
Baghdad=Bagdad
Maccabee=Macabaech
Newfield=An Pháirc Nua
Jupiter=Iúpatar
Brandrum=Bréandroim
Balrath=Baile na Rátha
Ahascragh=Áth Eascrach
Rathmullen=Ráth an Mhuilinn
Ovid=Oivid
Normandy=An Normainn
nábhar=n-ábhar
Moyasta=Maigh Sheasta
Tievemore=Taobh Mór
Cloonyquin=Cluain Uí Choinn
Idun=Íodan
nóa=nó a
Anascaul=Abhainn an Scáil
Coke=Cóc
Eyeries=Na hAoraí
Hades=Háidéas
Westmeath=An Iarmhí
Baily=Dún Criofainn
Bootes=Aoire
Bunbrosna=Bun Brosnaí
Dionysus=Diníosas|Diníseas
Ower=Odhar
Melanesia=An Mheilinéis
Oilgate=Maolán nGabhar
Leap=An Léim
Robinstown=Baile Roibín
nac=nach
Carrahan=Carrachán
neamsheasmhach=neamhsheasmhach
Rathtoe=Ráth Tó
Dunamon=Dún Iomáin
Rhone=An Róin
reáchtá=reáchtáil
héinní=haon ní
Leonidas=Leonadas
déanam=déanamh
Indian=Indiach Dearg
Cootehall=Uachtar Thíre
Aghadown=Achadh Dúin
Charioteer=Ara
Fordstown=Baile Forda
Clonlost=Cluain Loiste
Newtownsandes=Maigh Mheáin
Neale=An Éill
Hispaniola=Easpáinneoil
Geryon=Géarón
Ceannain=Ceanainn
Drumfin=Droim Fionn
athrisím=aithrisím
January=Eanáir|Mí Eanáir
Esker=An Eiscir
Chekhov=Tséachov
Oldtown=An Seanbhaile
bhfhearr=b'fhearr
Craggach=An Chreagach
Yugoslavia=An Iúgslaiv
Levally=An Leathbhaile
Cuchulainn=Chúchulainn|Cúchulainn
n'éirí=n-éirí
Jersey=Geirsí
Christmastide=Nollaig
abhfuil=a bhfuil
Bible=Bíobla
noidhreacht=n-oidhreacht
speisiúl=spéisiúil
Monasterboice=Mainistir Bhuithe
Portnablaha=Port na Bláiche
Templeboy=Teampall Baoith
Styx=Stiocs
Pentecost=An Chincís
corpoideadchas=corpoideachas
teilfíse=teilifíse
Mullan=An Muileann
Ballylar=Baile Láir
Wikipedia=Vicipéid
May=Bealtaine|Mí na Bealtaine
Hellenist=Gréagóir|Heilléanaí
arfáil=ar fáil
Ballysteen=Baile Stiabhna
Ballinlough=Baile an Locha
aran=ar an
Malayan=Malaech
Islam=Ioslam
Banemore=An Bán Mór
Astee=Eas Daoi
Culkeeny=Cúil Chaonaigh
Habháís=Haváis
Murntown=Baile Mhúráin
Plautus=Plátas
Beglieve=Beagshliabh
Charon=Carán
Absolute=Absalóid
Devil=An Boc Dubh|An Fear Mór|An Fear Thíos|An Giolla Goillín|An Mac Mallachta|An Seanbhoc|An Seanbhuachaill|An buachaill críonna|An fear dubh|An tAinspiorad|An tÁibhirseoir|Fear an Uabhair
isfearr=is fearr
Lisbealad=Lios Béalaid
Garranlahan=An Carrán Leathan
coinníolacha=coinníollacha
oired=oiread
Fortel=Foirtil
Ballymore=An Baile Mór
Grangebellew=Gráinseach an Dísirt
abhaineann=a bhaineann
Coolegreane=Cúl le Gréin
Teevurcher=Taobh Urchair
agsu=agus
Lyracrumpane=Ladhar an Chrompáin
Glenbrien=Gleann Bhriain
buachail=buachaill
isiad=is iad
Chuvashia=An tSuvais
agusna=agus na
tughta=tugtha
tearra=t-earra
Porturlin=Port Durlainne
leisan=leis an
Satan=An Boc Dubh|An Fear Mór|An Fear Thíos|An Giolla Goillín|An Mac Mallachta|An Seanbhoc|An Seanbhuachaill|An buachaill críonna|An fear dubh|An tAinspiorad|An tÁibhirseoir|Fear an Uabhair
Hydra=Hiodra
Bonalas=Bothailios
leisean=leis-sean
Holycross=Baile na gCailleach
a'bhfuil=an bhfuil
Anglo-Irishman=Gall-Ghael
Gaybrook=Baile Réamainn
Carragh=Ceárach
meastú=meas tú
pictuirí=pictiúir
Drung=Drong
Ballsbridge=Drochead na Dothra
Stroove=An tSrúibh
Wednesday=Céadaoin
Thoueris=Túiris
Bhoston=Bhostún
Nereus=Néiréas
agas=agus
téileamh=t-éileamh
Lackamore=An Leaca Mhór
Sagittarius=Saighdeoir
Muhammad=Mahamad
Haystown=Carn Ulfa
Iyneferty=Ínifirtí
Moira=Móire
fa=faoi
Barnesmore=An Bearnas Mór
Antarctic=An tAntartach
Ahmose=Amós
Orion=Oiríon
Bellanamore=Béal an Átha Móir
Wesport=Cathair na Mart
Puckaun=Pocán
Redcastle=Carraig Mhic Uidhilín
Belisarius=Beileasáirias
Clongoweswood=Coill Chluana Gabhann
cirghe=éirí
Salthill=Bóthar na Trá
Dovea=An Dubhfhéith
Lermontov=Léarmontov
Tooms=Tuaim
Faustalus=Fástalas
Tobinstown=Baile Tóibín
eicint=éigin
Wight=Iocht
sruchtúr=struchtúr
Brittany=An Bhriotáin
Assyria=An Aisiria
bheul=bhuel
Pompeii=Poimpé
gombeidh=go mbeidh
todchaí=todhchaí
gac=gach
Coolderry=Cúl Doire
Meenaneary=Mín an Aoire
aonduine=aon duine
Knocknagashel=Cnoc na gCaiseal
Sraheens=Na Sraithíní
Drumbane=An Drom Bán
Galicia=An Ghailís
Scardaun=Scardán
Hollycross=Mainistir na Croiche
Santiago=Saintiagó
Louvain=Lováin
Thames=An Tamais
Trajan=Tráian
Moneygashel=Muine na gCaiseal
Killinkere=Cillín Chéir
compháirtíocht=comhpháirtíocht
Carrowroe=An Cheathrú Rua
Artaine=Ard Aidhin
Indies=Indiacha
brioscáinphrátaí=brioscáin phrátaí
Laragh=Láithreach
Asia=An Áise
ainneoinn=ainneoin
Eurystheus=Eoraistéas
ars'an=arsa an
Clouncagh=Cluain Cath
d'thoil=do thoil
socraid=sochraid
Firbolgs=Fir Bolg
Tacatus=Tacatas
Attica=Aitice
Treasury=Státchiste
Madeira=Maidéara
Attanagh=Áth Tanaí
Rathféigh=Ráth Faiche
Derreen=Doirín
Triangulum=Triantán
Adrianople=Cathair Aidriain
Kilkerrin=Cill Choirín
agu=agus
Ramsgrange=An Ghráinseach
Drumcondra=Droim Conrach
Mullagh=An Mullach
Carracastle=Ceathrú an Chaisil
finiméin=feiniméin
coiteanta=coitianta
Drum=An Droim
Nuremberg=Nürnburg
Ballinunty=Baile an Fhantaigh
Archerstown=Baile an Airsirigh
Jutland=An Iútlainn
Kilnagross=Coill na gCros
Ballaghnatrillick=Béal Átha an Trí Liag
Herodotus=Heireadótas
innu=inniu
Police=Garda Síochána
Linus=Lineas
Peking=Béising|Péicing
Bistones=Biostónaigh
Eurovision=Eoraifís
Tangiers=Tainséir
síochán=síocháin
annocht=anocht
Carrowmenagh=Ceathrú Meánach
Lisnalong=Lios na Long
Dunleer=Dún Léire
Abkhaz=An Abcáis
Howth=Binn Éadair
coinceap=coincheap
Sharavogue=Searbhóg
Ballygarvan=Baile Garbháin
Doon=Dún
Davidstown=Baile Dháith
Skeaghvasteen=Sceach an Mhaistín
Kilsallagh=Coill Salach
Ulster=Cúige Uladh|Ulaidh
foglaim=foghlaim
Inishturk=Inis Toirc
Alsace=An Alsáis
Teerelton=Tír Eiltín
Glanworth=Gleannúir
Thanksgiving=Lá an Altaithe
Drumeague=Droim Éag
arlíne=ar líne
Cerberus=Ceirbearas
Russophile=Rúisbhách
antóir=an-tóir
fadbh=fadhb
Carlow=Ceatharlach
Apollonius=Apallóinias
Castletown=Baile an Chaisleáin
igcomhar=i gcomhar
gombeadh=go mbeadh
agur=agus
Cíochóité=Cíochótae
Fethard=Fiodh Ard
Elton=Eiltiún
Inchigeelagh=Inse Geimhleach
Moneygold=Muine Dhúltaigh
Killashandra=Cill na Seanrátha
Maddockstown=Baile Mhadóg
Rosmuck=Ros Muc
Achaean=Acaech
Mozambique=Mósaimbíc
Lough=Loch
ostán=óstlann
Berrings=Biorainn
dhaidh=dhiaidh
Hindu=Hiondúch
alán=a lán
Araglin=Airglinn
Whitegate=An Geata Bán
céana=céanna
Moneystown=An Muine
Cancer=Portán
Paibes=Péibéas
Carnnaross=Carn na Ros
Nazareth=Nasaireit
Moyglass=Maigh Ghlas
Ballymacart=Baile Mhac Airt
February=Feabhra|Mí Feabhra
Unionist=Aontachtaí
Killurin=Cill Iúirín|Cill Liúráin
Kiev=Cív
aigneachta=aighneachta
Tolstoy=Tolstóigh
t'eh=tá sé
Orthrus=Ortras
Coolbaun=An Cúl Bán
Scotch=Na hAlbanaigh
Strongbow=Strongbó
Bermudas=Na Beirmiúdaí
mismím=mismín
forim=foirm
Cecilstown=Baile an Bhriotaigh
carráid=earráid
Leghorn=Leigearn
tuaslaóir=tuaslagóir
Ballinure=Baile an Iúir
Hague=An Háig
Savitri=Saivitrí
anbhuíoch=an-bhuíoch
assin=as sin
mionshonraí=mionsonraí
Grangeford=An Ghráinseach
Judas=Iúdás
Bealin=Béal Linne
Sofia=Sóifia
Annunciation=Teachtaireacht an Aingil
Buri=Búirí
Bradocks=Na Bráideoga
Maynooth=Maigh Nuad
tiochfaidh=tiocfaidh
Corraneary=Corr an Aoire
Dardanelles=An Dardainéil
Gaelicizing=Gaelú
Saarland=Sárbruc
Babel=Báibil
Cappagh=An Cheapaigh
Mithras=Mitreas
Anglophile=Gallbhách
cile=eile
Leitrim=Liatroim
Bilboa=Biolbó
Caherelly=Cathair Ailí
cailte=caillte
Athene=Aitéiné
Sark=Sairc
laethaenta=laethanta
Commons=Na Coimíní
teaghmháil=teagmháil
dho=dó
Blackwater=An Abhainn Dubh
Kildorragh=Coill Dorcha
Meelin=An Mhaoilinn
Gemini=Cúpla
Dublin=Baile Átha Cliath
Rosemount=Baile an Bhric Óig
O'Callaghansmills=Muileann Uí Cheallacháin
Albion=An Bhreatain
Czar=Sár
Indochina=An Ind-Sín
rómhnic=rómhinic
Lacken=An Leacain
Greenan=An Grianán
Coolcullen=Cúl an Chuilinn
Normanach=Normannach
Faha=Faiche
God=An Fear Thuas|Dia
seoagus=seo agus
Gubaveeny=Gob an Mhianaigh
Inver=Inbhear
Ossian=Oisín
Silveracre=Acra an Airgid
suimúil=suimiúil
Vergil=Veirgil
Rathcool=Ráth Cúil
Lanesborough=Béal Átha Liag
Ballynacarrigy=Baile na Carraige
Clonrohid=Cluain Droichead
Mendeleev=Meindeiléiv
Garristown=Baile Gháire
Zambezi=An tSaimbéis
Killavil=Cill Fhábhail
Tarbert=Tairbeart
stráinséar=strainséir
Chair=Cathaoirleach
Mesopotamia=An Mheaspatáim
Zion=Sión
Coca-Cola=Cóc
Oedipus=Éideapús
Sami=Sáimis
feidhmeanmach=feidhmeannach
Trinidad=Oileán na Tríonóide
Sanskrit=Sanscrait
Saracen=Saraistín
Selloo=Suí Lú
bealtaine=Bealtaine
Kilmacanoge=Cill Mocheanóg
Stackallan=Stigh Colláin
Achilles=Aichill|Aicilléas
aigneacht=aighneacht
abheith=a bheith
Innfield=An Bóthar Buí
achinntiú=a chinntiú
Memphis=Meimfís
Brickeens=Na Broicíní
Doonaha=Dún Átha
ladh=1ú
Ulysses=Uiliséas
comisinéara=coimisinéara
Crookstown=An Baile Gallda
Andersonstown=Baile Andarsan
Lisduff=An Lios Dubh
Mediterranean=An Mheánmhuir
Himalayas=Himiléithe
Brurec=Brú Rí
Afro-Asiatic=Afra-Áisic
Levant=An Leiveaint
Sammarinese=San Mairíneach
tionad=t-ionad
Cacus=Cacas
Suttung=Sutang
dóthin=dóthain
bliaina=bliana
Cavangarden=Cabhán an Gharraí
tóstán=t-óstán
Demeter=Déiméatar
Hebe=Héibé
Rochestown=Baile an Róistigh
Speenoge=Spínnóg
náisúnta=náisiúnta
Ballinglen=Baile an Ghleanna
Australasia=An Astraláise
Devanagari=Déiveanágraí
Barbary=An Bharbair
Drummacool=Droim Mhic an Choill
anchuid=an-chuid
Colbinstown=Baile Choilbín
Easter=Cáisc
Runnaroddan=Roinn an Rodáin
trím=trí mo
talann=tallann
Ture=An tIúr
niliomad=n-iliomad
Ballinabrackey=Buaile na Bréachmhaí
druite=druidte
Gleneask=Gleann Iasc
Turkoman=Turcamáin
Ballyorgan=Baile Uí Argáin
Knockanevin=Cnocán Aoibhinn
Glenade=Gleann Éada
Galatia=An Ghaláit
Rossbeg=Ros Beag
ngíomh=ngníomh
araghaidh=ar aghaidh
Moluccas=Molacaí
Bethlehem=An Bheithil
Ballywilliam=Baile Liam
Meirceánach=Meiriceánach
Coolcarrigan=Cúil Charraigín
Ural=An Úrail
Miltown=Baile an Mhuilinn
Castlefinn=Caisleán na Finne
oidreacht=oidhreacht
Loughan=Lochán
Ballymurphy=Baile Uí Mhurchú
Doohooma=Dumha Thuama
Ardnaree=Ard na Ria
cinlae=cín lae
Killavally=Coill an Bhaile
Brownie=Brídín
Ballyglunin=Béal Átha Glúinín
Corrandrum=Cor an Droma
Pompey=Poimpéas
fluich=fliuch
Minerva=Mineirve
Aeolus=Aeólas
achmhainne=acmhainne
Taleban=Talaban
Alps=Alpa|Na hAlpa
Clonbern=Cluain Bheirn
Ghengis=Geingeas
Latinity=Laidineacht
comairle=comhairle
Burgundy=An Bhurgúin
Fingal=Fine Gall
Proserpine=Proiseirpine
Ballyfoyle=Baile an Phoill
Carrigtohill=Carraig Thuathail
difiriúla=difriúla
cinnitú=cinntiú
Electra=Éileictre
Tanganyika=An Tangainíc
bliadain=bliain
Sardinia=An tSairdín
Khunanpu=Cúnanpú
Slieveroe=Sliabh Rua
Hermes=Heirméas
Aeinéas=Aenéas
Crusade=Cogaí na Croise
Tulrohaun=Tulach Shrutháin
Cashelgarran=Caiseal an Ghearráin
Gracchi=Gracais
Freshford=Achadh Úr
Satyavan=Sáiteaván
Knockbrit=Cnoc an Bhriotaigh
comisiúin=coimisiúin
Kilmacsimon=Coill Mhic Shíomoin
Laurasia=An Labhráise
Diogenes=Deoiginéas
Rhineland=Dúiche na Réine
Rossadrehid=Ros an Droichid
asa=as a
Byelorussia=An Bhealarúis
cumacht=cumhacht
Carrickart=Carraig Airt
anaus=anuas
Cashelmore=An Caiseal Mór
Byblos=Bíoblós
Ballyfarnagh=Bealach Fearna
Kylebrack=An Choill Bhreac
Jehovah=Iáivé
Muff=Magh
Curraguneen=Currach Guinín
Hyllus=Hilleas
Ballyneill=Baile Uí Néill
Vatican=An Vatacáin
Muscat=Muscáit
pictúir=pictiúr
Tirida=Tiride
Aphrodite=Afradaíté
Mass=Aifreann
isí=is í
Portlaoise=Port Laoise
Euclides=Eoiclídéas
Inishboffin=Inis Bó Finne
Bellananagh=Béal Átha na nEach
Appalachians=Na Sléibhte Apaláiseacha
Africa=An Afraic
Triton=Tríotón
Ballon=Balana
Kilbarry=Cill Barra
Yemen=Éimin
feicéal=feiceáil
Tawnylea=Tamhnaí Liatha
nimeachtaí=n-imeachtaí
Strymon=Striomóin
sina=sin a
Cloghran=Clochrán
antábhachtach=an-tábhachtach
Kronos=Cronas
Eurytus=Eoratas
Kenamun=Ceineaman
Oldcastle=An Seanchaisleán
choích=choíche
Ballymanus=Baile Mhánais
einne=aon duine
agna=ag na
Kilmichael=Cill Mhichíl
Tallonstown=Baile an Tallúnaigh
Baleares=Na hOileáin Bhailéaracha
Desertserges=An Díseart
Christ=Críost
Medea=Méidia
bhuil=bhfuil
Ballypatrick=Baile Phádraig
tre=trí
neiri=n-éirí
c'ainm=cén t-ainm
Inishcarra=Inis Cara
Kilmead=Cill Míde
Rathmore=An Ráth Mhór
spriocdáta=spriocdháta
Kilmanagh=Cill Mhanach
mionshonra=mionsonra
daignithe=daingnithe
Rathmoyle=An Ráth Mhaol
tháing=tháinig
Ballinagar=Béal Átha na gCarr
Teye=Téighe
Cloontia=Na Cluainte
Lucian=Lúician
Octavian=Octáivian
Famine=Drochshaol|Gorta Mór
Ballynamona=Baile na Móna
Rathmines=Ráth Maonais
Orient=Oirthear
Aghnamullen=Achadh na Muilleann
Balyglass=An Baile Glas
griain=grian
Rathcore=Ráth Cuair
comphobal=comhphobal
Boeotia=An Bhéóitia
Ballynastangford=Baile na Stanfard
Ravensdale=Gleann na bhFiach
achmainn=acmhainn
Augean=Áigéis
Lammastide=Lá Lúnasa
Columbkille=Colmcille
saoriseoir=saoririseoir
Strahart=Sraith Airt
Inishmaan=Inis Meáin
adhmháil=admháil
cursíos=cur síos
Dernagree=Doire na Graí
Aries=Reithe
Cornafean=Corr na Féinne
Tantalus=Tantalas
glaochanna=glaonna
Moyne=An Mhaighean
Tagoat=Teach Gót
Euripides=Eoiripidéas
Turkmen=An Tuircméanastáin
Reanascreena=Rae na Scríne
soléir=soiléir
Lehinch=An Leacht
Donore=Dún Uabhair
Cleristown=Baile de Cléir
Columbine=Choluimbín|Coluimbín
Lisboduff=Lios Bó Dubh
Ballyclogh=Baile Cloch
Polydeuces=Polaideoicéis
Meenacross=Mín na Croise
Donoghmore=Domhnach Mór
Athena=Aitéiné|Ataene
anchabhrach=an-chabhrach
iniúcadh=iniúchadh
Uzbek=An Úisbéiceastáin
Chapeltown=An Caol
Elysium=Tír na nÓg|Éilísiam
Stranoodan=Sraith Nuadáin
Congo=An Congó|Poblacht an Chongó
Williamstown=Baile Liam
Kali=Cailí
Cloonkeevy=Cluain Ciabhaigh
Glenville=Gleann an Phréacháin
tuairiscthe=tuairiscithe
lomairín=iomairín
Grangemockler=Gráinseach Mhóicléir
nabliana=na bliana
Oldleighlin=Seanleithghlinn
Byzantium=An Bhiosáint
Guadeloupe=Guadalúip
Smarmore=Smearamair
Graniamore=Gráinne Mór
gailge=Gaeilge
Kazakstan=An Chasacstáin
Appenines=Na hAipiníní
Babylon=An Bhablóin
Ballymackney=Baile Macnaí
Liscarney=Lios Cearnaigh
Irishtown=An Baile Gaelach
tionscamh=tionscnamh
Drommahane=Drom Átháin
neamh-achmainn=neamhacmhainn
Garinish=Garinis
diploma=dioplóma
Beaufort=Lios an Phúca
Creaghanroe=Crícheán Rua
Nohaval=Nuachabháil
Recess=Sraith Salach
Barnycarroll=Bearna Chearúill
sainiúl=sainiúil
ríomhpost=ríomhphost
Knockainy=Cnoc Áine
Mohammad=Mahamad
Leamlara=Léim Lára
feicáil=feiceáil
Drumcask=Droim Cásca
oidreachta=oidhreachta
Orpheus=Oirféas
Toomyvara=Tuaim Uí Mheára
Bermuda=Beirmiúda|Na Beirmiúdaí
Errigal=Earagail
lompar=iompar
Gorteeny=Goirtíní
Turbot=Tairbeart
Wrexham=Wrecsam
leannúint=leanúint
Carrowmore=Ceathrú Mhór Leacan
aigesan=aigesean
Bracklyn=Breaclainn
Amsterdam=Amstardam
Foxfield=Cnocán an Mhada Rua
Bulgaden=Builgidín
Crimea=An Chrimé
taispáint=taispeáint
Ellistrin=Eileastran
Passionist=Páiseadóir
naistriú=n-aistriú
Clonakenny=Cluain Uí Chionaoith
aleanas=a leanas
Kinshasa=Cinseasa
Knockbrack=An Cnoc Breac
Dover=Dobhar
Ulstermen=Ulaidh|Ultaibh
Rinvyle=Rinn Mhaoile
Duamutef=Duamútaf
Moyvore=Maigh Mhórdha
Turlough=Turlach
Listowel=Lios Tuathail
Drangan=Drongán
Graigue=An Ghráig
mease=measc
Derrybrien=Daraidh Braoin
Talibaan=Talaban
Ballindoon=Baile an Dúin
Ladysbridge=Droichead na Scuab
Menander=Meineándar
Cloondaff=Cluain Damh
Remus=Réamas
Prometheus=Proiméitéas
dtína=dtí na
Ballinalack=Béal Átha na Leac
síntús=síntiús
Ballyhahill=Baile dhá Thuile
Moravia=An Mhoráiv
Farranhavane=Fearann Uí Chiabháin
agua=agus
Tullylease=Tulach Léis
Cleito=Cléató
Bree=Brí
Glendalough=Gleann dá Loch
níosmó=níos mó
Newmills=An Muileann Úr
Garryhill=An Gharbhchoill
gairthí=ghairtí
Auriga=Ara
Readypenny=Cillín Cúile
Askamore=An Easca Mhór
Abbeyleix=Mainistir Laoise
Castlerickard=Caisleán Riocaird
Apocalypse=Apacailipsis
Castleshane=Caisleán an tSiáin
Ballintober=Baile an Tobair
Coachford=Áth an Chóiste
Abbey=An Mhainistir
Bunnanaddan=Bun an Fheadáin
Morpheus=Moirféas
Killadysert=Cill an Dísirt
adhéanann=a dhéanann
Bretagne=An Bhriotáin
Kyoto=Kiótó
Knockanarrigan=Cnoc an Aragain
Tatar=Tatair
Cloonagh=Cluain Each
Ceryneia=Cheirin
grammadach=gramadach
Comptroller=Ard-Reachtaire
Danesfort=Dún Feart
Killinierin=Coill an Iarainn
alún=talún
coirpideachas=corpoideachas
Tubber=An Tobar
Rossmore=An Ros Mór
Pluto=Plútón
Amon-Re=Amón-Rá
aghlacadh=a ghlacadh
Killeenadeema=Cillín a Díoma
flaithiúl=flaithiúil
Janesboro=Baile Shinéad
dfhéidfeadh=d'fhéadfadh
Ballyheerin=Baile Uí Shírín
Pisidia=An Phisid
Madrid=Maidrid
Drumree=Droim Rí
illdaite=ildathach
Ballymoney=Baile Muine
sanáireamh=san áireamh
Kashmir=An Chaismír
Pallas=Pailís
Astrakhan=An Astracáin
Ballyboghal=Baile Bachaille
Mauretania=Mhúratáin
infrastruchtur=infreastruchtúr
Sheean=An Sián
Downies=Na Dúnaibh
Portsalon=Port an tSalainn
Garranabraher=Garrán na mBráthar
Hercules=Earcail|Heirciléas
Annagassan=Áth na gCasán
párliament=parlaimint
tsort=sórt
Ruan=An Ruán
Rathangan=Ráth Iomgháin
iniúctha=iniúchta
Maganey=Maigh Géine
Ballymullen=Baile an Mhuilinn
Glenflesk=Gleann Fleisce
Gaggan=Géagánach
Lenamore=An Léana Mór
Soviet=Sóivéid
Clontallagh=Cluain tSalach
Toor=An Tuar
dféidfeadh=d'fhéadfadh
cuimneamh=cuimhneamh
Dunraymond=Dún Réamainn
Belclare=Béal Chláir
mBoston=mBostún
Pythean=Píotach
Sobek-Re=Sobac-Rá
Kong=Cong
Ballycroy=Baile Chruaich
Owenbeg=An Abhainn Bheag
September=Meán Fómhair|Mí Mheán Fómhair
Buttevant=Cill na Mallach
Tibohine=Tigh Baoithín
Mnnivea=Muine Mheá
uasdhátú=uasdátú
augs=agus
Turkmenia=An Tuircméanastáin
Castleblakeny=Gallach
Ballyagran=Béal Átha Grean
Rathgormuck=Ráth Ó gCormaic
nuaaimseartha=nua-aimseartha
Plow=Seisreach
Coan=An Cuan
Castlejordan=Caisleán Shiurdáin
Sicily=An tSicil
Bellough=Béal Lathaí
ionnanas=ionannas
Rótón=Rólón
Shanagolden=Seanghualainn
Publius=Puiblias
Ballycahill=Bealach Achaille
Wikinews=Vicínuacht
Corlough=Corlach
Ballinard=Baile an Aird
Rosary=Coróin Mhuire
Munster=Cúige Mumhan|Mumhain
Kilcolman=Cill Cholmáin
Suomi=An Fhionlainn
profisiúnta=proifisiúnta
Curragh=An Currach
Punjab=An Phuinseaib
Welchtown=Baile na mBreatnach
Gortymadden=Gort Uí Mhadaín
Lapland=An Laplainn
Bofeenaun=Both Faonáin
Phibsborough=Baile Phib
Lisnagry=Lios na Graí
Internet=Idirlíon
ainmeacha=ainmneacha
dfhonn=d'fhonn
Knockdrin=Cnoc Droinne
Egyptology=Éigipteolaíocht
Zulu=Súlú
roime=roimhe
March=Márta|Mí an Mhárta
Samaria=An tSamáir
Carraholly=Ceathrú Chalaidh
Arabian=Arabach
Gaelgeoir=Gaeilgeoir
Zululand=Súlúlainn
Latteragh=Leatracha
Samoan=Samóch
Kurdistan=An Chordastáin
glorthaí=glórtha
Crosspatrick=Crois Phádraig
Asphodelus=Asfadal
Montserrat=Montsarat
Ballyphehane=Baile Féitheán
Yama=Iáma
Bavaria=An Bhaváir
Kilchreest=Cill Chríost
bhfui=bhfuil
Tobago=Tobága
Ballyfad=An Baile Fada
Killenagh=Cill Éanach
agusa=agus a
Shanbally=An Seanbhaile
Zoroaster=Sóróstar
Dagestan=An Dagastáin
Karnak=Carnac
Lackaroe=An Leaca Rua
Carrigeenroe=Carraigín Rua
Lobinstown=Baile Lóibín
Eslingbridge=Droichead na hEislinne
Kvasir=Cuasair
Caucasus=Cugais
tradisiún=traidisiún
Lawderdale=Droim Raithin
Megara=Meigeara
Eve=Éabha
Offaly=Uíbh Fhailí
Ballynamult=Béal na Molt
Granagh=Greanach
Geailge=Gaeilge
Ganymede=Ganaiméide
Beauparc=Baile Phaghain
íochta=íoctha
June=Meitheamh|Mí an Mheithimh
Broomfield=Achadh an Bhrúim
Avaris=Avaras
bhFhlaitheas=bhFlaitheas
Ballydangan=Baile Daighean
Hebrides=Inse Ghall
Thursday=Déardaoin
Bantu=Bantúch
Ariadne=Airianna
amhráinní=amhráin
Tyrone=Tír Eoghain
túrscéalaí=t-úrscéalaí
tatmaisféar=t-atmaisféar
isé=is é
Headfort=Lios na gCeann
Glasleck=Glasleic
Shrovetide=Inid
Hollowtide=Samhain
Boynagh=Buíonach
Kilcullen=Cill Chuillinn
Corcreeghagh=An Chorr Chríochach
Scotland=Albain
Evenus=Eivinis
Kosovo=Cosaiv
Shanlaragh=Seanlárach
Tuscany=An Tuscáin|Toscana
Harmonstown=Baile Hearman
Canadian=Ceanadach
Milltownpass=Bealach Baile an Mhuilinn
Dundrum=Dún Droma
eacnamíochta=eacnamaíochta
Buddhist=Búdaí
Menes=Míníos
fritheadh=fuarthas
Eurytion=Eoratón
Drummin=An Dromainn
Iole=Iailé
Roundhead=Maolcheann
ríathair=rínathair
Caledonia=Caladóin
Micronesia=An Mhicrinéis
Westport=Cathair na Mart
teolas=t-eolas
Clonmore=Cluain Mhór
foghlam=foghlaim
Gortatlea=Gort an tSléibhe
titithe=tite
doicméad=doiciméad
Northlands=An Táchairt Thuaidh
Crete=An Chréit
Ringville=An Rinn
Pettigoe=Paiteagó
Clifferna=An Chliaifearna
Faroese=Faróch
Attymon=Áth Tíomáin
tábhar=t-ábhar
Emo=Ioma
Atlantic=An tAtlantach
Phoenicia=An Fhéiníc
Mullaghmore=An Mullach Mór
Kilmacrah=Cill Mhic Craith
Rathlee=Ráth Lao
Java=Iáva
Shillelagh=Síol Éalaigh
Tulla=An Tulach
Authun=Abhtan
Bohermeer=An Bóthar Mín
Persephone=Peirseifine
Farnanes=Na Fearnáin
Antiope=Antaipé
Tyrol=An Tioróil
Asgard=Ascar
díogras=díograis
Redhills=An Cnoc Rua
teilefís=teilifís
Dia's=Dia is
Kilshane=Cill Sheáin
institiúd=institiúid
Ballynashannagh=Baile na Seanach
Ferrybank=Port an Chalaidh
Kilmoyly=Cill Mhaoile
Quintilian=Cuintilian
leissin=leis sin
Kilberry=Cill Bhearaigh
Parcae=Pairche
Newtownshandrum=Baile Nua Sheandroma
Doogort=Dumha Goirt
Martín=Máirtín
Clogh=An Chloch
Nazi=Naitsí
Proteus=Próitéas
neagraíochtaí=n-eagraíochtaí
Mordovia=An Mhordóiv
teaglach=teaghlach
Ballymacoda=Baile Mhac Óda
Roebuck=Reabóg
Cassiopeia=Caiseoipé
Derrynacreeve=Doire na Criadh
Ballyhean=Béal Átha hÉin
Annacarty=Áth na Cairte
Kill=An Chill
Dunnamaggan=Dún Iomagáin
Littleton=An Baile Beag
Corrib=Coirib
Malay=Malaech
Kildinan=Cill Daighnín
nGàidhlig=nGaeilge na hAlban
Ballincurrig=Baile an Churraigh
Hesperus=Réalta Nóna
Glinsk=Glinsce
Eabharc=Eabhrac
Manchuria=An Mhanchúir
Bosnia-Herzegovina=An Bhoisnia-Heirseagaivéin
Ballylynan=Baile Uí Laigheanáin
Ashwapati=Aiseapaití
Madonna=Maighdean Mhuire
leabharín=leabhairín
forum=fóram
Centaur=Ceinteár
Ballynacarrow=Baile na Cora
Argonaut=Arganát|Argónátach
Machiavelli=Maiciaiveillí
Minotaur=Míonótár
Drumkeen=Droim Caoin
Tir-na-nog=Tír na nÓg
Castleleiney=Caisleán Laighnigh
cummanach=cumannach
Ventry=Ceann Trá
isea=is ea
Glasthule=Glas Tuathail
Sabbath=Sabóid
Creegh=An Chríoch
Leinster=Cúige Laighean
Macedonia=An Mhacadóin
Piedmont=Píodmant
Commeen=An Coimín
Aeneid=Aeniad
Whitsuntide=An Chincís
neirí=n-éirí
Ballyhar=Baile Uí Aichir
gaeltacht=Gaeltacht
Svaldifari=Sualdafáraí
statisticí=staitisticí
Korea=An Chóiré
Bennekerry=Binn an Choire
ecstais=eacstais
Pantaloon=Pantalún
nachbhfuil=nach bhfuil
Farran=An Fearann
Cullahill=An Chúlchoill
Gola=Gabhla
tam=t-am
Doomsday=Lá an Bhreithiúnais|Lá an Bhrátha|Lá an Luain|Lá an tSléibhe
Irishman=Gael
aineoin=ainneoin
eilea=eile a
Eirinneach=Éireannach
fen=faoin
Pole=Mol
Mullincross=Muileann Cros
Ballinacurra=Baile na Cora
Nemesis=Neimisis
dfhógair=d'fhógair
Cairo=Caireo
Thermodon=Tearmódón
Thrace=An Tráicia
Lucius=Lúicias
Brierfield=An Driseachán
iarrtas=iarratas
an-dheas=an-deas
Lissacresig=Lios an Chraosaigh
dea-boladh=dea-bholadh
Annaghmore=Eanach Mór
Glenboy=Gleann Buí
Crossakeel=Crosa Caoil
Leucippe=Leocaipé
Libra=Meá
Newfoundland=Talamh an Éisc
leathanch=leathanach
Fedamore=Feadamair
Boyounagh=Buíbheanach
Caomhín=Caoimhín
Kilcurry=Cill Choirle|Cill an Churraigh
Peloponnese=An Pheilipinéis
Omphale=Omfailé
Ballindrait=Baile an Droichid
Pale=Galltacht|Páil
Killasser=Cill Lasrach
Caherlistrane=Cathair Loistreáin
Aghacashel=Achadh an Chaisil
Cheiron=Céarón
Clogher=An Clochar
Ballymurn=Baile Uí Mhurúin
diúltiú=diúltú
Mungret=Mungairit
meánscolaí=meánscolaíocht
Doohamlat=Dúthamhlach
Aghabog=Achadh Bog
Cygnus=Cros an Tuaiscirt|Eala
Bellnamullia=Béal Átha na Muille
Beltra=Béal Trá
lelinn=le linn
Muckross=Mucros
aimneacha=ainmneacha
Ballyvoge=Baile Uí Bhuaigh
Burnfort=Ráth an Tóiteáin
Querrin=An Cuibhreann
thainic=tháinig
Menelaus=Meinealás
sóchmhainní=sócmhainní
Croghan=Cruachán
Pindar=Piondar
Abkhazia=An Abcáis
Babylonia=An Bhablóinia
Chronos=Cronas
bhful=bhfuil
Dalmatia=An Dalmáit
Gypsy=Romanaí
Carpathia=Cairp
Bartlemy=Tobar Pártnáin
Bosnia=An Bhoisnia
Garryfine=Garraí Phaghain
Dromacummer=Drom an Chomair
Trent=Trionta
críchcanna=críocha
Aclare=Áth an Chláir
Carradoan=Ceathrú Domhain
Kiltiernan=Cill Tiarnáin
lehaon=le haon
Passover=Cáisc
Pharao=Faró
teaglaigh=teaghlaigh
dfhéadfadh=d'fhéadfadh
Reananerree=Rae na nDoirí
cabidil=caibidil
Toem=Tuaim
Anglesborough=Gleann na gCreabhar
Robertstown=Baile Riobaird
Antigone=Antagana
Lismacaffry=Lios Mhic Gofraidh
Palestine=An Phalaistín
Navajo=Navachóch
Ballymacaw=Baile Mhac Dháith
Lekaun=An Leacán
guid=gcuid
Advent=Aidbhint
Claith=Cliath
díobhse=díobhsan
Mountlucas=Droim Cáithe
Perseus=Peirséas|Pheirséis
Gurteen=Goirtín
Majorca=Mallarca
Spiddle=An Spidéal
Dooega=Dumha Éige
Odin=Óidin
Vulcan=Bolcán
Ballygorman=Baile Uí Ghormáin
Linsfort=Lios Loinn
Balinderry=Baile an Doire
timpeallac=timpeallacht
talt=t-alt
Kilmore=Cill Mhór
athabhairt=a thabhairt
Callow=An Caladh
Quilty=Coillte
Timbuktu=Timbeactú
t'mé=tá mé
Killinaboy=Cill Iníne Baoith
Cranford=Creamhghort
Feinne=Fiann
Virginia=Achadh an Iúir|Virgín
Ballymaleel=Baile Uí Mhaolaíola
Kiltullagh=Cill Tulach
Lisvarrinane=Lios Fearnáin
tiarratasóir=t-iarratasóir
Cappoge=Ceapach
Leenane=An Líonán
Greenane=Grianán
maidirleis=maidir leis
Freemount=Cillín an Chrónáin
Falmouth=Aberfal
Nero=Néaró
Treantagh=Na Tréantacha
Narraghmore=An Fhorrach Mhór
tairscint=tairiscint
aistharraing=aistarraing
tradisiúnta=traidisiúnta
Edirne=Cathair Aidriain
Rathnamagh=Ráth na Mach
Eighter=Íochtar
athbhlian=athbhliain
Gailege=Gaeilge
Barrackton=Gleann Ciotáin
Baltic=An Mhuir Bhailt
Zionist=Siónaí
Orchardstown=Baile an Úlloird
Theocritus=Teocratas
Trinity=Tríonóid
oirúnach=oiriúnach
naghaidh=n-aghaidh
Farnaght=Farnocht
Tullyvin=Tulaigh Bhinn
Flagmount=Leacain an Éadain
tháining=tháinig
Rostellan=Ros Tialláin
Palace=An Phailís
Prussia=An Phrúis
Koran=Córan
Latton=Leatón
Paradise=Gairdín Pharthais
Phrygia=An Fhrigia
Arranmore=Árainn Mhór
Tory=Tóraí
Carrowneden=Ceathrú an Éadain
Martinique=Martainíc
Nauruan=Nárúch
Kilmaganny=Cill Mogeanna
Poseidon=Poisíodón
Cloneen=An Cluainín
Aetolia=Aetóil
Lammas=Lá Lúnasa
Alcibiades=Alcaibiaidéas
Corbally=An Corrbhaile
Laggacurrer=Log an Churraigh
Tuesday=Máirt
Templeglentan=Teampall an Ghleanntáin
núsáid=n-úsáid
Ballinraun=Baile an Ruáin
Reynard=Donncha rua
dognaím=dogmaím
Dalystown=Baile Uí Dhálaigh
radh=rá
Ballyshrule=Baile Sruthail
Deianeira=Déinéire
Inishmeane=Inis Meáin
Stradone=Sraith an Domhain
néireodh=n-éireodh
nais=n-ais
Ballindaggan=Baile an Daingin
Kilteely=Cill Tíle
Meenbannad=Mín Beannaid
Brinlack=Bun na Leaca
seoa=seo a
Psyche=Sícé
bfheidir=b'fhéidir
Christendom=Críostaíocht
Enniskean=Inis Céin
Banogue=An Bhánóg
Dooleeg=Dumha Liag
Gaedhael=Gael
America=An tOileán Úr|Meiriceá
Ballycrossaun=Baile Crosáin
Antipodes=Fritíortha
Sumeria=Suiméir
afheabhsú=a fheabhsú
Gneevgullia=Gníomh go Leith
Osiris=Óisíris
Palmerston=Baile Phámar
Zanzibar=Sainsibeár
Lydia=Lidia
ionnannais=ionannais
Trafrask=Trá Phraisce
greanmhar=greannmhar
Bellanode=Béal Átha an Fhóid
Kabul=Cabúl
Teermaclane=Tír Mhic Calláin
Borneo=Boirneo
chunna=chun na
Coppeen=An Caipín
Gaul=An Ghaill
Glendowan=Gleann Domhain
Clonleigh=Cluain Lao
Medusa=Meadúsa
polataíocht=polaitíocht
Russifying=Rúisiú
Owey=Uaigh
Glanlough=Gleann Locha
Castlegal=Caisle Geala
Inquisition=Cúistiúnacht
Khefre=Ceafra
Cabragh=An Chabrach
Knockraha=Cnoc Rátha
Eti=Eití
Currane=An Corrán
túrscéal=t-úrscéal
Dido=Díodó
Waterfall=Tobar an Iarla
Kilclare=Coill an Chláir
ThuaidhTheas=Thuaidh-Theas
Kilmurry=Cill Mhuire
arist=arís
mait=maith
inadhiaidh=ina dhiaidh
raib=raibh
Clonroadmore=Cluain Ráda
idtaobh=i dtaobh
Habháí=Haváí
Gleneely=Gleann Daoile
Cummer=Comar
Shanahoe=Seanchua
aimnigh=ainmnigh
Ballynacarriga=Béal na Carraige
Zagreb=Ságrab
Glenroe=An Gleann Rua
Fermanagh=Fear Manach
Knockrath=Cnoc Rátha
Wikisource=Vicífhoinse
deanam=déanamh
Shetlands=Sealtainn
Rathmelton=Ráth Mealtain
Parkbridge=Droichead na Páirce
thángas=thángthas
Vulgate=Vulgáid
Lissalway=Lios Sealbhaigh
Kilgobnet=Cill Ghobnait
Causeway=An Tóchar
Knockagree=Cnoc na Graí
Peruvian=Peiriúch
Lahardaun=Leathardán
arsan=arsa an
feacail=feiceáil
Erris=Iorras
Aghagower=Achadh Ghobhair
oscalit=oscailt
Ballyliffen=Baile Lifín
Hillstreet=Leac na gCon
leisna=leis na
Balkans=Na Balcáin|Na Stáit Bhalcánacha
China=An tSín
Ballygirreen=Baile Ghiodaraín
Abyssinia=An Aibisín
Grousehall=Maigh Leacht
Monaster=An Mhainistir
nealaíon=n-ealaíon
Savoy=Saváí
Imsety=Imsití
Dacia=Dáicia
Clonard=Cluain Ioraird
Kilduff=An Chill Dubh
Togoland=Tógalainn
Kishkeam=Coiscéim na Caillí
lehaghaidh=le haghaidh
Killygordon=Cúil na gCuirridín
Titan=Tíotán
Coolagherty=Cúil Uí Fhathartaigh
Gàidhlig=Gaeilge na hAlban
Alaska=Alasca
Alpheus=Ailféis
sabhliain=sa bhliain
Garadice=Garairis|Garbhros
Catslecor=Caisleán na Cora
Moyvalley=Maigh Bhealaigh
Algiers=Cathair na hAilgéire
Livy=Livias
Tahilla=Tathuile
churar=chur ar
Bengal=Beangál
Carrownisky=Ceathrú an Uisce
Thessaly=An Teasáil
Moyard=Maigh Ard
Drumcree=Droim Cria
Ballyfeard=Baile Feá Aird
Booleyvogue=Bhaile Mhaodhóg
gairéadeach=gairéadach
crannn=crann
Ceadaoine=Céadaoin
Taur=Teamhair
agusín=aguisín
cairdúil=cairdiúil
Colgagh=Calgach
Drumcolliher=Drom Collachair
Urlaur=Urlár
Moroe=Maigh Rua
Phoebus=Féabas
Kiltoom=Cill Tuama
aistharraingt=aistarraingt
Lent=Carghas
maidirle=maidir le
Padua=Padova
Lislevane=Lios Leamháin
Brussels=An Bhruiséil
Eurasia=An Eoráise
Archbishop=Ard-Easpag
November=Samhain
Polynesia=An Pholainéis
Cloghmore=An Chloich Mhóir
Clogheen=An Chloichín
turlabhraí=t-urlabhraí
Bealaclugga=Béal an Chloga
Romany=Romanaí
Ardattin=Ard Aitinn
tainm=t-ainm
Muhammed=Mahamad
Speaker=Ceann Comhairle
Madabawn=An Maide Bán
Feenagh=Fíonach
Mohamed=Mahamad
cathar=cathair
Lettergesh=Leitir Geis
Parthenon=Partanón
Collon=Collann
Ballinahinch=Baile na hInse
Riga=Ríge
tréimse=tréimhse
Tsar=Sár
Lackan=An Leacain
Pollatomish=Poll an Tómais
Riviera=Rivéara
Portarlington=Cúil an tSúdaire
nintinn=n-intinn
sóchmhainn=sócmhainn
suimiúl=suimiúil
