# list of words to be excluded
# from the synthesis dictionary
#
#archaic/corpus-specific non-text items
#Licence: MIT/LGPL
*	*	Num:Op
-	-	Num:Op
/	/	Num:Op
=	=	Num:Op
</Turn>	</Turn>	XMLTag
</caption>	</caption>	XMLTag
</div>	</div>	XMLTag
</head>	</head>	XMLTag
</l>	</l>	XMLTag
</p>	</p>	XMLTag
</s>	</s>	XMLTag
</speaker_turn>	</speaker_turn>	XMLTag
</title>	</title>	XMLTag
<caption>	<caption>	XMLTag
<div type = 'unspec'/>	<div type = 'unspec'/>	XMLTag
<div type = 'unspec'>	<div type = 'unspec'>	XMLTag
<div type= 'section' n=	<div type= 'section' n=	XMLTag
<gap desc='bibl'/>	<gap desc='bibl'/>	XMLTag
<gap desc='contact_info'/>	<gap desc='contact_info'/>	XMLTag
<gap desc='english text'/>	<gap desc='english text'/>	XMLTag
<gap desc='english'/>	<gap desc='english'/>	XMLTag
<gap desc='french'/>	<gap desc='french'/>	XMLTag
<gap desc='german text'/>	<gap desc='german text'/>	XMLTag
<gap desc='german'/>	<gap desc='german'/>	XMLTag
<gap desc='glossary'/>	<gap desc='glossary'/>	XMLTag
<gap desc='note'/>	<gap desc='note'/>	XMLTag
<gap desc='spanish'/>	<gap desc='spanish'/>	XMLTag
<gap desc='table'/>	<gap desc='table'/>	XMLTag
<gap desc='welsh'/>	<gap desc='welsh'/>	XMLTag
<gap/>	<gap/>	XMLTag
<gap>	<gap>	XMLTag
<head>	<head>	XMLTag
<l>	<l>	XMLTag
<p>	<p>	XMLTag
<s>	<s>	XMLTag
<title>	<title>	XMLTag
@=broim	@=broim	Event
@=brúcht	@=brúcht	Event
@=caoineadh	@=caoineadh	Event
@=casacht	@=casacht	Event
@=clic	@=clic	Event
@=fuaim	@=fuaim	Event
@=gáire	@=gáire	Event
@=méanfach	@=méanfach	Event
@=sraoth	@=sraoth	Event
