
Abbeydorney=Mainistir Ó dTorna
Abbeyfeale=Mainistir na Féile
Abbeylara=Mainistir Leathrátha
Abbeyshrule=Mainistir Shruthla
Abbeyside=Dún na Mainistreach
Adamstown=Baile Adaim|Baile Ádaim|Baile Adáim|Maigh Arnaí
Adare=Áth Dara
Aden=Áidin
Adrigole=Eadargóil
Aghaboe=Achadh Bhó
Aghabullogue=Achadh Bolg
Aghamore=Achadh Mór
Agher=Achair
Aglish=An Eaglais
Ahenny=Áth Eine
Aherla=An Eatharla
Allenwood=Fiodh Alúine
Allihies=Na hAilichí
Annamoe=Áth na mBó
Antrim=Aontroim
Antwerp=Antuairp
Ardara=Ard an Rátha
Ardee=Baile Átha Fhirdhia
Ardfert=Ard Fhearta
Ardfield=Ard Ó bhFicheallaigh
Ardfinnan=Ard Fhíonáin
Ardgroom=Dhá Dhrom
Ardnacrusha=Ard na Croise
Ardpatrick=Ard Pádraig
Ardrahan=Ard Raithin
Arigna=An Airgnigh
Arklow=An tInbhear Mór
Arthurstown=Colmán
Arvagh=Ármhach
Ashbourne=Cill Dhéagláin
Askeaton=Eas Géitine
Athboy=Baile Átha Buí
Athea=Áth an tSléibhe
Athenry=Baile Átha an Rí
Athgarvan=Áth Garbháin
Athlacca=An tÁth Leacach
Athleague=Áth Liag
Athlone=Baile Átha Luain
Athy=Baile Átha Í
Attymass=Áth Tí an Mheasaigh
Bailieborough=Coill an Chollaigh
Balbriggan=Baile Brigín
Baldoyle=Baile Dúill
Ballaghaderreen=Bealach an Doirín
Ballaghmore=An Bealach Mór
Ballickmoyler=Baile Mhic Mhaoilir
Ballina=Béal an Átha|Béal an Fheá
Ballinaclash=An Chlais
Ballinadee=Baile na Daibhche
Ballinagree=Baile na Graí
Ballinakill=Baile na Coille
Ballinalee=Béal Átha na Lao
Ballinamore=Béal an Átha Móir
Ballinamuck=Béal Átha na Muc
Ballinascarty=Béal na Scairte
Ballincollig=Baile an Chollaigh
Ballinderreen=Baile an Doirín
Ballindine=Baile an Daighin
Ballingeary=Béal Átha an Ghaorthaidh
Ballinhassig=Béal Átha an Cheasaigh
Ballinrobe=Baile an Róba
Ballinskelligs=Baile an Sceilg
Ballinspittle=Béal Átha an Spidéil
Ballintemple=Baile an Teampaill
Ballintra=Baile an tSratha
Ballitore=Béal Átha an Tuair
Ballivor=Baile Íomhair
Ballybay=Béal Átha Beithe
Ballyboden=Baile Baodáin
Ballybofey=Bealach Féich
Ballybrittas=Baile Briotáis
Ballybunion=Baile an Bhuinneánaigh
Ballycanew=Baile Uí Chonnmhaí
Ballycarney=Baile Uí Chearnaigh
Ballycastle=Baile an Chaistil|Baile an Chaisil
Ballyclerahan=Baile Uí Chléireacháin
Ballycommon=Baile Uí Chomáin
Ballyconneely=Baile Conaola
Ballyconnell=Béal Átha Conaill
Ballycotton=Baile Choitín
Ballycullane=Baile Uí Choileáin
Ballycumber=Béal Átha Chomair
Ballydehob=Béal an Dá Chab
Ballydesmond=Baile Deasumhan
Ballyfarnon=Béal Átha Fearnáin
Ballyfermot=Baile Formaid
Ballyferriter=Baile an Fheirtéaraigh
Ballyfin=An Baile Fionn
Ballyforan=Béal Átha Feorainne
Ballygar=Béal Átha Ghártha
Ballygarrett=Baile Ghearóid
Ballyhaise=Béal Átha hÉis
Ballyhale=Baile Héil
Ballyhaunis=Béal Átha hAmhnais
Ballyheigue=Baile Uí Thaidhg
Ballyhooly=Baile Átha hÚlla
Ballyjamesduff=Baile Shéamais Dhuibh
Ballykeeran=Bealach Caorthainn
Ballylanders=Baile an Londraigh
Ballylickey=Béal Átha Leice
Ballylongford=Béal Átha Longfoirt
Ballylooby=Béal Átha Lúbaigh
Ballymacarbry=Baile Mhac Cairbre
Ballymacelligott=Baile Mhic Eileagóid
Ballymacward=Baile Mhic an Bhaird
Ballymahon=Baile Uí Mhatháin
Ballymakeery=Baile Mhic Íre
Ballymoe=Béal Átha Mó
Ballymun=Baile Munna
Ballynacally=Baile na Caillí
Ballynagall=Baile na nGall
Ballynahown=Baile na hAbhann
Ballyporeen=Béal Átha Póirín
Ballyragget=Béal Átha Ragad
Ballyshannon=Béal Átha Seanaidh
Ballyvourney=Baile Bhuirne
Baltinglass=Bealach Conglais
Baltray=Baile Trá
Banagher=Beannchar
Bandon=Droichead na Bandan
Bangor=Baingear|Beannchar
Bansha=An Bháinseach
Banteer=Bántír
Bantry=Beanntraí
Barefield=Gort Lomán
Barna=Bearna
Barnaderg=Bearna Dhearg
Barntown=Baile an Bharúnaigh
Batterstown=Baile an Bhóthair
Bawnboy=An Bábhún Buí|An Bán Buí
Bealadangan=Béal an Daingin
Bekan=Béacán
Belgooly=Béal Guala
Bellanagare=Béal Átha na gCarr
Bellavary=Béal Átha Bhearaigh
Bellewstown=Baile an Bheileogaigh
Belmullet=Béal an Mhuirthead
Belturbet=Béal Tairbirt
Belvelly=Béal an Bhealaigh
Bennettsbridge=Droichead Binéid
Bettystown=Baile an Bhiataigh
Binghamstown=An Geata Mór
Birdhill=Cnocán an Éin Fhinn
Birr=Biorra
Blacklion=An Blaic
Blackrock=An Charraig Dhubh
Blanchardstown=Baile Bhlainséir
Blarney=An Bhlarna
Blennerville=Cathair Uí Mhóráin
Blessington=Baile Coimín
Bluebell=An Cloigín Gorm
Bodyke=Lúbán Díge
Bohola=Both Chomhla
Booterstown=Baile an Bhóthair
Bornacoola=Barr na Cúile
Borrisokane=Buiríos Uí Chéin
Borrisoleigh=Buiríos Ó Luigheach
Boston=Bostún
Bouladuff=An Bhuaile Dhubh
Bracknagh=Breacánach
Bray=Bré
Brittas=An Briotás
Broadford=Béal an Átha
Bruckless=An Bhroclais
Bruff=An Brú
Buckode=Bocóid
Bunbeg=An Bun Beag
Bunclody=Bun Clóidí
Buncrana=Bun Cranncha
Bundoran=Bun Dobhráin
Bunmahon=Bun Machan
Burncourt=An Chúirt Dóite
Burtonport=Ailt an Chorráin
Cabinteely=Cábán tSíle
Cadamstown=Baile Mhic Ádaim
Cahersiveen=Cathair Saidhbhín
Callan=Callainn
Caltra=An Chealtrach
Calverstown=Baile an Chalbhaigh
Campile=Ceann Poill
Canningstown=Baile Chainín
Cappamore=An Cheapach Mhór
Cappataggle=Ceapaigh an tSeagail
Cappoquin=Ceapach Choinn
Carndonagh=Carn Domhnach
Carnew=Carn an Bhua
Carraroe=An Cheathrú Rua
Carrick-on-Suir=Carraig na Siúire
Carrickbeg=An Charraig Bheag
Carrickmacross=Carraig Mhachaire Rois
Carrickmines=Carraig Mhaighin
Carrigaholt=Carraig an Chabhaltaigh
Carrigaline=Carraig Uí Leighin
Carrigallen=Carraig Álainn
Carriganimmy=Carraig an Ime
Carrignavar=Carraig na bhFear
Carrowteige=Ceathrú Thaidhg
Cashel=Caiseal
Castlebaldwin=Béal Átha na gCarraigíní
Castlebar=Caisleán an Bharraigh
Castlebellingham=Baile an Ghearlánaigh
Castleblayney=Baile na Lorgan
Castlebridge=Droichead an Chaisleáin
Castlecomer=Caisleán an Chomair
Castleconnell=Caisleán Uí Chonaill
Castlecove=An Siopa Dubh
Castledermot=Díseart Diarmada
Castlegregory=Caisleán Ghriaire
Castlehill=Caorthannán
Castleisland=Oileán Ciarraí
Castleknock=Caisleán Cnucha
Castlelyons=Caisleán Ó Liatháin
Castlemaine=Caisleán na Mainge
Castlemartyr=Baile na Martra
Castleplunket=Lios Lachna
Castlepollard=Baile na gCros
Castlerea=An Caisleán Riabhach
Castletownbere=Baile Chaisleáin Bhéarra
Castletownroche=Baile Chaisleáin an Róistigh
Castletownshend=Baile an Chaisleáin
Castletroy=Caladh an Treoigh
Castlewarren=Caisleán an Bhairínigh
Cavan=An Cabhán
Celbridge=Cill Droichid
Chapelizod=Séipéal Iosóid
Churchtown=Baile an Teampaill
Claddaghduff=An Cladach Dubh
Clane=Claonadh
Clarecastle=Droichead an Chláir
Clareen=An Cláirín
Claregalway=Baile Chláir
Claremorris=Clár Chlainne Mhuiris
Clarinbridge=Droichead an Chláirín
Clashmore=Clais Mhór
Cleggan=An Cloigeann
Clifden=An Clochán
Cloghan=An Clochán
Cloghane=An Clochán
Clogherhead=Ceann Chlochair
Clohamon=Cloch Ámainn
Clonakilty=Cloich na Coillte
Clonaslee=Cluain na Slí
Clonbur=An Fhairche
Clondalkin=Cluain Dolcáin
Clonee=Cluain Aodha
Clonfert=Cluain Fearta
Clonmany=Cluain Maine
Clonmel=Cluain Meala
Clonmellon=Ráistín
Clonroche=Cluain an Róistigh
Clonsilla=Cluain Saileach
Clontibret=Cluain Tiobrad
Clonygowan=Cluain na nGamhan
Cloonacool=Cluain na Cúile
Cloondara=Cluain Dá Ráth
Cloone=An Chluain
Cloonfad=Cluain Fada
Cloyne=Cluain
Coalbrook=Glaise an Ghuail
Cobh=An Cóbh
Coleraine=Cúil Raithin
Collinstown=Baile na gCailleach
Collooney=Cúil Mhuine
Conna=Conaithe
Coolaney=Cúil Áine
Coolboy=An Cúl Buí
Coolgreany=Cúil Ghréine
Coolmeen=Cúil Mhín
Cooraclare=Cuar an Chláir
Cootehill=Muinchille
Corduff=An Chorr Dhubh
Cornafulla=Corr na Fola
Cornamona=Corr na Móna
Corofin=Cora Finne
Cortober=Corr Tobair
Costelloe=Casla
Courtmacsherry=Cúirt Mhic Shéafraidh
Craanford=Áth an Chorráin
Cratloe=An Chreatalach
Craughwell=Creachmhaoil
Crecora=Craobh Chomhartha
Creeslough=An Craoslach
Cregganbaun=An Creagán Bán
Creggs=Na Creaga
Crettyard=Crochta Ard
Crinkill=Críonchoill
Croagh=Cróch
Crolly=Croithlí
Crookedwood=Tigh Munna
Crookhaven=An Cruachán
Crossabeg=Na Crosa Beaga
Crosshaven=Bun an Tábhairne
Crossmolina=Crois Mhaoilíona
Crumlin=Cromghlinn
Crusheen=Croisín
Culdaff=Cúil Dabhcha
Curracloe=Currach Cló
Currow=Corra
Dalkey=Deilginis
Delgany=Deilgne
Delphi=Deilfe
Delvin=Dealbhna
Derrybeg=Doirí Beaga
Dingle=An Daingean
Dollymount=Cnocán Doirinne
Donabate=Domhnach Bat
Donaghpatrick=Domhnach Phádraig
Donard=Dún Ard
Doneraile=Dún ar Aill
Donnybrook=Domhnach Broc
Donohill=Dún Eochaille
Donoughmore=Domhnach Mór
Doochary=An Dúchoraidh
Doolin=Dúlainn
Doonbeg=An Dún Beag
Dowra=An Damhshraith
Drimnagh=Droimeanach
Drinagh=Draighneach
Dripsey=An Druipseach
Dromahair=Droim Dhá Thiar
Dromineer=Drom Inbhir
Dromiskin=Droim Ineasclainn
Dromod=Dromad
Drumcar=Droim Chora
Drumcliff=Droim Chliabh
Drumcong=Droim Conga
Drumkeeran=Droim Caorthainn
Drumlish=Droim Lis
Drumone=Droim Eamhna
Drumraney=Droim Raithne
Drumshanbo=Droim Seanbhó
Drumsna=Droim ar Snámh
Duleek=Damhliag
Dunboyne=Dún Búinne
Duncannon=Dún Canann
Duncormick=Dún Chormaic
Dundalk=Dún Dealgan
Dunderrow=Dún Darú
Dunfanaghy=Dún Fionnachaidh
Dungannon=Dún Geanainn
Dungarvan=Dún Garbhán
Dungourney=Dún Guairne
Dunkerrin=Dún Cairin
Dunkineely=Dún Cionnaola
Dunlavin=Dún Luáin
Dunmanway=Dún Mánmhaí
Dunquin=Dún Chaoin
Dunshaughlin=Dún Seachlainn
Durrus=Dúras
Dysart=An Díseart
Easky=Iascaigh
Eden=Gairdín Éidin
Edenderry=Éadan Doire
Edgeworthstown=Meathas Troim
Edmondstown=Baile Éamainn
Effin=Eifinn
Elphin=Ail Finn
Emly=Imleach
Emyvale=Scairbh na gCaorach
Enniscorthy=Inis Córthaidh
Enniskerry=Áth na Sceire
Enniskillen=Inis Ceithleann
Errill=Eiréil
Eyrecourt=Dún an Uchta
Fahan=Fathain
Fairview=Fionnradharc
Falcarragh=An Fál Carrach
Farranfore=An Fearann Fuar
Feakle=An Fhiacail
Fenit=An Fhianait
Ferbane=An Féar Bán
Fermoy=Mainistir Fhear Maí
Fiddown=Fiodh Dúin
Finglas=Fionnghlas
Fintown=Baile na Finne
Finuge=Fionnúig
Firies=Na Foidhrí
Foulkesmill=Muileann Fúca
Foxford=Béal Easa
Foxrock=Carraig an tSionnaigh
Foynes=Faing
Frenchpark=Dún Gar
Frosses=Na Frosa
Galmoy=Gabhalmhaigh
Garrafrauns=Na Garfráin
Garryspillane=Garraí Uí Spealáin
Geashill=Géisill
Geevagh=An Ghaobhach
Glandore=Cuan Dor
Glangevlin=Gleann Ghaibhle
Glanmire=Gleann Maghair
Glaslough=Glasloch
Glassan=Glasán
Glenamoy=Gleann na Muaidhe
Glenbeigh=Gleann Beith
Glenfarne=Gleann Fearna
Glengarriff=An Gleann Garbh
Glenties=Na Gleannta
Glin=An Gleann
Glounthaune=An Gleanntán
Golden=An Gabhailín
Goleen=An Góilín
Goresbridge=An Droichead Nua
Gorey=Guaire
Gortahork=Gort an Choirce
Gorteen=Goirtín
Gowran=Gabhrán
Graiguenamanagh=Gráig na Manach
Granard=Gránard
Greenore=An Grianfort
Greystones=Na Clocha Liatha
Gweedore=Gaoth Dobhair
Gweesalia=Gaoth Sáile
Hacketstown=Baile Haicéid
Headford=Áth Cinn
Herbertstown=Baile Hiobaird
Hollyfort=Ráth an Chuilinn
Hollymount=Maolla
Horseleap=Baile Átha an Urchair
Hugginstown=Baile Hugúin
Inagh=Eidhneach
Inistioge=Inis Tíog
Innishannon=Inis Eonáin
Inveran=Indreabhán
Islandeady=Oileán Éadaí
Johnswell=Tobar Eoin
Julianstown=Baile Iúiliáin
Kanturk=Ceann Toirc
Kealkill=An Chaolchoill
Keenagh=Caonach
Kells=Ceanannas
Kenmare=Neidín
Keshcarrigan=Ceis Charraigín
Kilbaha=Cill Bheathach
Kilbarrack=Cill Bharróg
Kilbeggan=Cill Bheagáin
Kilbeheny=Coill Bheithne
Kilbricken=Cill Bhriocáin
Kilbrittain=Cill Briotáin
Kilcar=Cill Charthaigh
Kilcock=Cill Choca
Kilcogy=Cill Chóige
Kilcolgan=Cill Cholgáin
Kilconnell=Cill Chonaill
Kilcoole=Cill Chomhghaill
Kilcormac=Cill Chormaic
Kilcorney=Cill Coirne
Kilcummin=Cill Chuimín
Kildalkey=Cill Dealga
Kildangan=Cill Daingin
Kildavin=Cill Damháin
Kildimo=Cill Díoma
Kildorrery=Cill Dairbhre
Kilfenora=Cill Fhionnúrach
Kilgarvan=Cill Gharbháin
Kilglass=Cill Ghlas
Kilkee=Cill Chaoi
Kilkelly=Cill Cheallaigh
Kilkieran=Cill Chiaráin
Kilkishen=Cill Chisín
Killala=Cill Ala
Killarga=Cill Fhearga
Killarney=Cill Airne
Killashee=Cill na Sí
Killavullen=Cill an Mhuilinn
Killeigh=Cill Aichidh
Killenaule=Cill Náile
Killester=Cill Easra
Killimor=Cill Íomair
Killoe=Cill Eo
Killorglin=Cill Orglan
Kilmacow=Cill Mhic Bhúith
Kilmacrenan=Cill Mhic Réanáin
Kilmacthomas=Coill Mhic Thomáisín
Kilmaine=Cill Mheáin
Kilmainhamwood=Cill Mhaighneann
Kilmaley=Cill Mháille
Kilmallock=Cill Mocheallóg
Kilmeadan=Cill Mhíodáin
Kilmeedy=Cill Míde
Kilmeena=Cill Mhíona
Kilmessan=Cill Mheasáin
Kilmihil=Cill Mhichíl
Kilmovee=Cill Mobhí
Kilmuckridge=Cill Mhucraise
Kilnaleck=Cill na Leice
Kilnamona=Cill na Móna
Kilrush=Cill Rois
Kilsheelan=Cill Sioláin
Kilskeer=Cill Scíre
Kiltealy=Cill Téile
Kilteevan=Cill Taobháin
Kiltegan=Cill Téagáin
Kiltimagh=Coillte Mach
Kiltyclogher=Coillte Clochair
Kingscourt=Dún an Rí
Kinlough=Cionn Locha
Kinnegad=Cionn Átha Gad
Kinnitty=Cionn Eitigh
Kinsale=Cionn tSáile
Kinvara=Cinn Mhara
Knockaderry=Cnoc an Doire
Knockananna=Cnoc an Eanaigh
Knockanore=Cnoc an Óir
Knockbridge=Droichead an Chnoic
Knockcroghery=Cnoc an Chrochaire
Knocklong=Cnoc Loinge
Knocknahur=Cnoc na hIora
Knocktopher=Cnoc an Tóchair
Labasheeda=Leaba Shíoda
Laghy=An Lathaigh
Largydonnell=Learga Uí Dhónaill
Laytown=An Inse
Lecarrow=An Leithcheathrú
Leenaun=An Líonán
Leighlinbridge=Leithghlinn an Droichid
Leixlip=Léim an Bhradáin
Lemybrien=Léim Uí Bhriain
Letterfrack=Leitir Fraic
Letterkenny=Leitir Ceanainn
Lettermacaward=Leitir Mhic an Bhaird
Lettermore=Leitir Móir
Lifford=Leifear
Liscannor=Lios Ceannúir
Liscarroll=Lios Cearúill
Lisdoonvarna=Lios Dúin Bhearna
Lismore=Lios Mór
Lispole=Lios Póil
Lisronagh=Lios Ruanach
Lisselton=Lios Eiltín
Lombardstown=Baile Lombaird
Lorrha=Lothra
Loughrea=Baile Locha Riach
Louisburgh=Cluain Cearbán
Louth=Lú
Lucan=Leamhcán
Lusk=Lusca
Luxembourg=Lucsamburg
Lyre=An Ladhar
Macroom=Maigh Chromtha
Magheracloone=Machaire Cluana
Malahide=Mullach Íde
Mallow=Mala
Manorcunningham=Mainéar Uí Chuinneagáin
Manorhamilton=Cluainín
Maum=An Mám
Mayo=Maigh Eo
Midleton=Mainistir na Corann
Milehouse=Teach an Mhíle
Millstreet=Sráid an Mhuilinn
Mitchelstown=Baile Mhistéala
Moate=An Móta
Mohill=Maothail
Monamolin=Muine Moling
Monaseed=Móin na Saighead
Monasteraden=Mainistir Réadáin
Monasterevin=Mainistir Eimhín
Moneygall=Muine Gall
Mooncoin=Móin Choinn
Moone=Maoin
Mosney=Maigh Muirí
Mountbellew=An Creagán
Mountbolus=Cnocán Bhólais
Mountcharles=Tamhnach an tSalainn
Mountcollins=Cnoc Uí Choileáin
Mountmellick=Móinteach Mílic
Mountrath=Maighean Rátha
Mountshannon=Baile Uí Bheoláin
Moville=Bun an Phobail
Moycullen=Maigh Cuilinn
Moydow=Maigh Dumha
Moylough=Maigh Locha
Moynalty=Maigh nEalta
Moyvoughly=Maigh Bhachla
Mullinahone=Muileann na hUamhan
Mullinavat=Muileann an Bhata
Mullingar=An Muileann gCearr
Multyfarnham=Muilte Farannáin
Murrisk=Muraisc
Myrtleville=Baile an Chuainín
Myshall=Míseal
Naas=An Nás
Naul=An Aill
Navan=An Uaimh
Nenagh=An tAonach
Newbawn=An Bábhún Nua
Newbliss=Cúil Darach
Newbridge=An Droichead Nua
Newcestown=Baile Níos
Newmarket=Áth Trasna
Newtown=An Baile Nua
Ninemilehouse=Tigh na Naoi Míle
Nobber=An Obair
Ogonnelloe=Tuath Ó gConaíle
Omagh=An Ómaigh
Omeath=Ó Méith
Oola=Úlla
Oranmore=Órán Mór
Oughterard=Uachtar Ard
Oulart=An tAbhallort
Pallaskenry=Pailís Chaonraí
Partry=Partraí
Patrickswell=Tobar Phádraig
Paulstown=Baile Phóil
Perrystown=Baile Pheire
Piltown=Baile an Phoill
Pollagh=Pollach
Portlaw=Port Lách
Portmagee=An Caladh
Portmarnock=Port Mearnóg
Portroe=An Port Rua
Portrush=Port Rois
Portumna=Port Omna
Prosperous=An Chorrchoill
Quin=Cuinche
Rahara=Ráth Ara
Raheny=Ráth Eanaigh
Ranelagh=Raghnallach
Raphoe=Ráth Bhoth
Rathconrath=Ráth Conarta
Rathcoole=Ráth Cúil
Rathcormack=Ráth Chormaic
Rathdangan=Ráth Daingin
Rathdowney=Ráth Domhnaigh
Rathfarnham=Ráth Fearnáin
Rathgar=Ráth Garbh
Rathkeale=Ráth Caola
Rathmolyon=Ráth Moliain
Rathmullan=Ráth Maoláin
Rathnew=Ráth Naoi
Rathnure=Ráth an Iúir
Rathowen=Ráth Eoghain
Rathvilly=Ráth Bhile
Ratoath=Ráth Tó
Redcross=An Chrois Dhearg
Rerrin=Raerainn
Ringaskiddy=Rinn an Scidígh
Riverstick=Áth an Mhaide
Riverstown=Baile Idir dhá Abhainn
Rochfortbridge=Droichead Chaisleán Loiste
Rockchapel=Séipéal na Carraige
Rockcorry=Buíochar
Roosky=Rúscaigh
Roscommon=Ros Comáin
Roscrea=Ros Cré
Rosegreen=Faiche Ró
Rosenallis=Ros Fhionnghlaise
Rossinver=Ros Inbhir
Rossnowlagh=Ros Neamhlach
Rossport=Ros Dumhach
Roundwood=An Tóchar
Rush=An Ros
Saggart=Teach Sagard
Sallins=Na Solláin
Sallynoggin=An Naigín
Saltmills=Muileann an tSáile
Sandyford=Áth an Ghainimh
Sandymount=Dumhach Thrá
Santry=Seantrabh
Scarriff=An Scairbh
Scotshouse=Teach an Scotaigh
Scotstown=Baile an Scotaigh
Shanballymore=An Seanbhaile Mór
Shankill=Seanchill
Shannonbridge=Droichead na Sionainne
Shercock=Searcóg
Shinrone=Suí an Róin
Shrule=Sruthair
Silvermines=Béal Átha Gabhann
Sixmilebridge=Droichead Abhann Ó gCearnaigh
Skerries=Na Sceirí
Skibbereen=An Sciobairín
Skreen=An Scrín
Slane=Baile Shláine
Sligo=Sligeach
Smithborough=Na Mullaí
Sneem=An tSnaidhm
Spiddal=An Spidéal
Stamullen=Steach Maoilín
Strabane=An Srath Bán
Stradbally=An Sráidbhaile
Strade=An tSráid
Straffan=Teach Srafáin
Strandhill=An Leathros
Stranorlar=Srath an Urláir
Stratford=Áth na Sráide
Streamstown=Baile an tSrutháin
Strokestown=Béal na mBuillí
Suncroft=Crochta na Gréine
Swanlinbar=An Muileann Iarainn
Swinford=Béal Átha na Muice
Taghmaconnell=Teach Mhic Conaill
Taghmon=Teach Munna
Tallaght=Tamhlacht
Tarmon=An Tearmann
Teelin=Teileann
Templemore=An Teampall Mór
Templetuohy=Teampall Tuaithe
Terenure=Tír an Iúir
Termonfeckin=Tearmann Feichín
Terryglass=Tír Dhá Ghlas
Thurles=Durlas
Timahoe=Tigh Mochua
Timoleague=Tigh Molaige
Tinahely=Tigh na hÉille
Tipperary=Tiobraid Árann
Toorlestraun=Tuar Loistreáin
Toormakeady=Tuar Mhic Éadaigh
Tralee=Trá Lí
Tramore=Trá Mhór
Trim=Baile Átha Troim
Tuam=Tuaim
Tuamgraney=Tuaim Gréine
Tullaghan=An Tulachán
Tullamore=Tulach Mhór
Tullow=An Tulach
Tullyallen=Tulaigh Álainn
Tulsk=Tuilsce
Turloughmore=An Turlach Mór
Tynagh=Tíne
Tyrrellspass=Bealach an Tirialaigh
Valleymount=An Chrois
Vicarstown=Baile an Bhiocáire
Villierstown=An Baile Nua
Walkinstown=Baile Bhailcín
Watergrasshill=Cnocán na Biolraí
Waterville=An Coireán
Wexford=Loch Garman
Whitehall=An Halla Bán|Rinn Chúil Uisce|Halla Bán|An Baile Nua|Baile Phóil|Fionnbhrú
Wicklow=Cill Mhantáin
Woodlawn=Móta
Youghal=Eochaill
