Abdônio=Abdónio
Altônia=Altónia
Andrômaca=Andrómaca
Antêmio=Antémio
Armênia=Arménia
Brandônio=Brandónio
Bufônida=Bufónida
Caledônia=Caledónia
Caprônia=Caprónia
Cirênio=Cirénio
Cleomênia=Cleoménia
Cleômene=Cleómene
Climômaco=Climómaco
Colônia=Colónia
Desdêmona=Desdémona
Deuteronômio=Deuteronómio
Eslovênia=Eslovénia
Estônia=Estónia
Eufêmio=Eufémio
Eumênio=Euménio
Eumênis=Euménis
Febrônio=Febrónio
Fessônia=Fessónia
Gênova=Génova
Hirônide=Hirónide
Icônio=Icónio
Iêmen=Iémene
Letônia=Letónia
Lênio=Lénio
Macedônia=Macedónia
Mônaco=Mónaco
Nicômaco=Nicómaco
Pacômio=Pacómio
Pacônio=Pacónio
Palemônida=Palemónida
Parmênio=Parménio
Pentatômida=Pentatómida
Pleiocênico=Pleiocénico
Polônia=Polónia
Pompônio=Pompónio
Quênia=Quénia
Roentgênio=Roentgénio
Romênia=Roménia
Salônica=Salónica
Telêmaco=Telémaco
Teotônio=Teotónio
Tessalônica=Tessalónica
Teufônio=Teufónio
Têmis=Témis
Vênus=Vénus
Zênia=Zénia
aalênio=aalénio
aaquênio=aaquénio
aarônico=aarónico
aarônida=aarónida
abacômite=abacómite
abatedômodon=abatedómodon
abatômetro=abatómetro
abdoministerectômico=abdoministerectómico
abdoministerotômico=abdoministerotómico
abdominoisterectômico=abdominoisterectómico
abdominoisteretômico=abdominoisteretómico
abdominuterotômico=abdominuterotómico
abdômen=abdómen
abdômene=abdómene
abelônio=abelónio
aberrômetro=aberrómetro
abietênico=abieténico
abiogênese=abiogénese
ablacômia=ablacómia
ablastêmico=ablastémico
ablutômano=ablutómano
abortigênico=abortigénico
abortogênico=abortogénico
abrônia=abrónia
absalônico=absalónico
absintêmico=absintémico
absorciômetro=absorciómetro
abstêmico=abstémico
abstêmio=abstémio
abulômano=abulómano
acadêmia=académia
acadêmica=académica
acadêmico=académico
acalibêmico=acalibémico
acamptossômico=acamptossómico
acamtossômico=acamtossómico
acanticônio=acanticónio
acantostômida=acantostómida
acantômero=acantómero
acantômetro=acantómetro
acantômice=acantómice
acantônique=acantónique
acanônico=acanónico
acardioêmico=acardioémico
acardiêmico=acardiémico
acarogênico=acarogénico
acatalasêmico=acatalasémico
acelerômetro=acelerómetro
acelômato=acelómato
acenaftilênico=acenaftilénico
acenaftênico=acenafténico
acervulômico=acervulómico
acetilacetônico=acetilacetónico
acetilaminobenzênico=acetilaminobenzénico
acetilcumênico=acetilcuménico
acetilenocarbônico=acetilenocarbónico
acetilenogênio=acetilenogénio
acetilenômetro=acetilenómetro
acetilidênico=acetilidénico
acetilidênio=acetilidénio
acetilionônico=acetilionónico
acetilogênio=acetilogénio
acetilpropilbenzênico=acetilpropilbenzénico
acetilpropilnitrobenzênico=acetilpropilnitrobenzénico
acetilpropiônico=acetilpropiónico
acetiltrimetilênico=acetiltrimetilénico
acetilênico=acetilénico
acetilênio=acetilénio
acetobenzônico=acetobenzónico
acetocinamônico=acetocinamónico
acetofenopinacônico=acetofenopinacónico
acetofenônico=acetofenónico
acetonaftônico=acetonaftónico
acetonedicarbônico=acetonedicarbónico
acetonilacetônico=acetonilacetónico
acetonêmico=acetonémico
acetopropiônico=acetopropiónico
acetoxicumarônico=acetoxicumarónico
acetômetro=acetómetro
acetônico=acetónico
acidobutirômetro=acidobutirómetro
acidogêneo=acidogéneo
acidogênico=acidogénico
acidêmico=acidémico
acidômetro=acidómetro
acilênico=acilénico
aclatônio=aclatónio
acmônida=acmónida
acmônio=acmónio
acnêmico=acnémico
acomodômetro=acomodómetro
acotiledônea=acotiledónea
acotiledôneo=acotiledóneo
acradênia=acradénia
acremônio=acremónio
acribômetro=acribómetro
acridônico=acridónico
acrimônia=acrimónia
acrocômia=acrocómia
acrodrômico=acrodrómico
acrofônico=acrofónico
acroglicogênio=acroglicogénio
acroglucogênio=acroglucogénio
acrogênese=acrogénese
acrogênia=acrogénia
acrogênico=acrogénico
acrolênio=acrolénio
acrometagênese=acrometagénese
acromotricômico=acromotricómico
acroocitêmico=acroocitémico
acrooglicogênio=acrooglicogénio
acropinacônico=acropinacónico
acrossalênia=acrossalénia
acrossilabônimo=acrossilabónimo
acrossêmico=acrossémico
acrossômico=acrossómico
acrotômico=acrotómico
acrômano=acrómano
acrômico=acrómico
acrômio=acrómio
acrônico=acrónico
acrônimo=acrónimo
acteômetro=acteómetro
acteônida=acteónida
acticarbônico=acticarbónico
actinocênia=actinocénia
actinofônico=actinofónico
actinogênico=actinogénico
actinomicômico=actinomicómico
actinomônada=actinomónada
actinotoxêmico=actinotoxémico
actinômero=actinómero
actinômetro=actinómetro
actinômice=actinómice
actômetro=actómetro
acuofênio=acuofénio
acuofônico=acuofónico
acusiômetro=acusiómetro
acutômetro=acutómetro
acuômetro=acuómetro
acômico=acómico
acômodo=acómodo
acônito=acónito
adansônia=adansónia
adaptômetro=adaptómetro
adatômetro=adatómetro
adelogênico=adelogénico
adelopnêumone=adelopnéumone
adelostômida=adelostómida
ademônico=ademónico
adenastênico=adenasténico
adenectômico=adenectómico
adenocarcinômico=adenocarcinómico
adenocistômico=adenocistómico
adenocondrômico=adenocondrómico
adenoidectômico=adenoidectómico
adenomectômico=adenomectómico
adenostêmato=adenostémato
adenostêmone=adenostémone
adenostômato=adenostómato
adenotômico=adenotómico
adermogênese=adermogénese
adermogênico=adermogénico
adessênio=adessénio
adiabênico=adiabénico
adimônia=adimónia
adipofibrômico=adipofibrómico
adipogênico=adipogénico
adipômetro=adipómetro
adisônia=adisónia
adiônio=adiónio
admirômano=admirómano
adrenalectômico=adrenalectómico
adrenalinogênese=adrenalinogénese
adrenalinogênico=adrenalinogénico
adrenalinêmico=adrenalinémico
adêmia=adémia
adênico=adénico
adênio=adénio
adônia=adónia
adônico=adónico
adônide=adónide
adônido=adónido
adônio=adónio
adônis=adónis
adônis-da-índia=adónis-da-índia
aerefônio=aerefónio
aeremoctônico=aeremoctónico
aerodrômico=aerodrómico
aerofotômetra=aerofotómetra
aerofônico=aerofónico
aerofônio=aerofónio
aeronômico=aeronómico
aeroperitônico=aeroperitónico
aerêmico=aerémico
aerômano=aerómano
aerômetro=aerómetro
afilopônico=afilopónico
afrômetro=afrómetro
afrônitro=afrónitro
afugenta-demônio=afugenta-demónio
afêmico=afémico
afônico=afónico
agalênida=agalénida
agamaglobulinêmico=agamaglobulinémico
agamemnônida=agamemnónida
agamenônida=agamenónida
agamogônico=agamogónico
agangliônico=agangliónico
agarofênico=agarofénico
agarônia=agarónia
agatômero=agatómero
agerônia=agerónia
aglossostômico=aglossostómico
aglutinogênico=aglutinogénico
aglutinogênio=aglutinogénio
aglutinômetro=aglutinómetro
aglutômetro=aglutómetro
agoranômico=agoranómico
agrimônia=agrimónia
agriônia=agriónia
agriônida=agriónida
agronômico=agronómico
agrômano=agrómano
agrônomo=agrónomo
agêmate=agémate
agênio=agénio
agônico=agónico
agônida=agónida
agônio=agónio
aitiogênico=aitiogénico
aitônia=aitónia
aiênia=aiénia
alagostêmone=alagostémone
alantolactônico=alantolactónico
alarcônia=alarcónia
albedômetro=albedómetro
albiônico=albiónico
albuminogênese=albuminogénese
albuminogênico=albuminogénico
albuminêmico=albuminémico
albuminômetro=albuminómetro
alcaligênico=alcaligénico
alcaloidômetro=alcaloidómetro
alcalêmico=alcalémico
alcalômetro=alcalómetro
alciôneo=alcióneo
alciônico=alciónico
alciônida=alciónida
alciônio=alciónio
alcmeônida=alcmeónida
alcoilbenzênico=alcoilbenzénico
alcoilênico=alcoilénico
alcoilênio=alcoilénio
alcoolêmia=alcoolémia
alcoolêmico=alcoolémico
alcoolômano=alcoolómano
alcoolômetro=alcoolómetro
alcoômetro=alcoómetro
alcurônio=alcurónio
aldeidêmico=aldeidémico
aldosterônico=aldosterónico
alectriônia=alectriónia
alelômaco=alelómaco
alemanofônico=alemanofónico
alendrônico=alendrónico
aleogênese=aleogénese
aleogênico=aleogénico
alergênico=alergénico
alergênio=alergénio
aleurômetro=aleurómetro
aleurônico=aleurónico
alfênico=alfénico
algedônico=algedónico
algernônia=algernónia
algesiocronômetro=algesiocronómetro
algesiogênico=algesiogénico
algesiômetro=algesiómetro
algestesiômetro=algestesiómetro
algoestesiômetro=algoestesiómetro
algogênico=algogénico
algômano=algómano
algômetro=algómetro
alilacetofenônico=alilacetofenónico
alilacetônico=alilacetónico
alilbenzênico=alilbenzénico
aliletilênico=aliletilénico
alilmalônico=alilmalónico
alilomalônico=alilomalónico
aliltoluênico=aliltoluénico
aliltrimetoxibenzênico=aliltrimetoxibenzénico
alilênico=alilénico
alimônia=alimónia
aliônia=aliónia
alliônia=alliónia
almargêmia=almargémia
alocrômico=alocrómico
alocrônico=alocrónico
aloctônico=aloctónico
alodrômico=alodrómico
alofônico=alofónico
alogênico=alogénico
alogênio=alogénio
alogônico=alogónico
aloiogênese=aloiogénese
aloiogênico=aloiogénico
alomônio=alomónio
alonômico=alonómico
alossômico=alossómico
alotigênico=alotigénico
alotônico=alotónico
aloxurêmico=aloxurémico
alquilênico=alquilénico
alquilênio=alquilénio
alsonômetro=alsonómetro
alstônia=alstónia
alsônia=alsónia
altenstênia=altensténia
altingênio=altingénio
altiônico=altiónico
altênia=alténia
altômetro=altómetro
alucinogênico=alucinogénico
alucinogênio=alucinogénio
aluminogênio=aluminogénio
alumogênio=alumogénio
alunogênio=alunogénio
aluviônico=aluviónico
alveolectômico=alveolectómico
alômero=alómero
alômia=alómia
alônimo=alónimo
alônomo=alónomo
amantênico=amanténico
amasônia=amasónia
amazônico=amazónico
amazônide=amazónide
amazônido=amazónido
amazônio=amazónio
ambenônio=ambenónio
ambigênia=ambigénia
ambigênico=ambigénico
amblêmido=amblémido
amebogênio=amebogénio
amelogênese=amelogénese
amenômano=amenómano
americanômano=americanómano
americômano=americómano
amibogênio=amibogénio
amicrônico=amicrónico
amictogênese=amictogénese
amidoazobenzossulfônico=amidoazobenzossulfónico
amidocaprônico=amidocaprónico
amidocarbônico=amidocarbónico
amidocrotônico=amidocrotónico
amidoetilsulfônico=amidoetilsulfónico
amidogênio=amidogénio
amidoisetiônico=amidoisetiónico
amidonaftolsulfônico=amidonaftolsulfónico
amigdalectômico=amigdalectómico
amigdalotômico=amigdalotómico
amilasêmico=amilasémico
amildissulfocarbônico=amildissulfocarbónico
amilditiônico=amilditiónico
amilogênese=amilogénese
amilogênio=amilogénio
amilênico=amilénico
amilênio=amilénio
amilômero=amilómero
aminoacidêmico=aminoacidémico
aminoazobenzênico=aminoazobenzénico
aminobenzênico=aminobenzénico
aminogênio=aminogénio
aminopropiônico=aminopropiónico
amiostênico=amiosténico
amitaônio=amitaónio
amoniogênico=amoniogénico
amoniêmico=amoniémico
amoniômetro=amoniómetro
amperêmetro=amperémetro
amperômetro=amperómetro
amênico=aménico
amômea=amómea
amônia=amónia
amônio=amónio
anabênico=anabénico
anacamptômetro=anacamptómetro
anaclasômetro=anaclasómetro
anacolêmato=anacolémato
anacoretômano=anacoretómano
anacrônico=anacrónico
anadiômene=anadiómene
anadrenalinêmico=anadrenalinémico
anadrômico=anadrómico
anadênico=anadénico
anadênio=anadénio
anafilactogênese=anafilactogénese
anafilactogênico=anafilactogénico
anafilatogênese=anafilatogénese
anafilatogênico=anafilatogénico
anafrênio=anafrénio
anagnosiastênico=anagnosiasténico
anagênese=anagénese
anagênico=anagénico
analuviônico=analuviónico
analônio=analónio
anamênia=anaménia
anapnômetro=anapnómetro
anaprossêmico=anaprossémico
anarmônico=anarmónico
anassômico=anassómico
anastêmone=anastémone
anastômico=anastómico
anatômico=anatómico
anatônico=anatónico
anaximênico=anaximénico
anaxônico=anaxónico
anaxônio=anaxónio
ancilosteotômico=ancilosteotómico
ancilostômico=ancilostómico
ancilotermômetro=ancilotermómetro
ancilotômico=ancilotómico
ancilômelo=ancilómelo
ancilômero=ancilómero
ancomênida=ancoménida
ancômeno=ancómeno
ancôneo=ancóneo
ancônio=ancónio
andersônia=andersónia
androgênese=androgénese
androgênico=androgénico
androgênio=androgénio
andropogônea=andropogónea
andropogôneo=andropogóneo
andrômana=andrómana
andrômeda=andrómeda
andrômina=andrómina
andrônico=andrónico
anecumênico=anecuménico
anedotômano=anedotómano
anelectrotônico=anelectrotónico
aneletrotônico=aneletrotónico
anematigênico=anematigénico
anematocromômetro=anematocromómetro
anematocrômico=anematocrómico
anematogênico=anematogénico
anemômetro=anemómetro
anemônea=anemónea
anemônia=anemónia
anemônico=anemónico
anencefalêmico=anencefalémico
anenterêmico=anenterémico
anepatogênico=anepatogénico
anepiticêmico=anepiticémico
anermênico=anerménico
anestesiogênico=anestesiogénico
anestesiômetro=anestesiómetro
anetolsulfônico=anetolsulfónico
anetênio=aneténio
aneuraxêmico=aneuraxémico
aneurismatômico=aneurismatómico
aneurismectômico=aneurismectómico
aneurismotômico=aneurismotómico
aneurêmico=aneurémico
anexectômico=anexectómico
anexotômico=anexotómico
anfictiônico=anfictiónico
anfictiônide=anfictiónide
anfictiônio=anfictiónio
anfidrômico=anfidrómico
anfidrômio=anfidrómio
anfigênio=anfigénio
anfigônico=anfigónico
anfitriônico=anfitriónico
anfitriônio=anfitriónio
anfiônio=anfiónio
anfopeptônico=anfopeptónico
anforofônico=anforofónico
anfotônico=anfotónico
anfradênio=anfradénio
anfêmero=anfémero
angelogênico=angelogénico
angelogônico=angelogónico
angelônia=angelónia
angiectômico=angiectómico
angiogênese=angiogénese
angiogênico=angiogénico
angioleucômero=angioleucómero
angioneurectômico=angioneurectómico
angionômico=angionómico
angiosterônico=angiosterónico
angiostênico=angiosténico
angiostômida=angiostómida
angiotensinogênico=angiotensinogénico
angiotensinogênio=angiotensinogénio
angiotênico=angioténico
angiotômico=angiotómico
angiotônico=angiotónico
angiêmico=angiémico
angiômero=angiómero
angiômetro=angiómetro
angiônoma=angiónoma
anglo-saxônico=anglo-saxónico
anglo-saxônio=anglo-saxónio
anglofônico=anglofónico
anglômano=anglómano
angulômetro=angulómetro
anidracocarbônica=anidracocarbónica
aniluvitônico=aniluvitónico
animatrônico=animatrónico
anisocrômico=anisocrómico
anisogônio=anisogónio
anisostêmone=anisostémone
anisostênico=anisosténico
anisotômida=anisotómida
anisotônico=anisotónico
anisômela=anisómela
anisômero=anisómero
anisômetro=anisómetro
anisônique=anisónique
aniônico=aniónico
anoftalmêmico=anoftalmémico
anogônio=anogónio
anolênico=anolénico
anomalonômico=anomalonómico
anomalônomo=anomalónomo
anomocardiostênico=anomocardiosténico
anomocrômico=anomocrómico
anoplômero=anoplómero
anorexigênio=anorexigénio
anorganogênico=anorganogénico
anoxigênico=anoxigénico
anoxitônico=anoxitónico
anoxiêmico=anoxiémico
anoxêmico=anoxémico
ansiogênico=ansiogénico
ansônia=ansónia
antadênia=antadénia
antagônico=antagónico
antenômero=antenómero
antetônico=antetónico
anti-helênico=anti-helénico
anti-higiênico=anti-higiénico
antiacadêmico=antiacadémico
antiarônico=antiarónico
antiatômico=antiatómico
antibalomênico=antibaloménico
antibalômeno=antibalómeno
antibrômico=antibrómico
anticanônico=anticanónico
anticiclônico=anticiclónico
anticodônio=anticodónio
anticrônico=anticrónico
anticômano=anticómano
antidrômico=antidrómico
antieconômico=antieconómico
antiepidêmico=antiepidémico
antiestegômico=antiestegómico
antieufônico=antieufónico
antifônico=antifónico
antifônio=antifónio
antigeômetra=antigeómetra
antigênico=antigénico
antigênio=antigénio
antigônia=antigónia
antigônida=antigónida
antilegômeno=antilegómeno
antilogômeno=antilogómeno
antimacedônico=antimacedónico
antimaçônico=antimaçónico
antimônico=antimónico
antimônio=antimónio
antinômico=antinómico
antipatogênico=antipatogénico
antiperitônico=antiperitónico
antipiogênico=antipiogénico
antipneumônico=antipneumónico
antixênico=antixénico
antiômega=antiómega
antogênese=antogénese
antogônia=antogónia
antogônio=antogónio
antracêmico=antracémico
antracênico=antracénico
antracênio=antracénio
antracômetro=antracómetro
antraquinônico=antraquinónico
antrectômico=antrectómico
antroaticotômico=antroaticotómico
antropedogênico=antropedogénico
antropogênese=antropogénese
antropogênico=antropogénico
antropogônico=antropogónico
antroponômico=antroponómico
antropotômico=antropotómico
antropômetro=antropómetro
antropônimo=antropónimo
antrotômico=antrotómico
antêmide=antémide
antênula=anténula
antômano=antómano
antônia=antónia
antônimo=antónimo
antônio=antónio
antônomo=antónomo
anuênio=anuénio
anágua-de-vênus=anágua-de-vénus
anêmico=anémico
anêmona=anémona
anêmona-do-mar=anémona-do-mar
anômalo=anómalo
anômato=anómato
anômea=anómea
anônimo=anónimo
aortostênico=aortosténico
apamênio=apaménio
apendicectômico=apendicectómico
apendicostômico=apendicostómico
apendicêmico=apendicémico
apertômetro=apertómetro
apicectômico=apicectómico
apicoectômico=apicoectómico
apirogênico=apirogénico
apiônico=apiónico
apnêumone=apnéumone
apnêumono=apnéumono
apobômio=apobómio
apocrênico=apocrénico
apocrômico=apocrómico
apocônico=apocónico
apocônimo=apocónimo
apofilênico=apofilénico
apofonêmico=apofonémico
apofônico=apofónico
apogênese=apogénese
apogênico=apogénico
apogônia=apogónia
apogônida=apogónida
apogônio=apogónio
apolônico=apolónico
apolônicon=apolónicon
apolônio=apolónio
apomecômetro=apomecómetro
apomilênico=apomilénico
aponeurectômico=aponeurectómico
aponeurotômico=aponeurotómico
aponevrotômico=aponevrotómico
apoquinênio=apoquinénio
apoxiômeno=apoxiómeno
aprosômetro=aprosómetro
aprônia=aprónia
apômaco=apómaco
apônico=apónico
aquemênida=aqueménida
aquemênio=aqueménio
aquilônio=aquilónio
aquirônia=aquirónia
aquitônio=aquitónio
aquênio=aquénio
arabofônico=arabofónico
arabônico=arabónico
araquidônico=araquidónico
arctômida=arctómida
ardômetro=ardómetro
arecômico=arecómico
aremônia=aremónia
areotectônica=areotectónica
areotectônico=areotectónico
areômetro=areómetro
argentômetro=argentómetro
argônio=argónio
arilaminossulfônico=arilaminossulfónico
arilarsônico=arilarsónico
aristogênese=aristogénese
aritmonômico=aritmonómico
aritmômano=aritmómano
aritmômetro=aritmómetro
aritmônomo=aritmónomo
armagedônico=armagedónico
armênico=arménico
armênio=arménio
aromadendrônico=aromadendrónico
aromatodendrônico=aromatodendrónico
arquegônico=arquegónico
arquegônio=arquegónio
arqueoantropedogênico=arqueoantropedogénico
arqueoastronômico=arqueoastronómico
arqueoastrônomo=arqueoastrónomo
arqueômetro=arqueómetro
arquissemêmico=arquissemémico
arquissêmico=arquissémico
arquitetônica=arquitetónica
arquitetônico=arquitetónico
arquivonômico=arquivonómico
arrenogênico=arrenogénico
arrizotônico=arrizotónico
arsamônio=arsamónio
arsenobenzênico=arsenobenzénico
arsênico=arsénico
arsênio=arsénio
arsônico=arsónico
arsônio=arsónio
arteriectômico=arteriectómico
arterioflebotômico=arterioflebotómico
arteriogênese=arteriogénese
arteriotômico=arteriotómico
arteriômero=arteriómero
arteriômetro=arteriómetro
arterogênese=arterogénese
artonômico=artonómico
artrectômico=artrectómico
artrômero=artrómero
artrômetro=artrómetro
artêmide=artémide
artêmio=artémio
arênico=arénico
arômata=arómata
arônia=arónia
asarônico=asarónico
ascalônia=ascalónia
ascalônico=ascalónico
ascogênico=ascogénico
ascogônio=ascogónio
asfaltênico=asfalténico
aspegrênia=aspegrénia
aspermatogênese=aspermatogénese
aspidopirênio=aspidopirénio
aspirofênio=aspirofénio
asplênio=asplénio
assifôneo=assifóneo
assistêmico=assistémico
assêmico=assémico
assêmio=assémio
assírio-babilônico=assírio-babilónico
assômato=assómato
astenômano=astenómano
astereômetro=astereómetro
asterômetro=asterómetro
asterônia=asterónia
asterônimo=asterónimo
astigmômetro=astigmómetro
astinômico=astinómico
astiônimo=astiónimo
astogênese=astogénese
astogênico=astogénico
astragalectômico=astragalectómico
astragalotômico=astragalotómico
astriônica=astriónica
astrofanômetro=astrofanómetro
astrofotômetro=astrofotómetro
astrogênese=astrogénese
astrogênico=astrogénico
astrogônico=astrogónico
astronômico=astronómico
astrômero=astrómero
astrômetro=astrómetro
astrônia=astrónia
astrônimo=astrónimo
astrônio=astrónio
astrônoma=astrónoma
astrônomo=astrónomo
astênico=asténico
astômato=astómato
ataxofêmico=ataxofémico
aterigogênio=aterigogénio
aterogênese=aterogénese
aterogênico=aterogénico
aterogênio=aterogénio
aticoantrotômico=aticoantrotómico
atinotoxêmico=atinotoxémico
atmidômetro=atmidómetro
atmômetro=atmómetro
atraciômetro=atraciómetro
atractômetro=atractómetro
atretolêmico=atretolémico
atretostômico=atretostómico
atrimônio=atrimónio
atrogênico=atrogénico
atrêmico=atrémico
atrônico=atrónico
atômico=atómico
atônico=atónico
atônito=atónito
audiofônico=audiofónico
audiômetro=audiómetro
aulacômelo=aulacómelo
aulacônio=aulacónio
aulônio=aulónio
auquenotômico=auquenotómico
auquenômelo=auquenómelo
aurinotricarbônico=aurinotricarbónico
auritrêmulo=auritrémulo
aurônia=aurónia
austrônoto=austrónoto
ausônida=ausónida
ausônio=ausónio
auto-ônibus=auto-ónibus
autocrômico=autocrómico
autofônico=autofónico
autografômano=autografómano
autografômetro=autografómetro
autogêneo=autogéneo
autogênese=autogénese
autogênico=autogénico
autogônico=autogónico
autonômico=autonómico
autossômico=autossómico
autotômico=autotómico
autômato=autómato
autômetro=autómetro
autômole=autómole
autônimo=autónimo
autônomo=autónomo
auxanômetro=auxanómetro
auximônia=auximónia
auxiômetro=auxiómetro
auxocrômico=auxocrómico
auxotônico=auxotónico
auxômetro=auxómetro
avarigênese=avarigénese
avicênia=avicénia
aviônica=aviónica
axiômetro=axiómetro
axiônimo=axiónimo
axênico=axénico
axômetro=axómetro
axônico=axónico
axônio=axónio
azametônio=azametónio
azobenzênico=azobenzénico
azocarbônico=azocarbónico
azossulfônico=azossulfónico
azotêmico=azotémico
azotômetro=azotómetro
azurcalcedônia=azurcalcedónia
azêmala=azémala
azêmola=azémola
aônida=aónida
aônio=aónio
babilônia=babilónia
babilônico=babilónico
babilônio=babilónio
babingtônia=babingtónia
bacilêmico=bacilémico
bacteriotoxêmico=bacteriotoxémico
bacteriêmico=bacteriémico
baculômetro=baculómetro
bafômetro=bafómetro
baillônia=baillónia
bailômano=bailómano
bailônia=bailónia
baletômano=baletómano
balônoto=balónoto
bandônio=bandónio
bandônion=bandónion
baptistônia=baptistónia
barareômetro=barareómetro
baratrômetro=baratrómetro
baratômetro=baratómetro
barbacênia=barbacénia
barestesiômetro=barestesiómetro
baridrômetro=baridrómetro
barifônico=barifónico
baritônico=baritónico
bariônico=bariónico
barjônia=barjónia
barociclonômetro=barociclonómetro
baroestesiômetro=baroestesiómetro
baromacrômetro=baromacrómetro
barotermoigrômetro=barotermoigrómetro
barotermômetro=barotermómetro
barovariômetro=barovariómetro
barringtônia=barringtónia
bartônia=bartónia
barêmico=barémico
barêmio=barémio
barômetro=barómetro
bascofônico=bascofónico
basicônico=basicónico
basidiogônio=basidiogónio
basigêneo=basigéneo
basiônimo=basiónimo
basônimo=basónimo
bateriotoxêmico=bateriotoxémico
bateriêmico=bateriémico
batipitômetro=batipitómetro
batireômetro=batireómetro
batirreômetro=batirreómetro
batirriônico=batirriónico
batmogênese=batmogénese
batocrômico=batocrómico
batômetro=batómetro
bdelômetro=bdelómetro
beatsônia=beatsónia
beatônia=beatónia
beberrônio=beberrónio
bedsônia=bedsónia
beethovênico=beethovénico
befênio=befénio
begônia=begónia
beladônio=beladónio
beloperônide=beloperónide
belostêmano=belostémano
belostômida=belostómida
belêmia=belémia
belôneon=belóneon
belônia=belónia
belônida=belónida
belônoto=belónoto
bencômia=bencómia
bentogênico=bentogénico
bentônico=bentónico
benzalcônio=benzalcónio
benzenossulfônico=benzenossulfónico
benzetônio=benzetónio
benzilônio=benzilónio
benzossulfônico=benzossulfónico
benzoxônio=benzoxónio
benzênico=benzénico
berberônico=berberónico
berchêmia=berchémia
bergamotênio=bergamoténio
bergaptênico=bergapténico
bergaptênio=bergapténio
bergsônico=bergsónico
bergênia=bergénia
bergômate=bergómate
bertolônia=bertolónia
berônico=berónico
besiclômetro=besiclómetro
bessiclômetro=bessiclómetro
betanaftalênico=betanaftalénico
betatrônio=betatrónio
betleêmico=betleémico
betlêmico=betlémico
betônia=betónia
betônica=betónica
betônica-bastarda=betónica-bastarda
bevônio=bevónio
beômetra=beómetra
biacetenilcarbônico=biacetenilcarbónico
biaquênio=biaquénio
biarmônico=biarmónico
biatômico=biatómico
bibenzônio=bibenzónio
bibiônide=bibiónide
bibliocleptômano=bibliocleptómano
bibliocrômico=bibliocrómico
bibliogênese=bibliogénese
bibliogênico=bibliogénico
biblioteconômico=biblioteconómico
bibliotecônomo=bibliotecónomo
bibliômano=bibliómano
bibliômato=bibliómato
bibliômetra=bibliómetra
bibliônimo=bibliónimo
bichênia=bichénia
bicrônico=bicrónico
bicônico=bicónico
bifonêmico=bifonémico
bignônia=bignónia
bignônica=bignónica
bigêmeo=bigémeo
bigêmino=bigémino
bigênere=bigénere
bigênero=bigénero
bigênito=bigénito
biligênese=biligénese
biligênico=biligénico
biliogênese=biliogénese
biliogênico=biliogénico
bilirrubinêmico=bilirrubinémico
bilênio=bilénio
bimilênio=bimilénio
binômico=binómico
binômine=binómine
binômino=binómino
binômio=binómio
biogênese=biogénese
biogênico=biogénico
biomecatrônico=biomecatrónico
biomônada=biomónada
bionômico=bionómico
biossistêmico=biossistémico
biostrômico=biostrómico
biotrofênio=biotrofénio
biotômico=biotómico
biotônico=biotónico
birquênia=birquénia
birsônima=birsónima
birônia=birónia
bistônio=bistónio
biênico=biénico
biênio=biénio
biômero=biómero
biômetro=biómetro
biônica=biónica
biônico=biónico
biônimo=biónimo
blasfêmia=blasfémia
blastogênese=blastogénese
blastômero=blastómero
blasônico=blasónico
blaudênio=blaudénio
blefaroclônus=blefaroclónus
blematômetro=blematómetro
blemômetro=blemómetro
blêmie=blémie
blênio=blénio
bocquillônia=bocquillónia
bocônia=bocónia
bodincômago=bodincómago
bodiônico=bodiónico
bodônida=bodónida
boedrômio=boedrómio
bolarmênico=bolarménico
bolo-armênio=bolo-arménio
boltênia=bolténia
boltônia=boltónia
bolômetro=bolómetro
bolônio=bolónio
bonemesônia=bonemesónia
bonnemaisônia=bonnemaisónia
boquilônia=boquilónia
borazênico=borazénico
borbônia=borbónia
borbônico=borbónico
borbônio=borbónio
boristênida=boristénida
bosônico=bosónico
botriogênio=botriogénio
bourlingtônia=bourlingtónia
boutônia=boutónia
boêmia=boémia
boêmico=boémico
boêmio=boémio
bracônida=bracónida
bradifrênico=bradifrénico
bradifêmico=bradifémico
bradigênese=bradigénese
branquiômeno=branquiómeno
branquiômero=branquiómero
braquicnêmico=braquicnémico
braquionotômico=braquionotómico
braquiotômico=braquiotómico
braquistocrônico=braquistocrónico
braquiônida=braquiónida
braquiônimo=braquiónimo
brasfêmia=brasfémia
brasênia=brasénia
brasônico=brasónico
brebissônia=brebissónia
bretônico=bretónico
bricômano=bricómano
brindônia=brindónia
brissônia=brissónia
britônico=britónico
britônio=britónio
briônia=briónia
bromatônimo=bromatónimo
bromobenzenossulfônico=bromobenzenossulfónico
bromobenzênico=bromobenzénico
bromonaftalênico=bromonaftalénico
bromotoluênico=bromotoluénico
broncofônico=broncofónico
broncogênico=broncogénico
broncopneumônico=broncopneumónico
broncospirômetro=broncospirómetro
broncotômico=broncotómico
brontômetro=brontómetro
brotolômia=brotolómia
brucinônico=brucinónico
brunônia=brunónia
bruxômano=bruxómano
brêmia=brémia
brômico=brómico
brômide=brómide
brômio=brómio
bubônia=bubónia
bubônico=bubónico
bubônida=bubónida
bubônio=bubónio
buceragênia=buceragénia
buchtiênia=buchtiénia
bucônida=bucónida
buffônia=buffónia
bufônia=bufónia
bulastênico=bulasténico
burlingtônia=burlingtónia
butadiênico=butadiénico
butanônico=butanónico
butedrônico=butedrónico
butilcarbônico=butilcarbónico
butilcetônico=butilcetónico
butilescopolamônio=butilescopolamónio
butilênico=butilénico
butilênio=butilénio
butirômetro=butirómetro
butopiramônio=butopiramónio
byrônico=byrónico
bênia=bénia
bênico=bénico
bônus=bónus
cabelos-de-vênus=cabelos-de-vénus
cabeça-de-santo-antônio=cabeça-de-santo-antónio
cabriônico=cabriónico
cachimônia=cachimónia
cacocrômico=cacocrómico
cacodemonômano=cacodemonómano
cacodemônico=cacodemónico
cacodemônio=cacodemónio
cacofatômano=cacofatómano
cacofonômano=cacofonómano
cacofônico=cacofónico
cacogênese=cacogénese
cacogênico=cacogénico
cacostômico=cacostómico
cacotênico=cacoténico
cacoxênio=cacoxénio
cadinênico=cadinénico
cadrômetro=cadrómetro
cadômelo=cadómelo
cafeidinocarbônico=cafeidinocarbónico
cafeômetro=cafeómetro
caiapônio=caiapónio
caitônia=caitónia
caladênia=caladénia
calameônico=calameónico
calamintônico=calamintónico
calcedônia=calcedónia
calcedônico=calcedónico
calcedônio=calcedónio
calcêmico=calcémico
caledônico=caledónico
caledônida=caledónida
caledônio=caledónio
calicnêmide=calicnémide
calicnêmio=calicnémio
calicnêmis=calicnémis
calicrômico=calicrómico
calidinogênio=calidinogénio
calidônio=calidónio
califônico=califónico
calinotômico=calinotómico
caliptogênio=caliptogénio
caliptronêmida=caliptronémida
calistênico=calisténico
caliêmico=caliémico
calopogônio=calopogónio
caloritrônico=caloritrónico
calômato=calómato
calômetro=calómetro
calônio=calónio
camaleônico=camaleónico
camaleônida=camaleónida
cameleônico=cameleónico
cameleônida=cameleónida
camerônio=camerónio
camisa de Vênus=camisa de Vénus
campenômico=campenómico
campilômetro=campilómetro
campônio=campónio
canabinônico=canabinónico
canabênico=canabénico
canabênio=canabénio
cancerogênico=cancerogénico
cancerêmico=cancerémico
canfilênico=canfilénico
canfocarbônico=canfocarbónico
canfoglicurônico=canfoglicurónico
canfolênico=canfolénico
canforquinônico=canforquinónico
canforômano=canforómano
canforônico=canforónico
canfênico=canfénico
canostômida=canostómida
cantarênico=cantarénico
cantotômico=cantotómico
canônico=canónico
capacitômetro=capacitómetro
caperônia=caperónia
capobênico=capobénico
caprilidênico=caprilidénico
caprilônico=caprilónico
caprinônico=caprinónico
caprolactônico=caprolactónico
caprômio=caprómio
caprônico=caprónico
capsuletômico=capsuletómico
capsulotômico=capsulotómico
capsônio=capsónio
carbazônico=carbazónico
carbogênio=carbogénio
carbonêmico=carbonémico
carbonômetro=carbonómetro
carbênico=carbénico
carbômetro=carbómetro
carbôneo=carbóneo
carbônico=carbónico
carbônio=carbónio
carcinoembriônico=carcinoembriónico
carcinogêneo=carcinogéneo
carcinogênese=carcinogénese
carcinogênico=carcinogénico
cardiastênico=cardiasténico
cardiectômico=cardiectómico
cardiodisêmico=cardiodisémico
cardiodêmico=cardiodémico
cardiogênese=cardiogénese
cardiogênico=cardiogénico
cardiotômico=cardiotómico
cardiotônico=cardiotónico
cardiômero=cardiómero
cardiômetro=cardiómetro
cardênico=cardénico
cardômetro=cardómetro
cariocrômico=cariocrómico
cariogênico=cariogénico
carotenêmico=carotenémico
carotênase=caroténase
carotênico=caroténico
carotênio=caroténio
carpectômico=carpectómico
carpogênese=carpogénese
carpogônio=carpogónio
carpostômio=carpostómio
carprônio=carprónio
carpênico=carpénico
carrimônia=carrimónia
carro-de-vênus=carro-de-vénus
cartômetro=cartómetro
carvenônico=carvenónico
carvomentônico=carvomentónico
carvênico=carvénico
carvênio=carvénio
carvônico=carvónico
carônico=carónico
caseinogênico=caseinogénico
caseinogênio=caseinogénio
caseogênio=caseogénio
cassidônia=cassidónia
cassônico=cassónico
catadrômico=catadrómico
catafônica=catafónica
catafônico=catafónico
catagênese=catagénese
cataleptocatatônico=cataleptocatatónico
catamênio=cataménio
catapiômetro=catapiómetro
cataplônia=cataplónia
catarômetro=catarómetro
catatermômetro=catatermómetro
catatônico=catatónico
catecumênico=catecuménico
catelectrônio=catelectrónio
catetrônio=catetrónio
catetômetro=catetómetro
catiônico=catiónico
catofônico=catofónico
catrimpônia=catrimpónia
catênula=caténula
catônico=catónico
cauchênico=cauchénico
cavernostômico=cavernostómico
caytônia=caytónia
cazalbôni=cazalbóni
caônio=caónio
cebriônida=cebriónida
cecectômico=cecectómico
cecidogênico=cecidogénico
cecidômia=cecidómia
cecidômida=cecidómida
cecocolostômico=cecocolostómico
cecostômico=cecostómico
cecotômico=cecotómico
cefalemômetro=cefalemómetro
cefaloemômetro=cefaloemómetro
cefalogênese=cefalogénese
cefalogênico=cefalogénico
cefalomênico=cefaloménico
cefalotômico=cefalotómico
cefalêmico=cefalémico
cefalômano=cefalómano
cefalômelo=cefalómelo
cefalômetro=cefalómetro
cefalônio=cefalónio
celidectômico=celidectómico
celidônia=celidónia
celidônia-menor=celidónia-menor
celidônico=celidónico
celiectômico=celiectómico
celienterotômico=celienterotómico
celioenterotômico=celioenterotómico
celiogastrotômico=celiogastrotómico
celioisterotômico=celioisterotómico
celiomiomectômico=celiomiomectómico
celiossalpingectômico=celiossalpingectómico
celiotômico=celiotómico
celogênio=celogénio
celossômico=celossómico
celotômico=celotómico
celtofônico=celtofónico
celtômano=celtómano
celulogênese=celulogénese
celômata=celómata
celômico=celómico
cementogênese=cementogénese
cenogênese=cenogénese
centaurômaco=centaurómaco
centradênia=centradénia
centrogênico=centrogénico
centropômida=centropómida
centrossômico=centrossómico
centrotômico=centrotómico
centrômero=centrómero
centrônia=centrónia
centuriônico=centuriónico
centênico=centénico
centênio=centénio
centômano=centómano
centônico=centónico
cenômero=cenómero
ceragênio=ceragénio
cerastotômela=cerastotómela
ceratectômico=ceratectómico
ceratogênese=ceratogénese
ceratogênico=ceratogénico
ceratotômico=ceratotómico
ceratômetro=ceratómetro
ceratônia=ceratónia
ceratônico=ceratónico
ceraulofônio=ceraulofónio
ceraunômetro=ceraunómetro
cercomônade=cercomónade
cercômona=cercómona
cerebrastênico=cerebrasténico
cerebrostênico=cerebrosténico
cerebrotômico=cerebrotómico
cerebrotônico=cerebrotónico
cerebrômetro=cerebrómetro
cerebrômico=cerebrómico
cerebrônico=cerebrónico
cerebrônio=cerebrónio
cerimônia=cerimónia
cerogênico=cerogénico
cerogênio=cerogénio
cerotinônico=cerotinónico
cerotênico=ceroténico
cerulinônico=cerulinónico
cesareotômico=cesareotómico
cestraciônida=cestraciónida
cetalcônio=cetalcónio
cetexônio=cetexónio
cetilbenzênico=cetilbenzénico
cetilmalônico=cetilmalónico
cetiltoluênico=cetiltoluénico
cetilênico=cetilénico
cetogênese=cetogénese
cetogênico=cetogénico
cetogênio=cetogénio
cetonêmico=cetonémico
cetrimônio=cetrimónio
cetênico=ceténico
cetônia=cetónia
cetônico=cetónico
ceutrônico=ceutrónico
charadômano=charadómano
charmônio=charmónio
chercônia=chercónia
chispômetro=chispómetro
chutômetro=chutómetro
cianogênese=cianogénese
cianogênico=cianogénico
cianogênio=cianogénio
cianêmico=cianémico
cianômetro=cianómetro
ciatrônio=ciatrónio
cibisotômico=cibisotómico
cicerônico=cicerónico
ciclanônico=ciclanónico
cicloalcadiênico=cicloalcadiénico
cicloalquênico=cicloalquénico
ciclobutadiênico=ciclobutadiénico
ciclodiatômico=ciclodiatómico
cicloexadiênico=cicloexadiénico
cicloexanodiônico=cicloexanodiónico
cicloexatriênico=cicloexatriénico
cicloexênico=cicloexénico
ciclogênese=ciclogénese
ciclogênico=ciclogénico
ciclonômico=ciclonómico
ciclopentadiênico=ciclopentadiénico
ciclopirrônio=ciclopirrónio
ciclossincrotônico=ciclossincrotónico
ciclossincrotônio=ciclossincrotónio
ciclostômida=ciclostómida
ciclotelêmetro=ciclotelémetro
cicloteruênico=cicloteruénico
ciclotrônio=ciclotrónio
ciclotômico=ciclotómico
ciclênico=ciclénico
ciclômetro=ciclómetro
ciclônico=ciclónico
ciclônio=ciclónio
cicônia=cicónia
cicônida=cicónida
cidmênida=cidménida
cidônia=cidónia
cifônio=cifónio
ciliarotômico=ciliarotómico
ciliectômico=ciliectómico
cilindro-cônico=cilindro-cónico
cilindrocônico=cilindrocónico
cilindrômetro=cilindrómetro
ciliotômico=ciliotómico
cilênia=cilénia
cilênio=cilénio
cimatômetro=cimatómetro
cimogênio=cimogénio
cimênio=ciménio
cimômetro=cimómetro
cimônomo=cimónomo
cinamênio=cinaménio
cinchofênio=cinchofénio
cinchomerônico=cinchomerónico
cinchônea=cinchónea
cinchônico=cinchónico
cintilômetro=cintilómetro
ciocrômico=ciocrómico
cionectômico=cionectómico
cionotômico=cionotómico
ciotômico=ciotómico
cipiônico=cipiónico
cipônima=cipónima
cirsotômico=cirsotómico
cirtômetro=cirtómetro
cistauquenotômico=cistauquenotómico
cistectômico=cistectómico
cisticectômico=cisticectómico
cisticenterostômico=cisticenterostómico
cisticoduodenostômico=cisticoduodenostómico
cisticolestênico=cisticolesténico
cisticolitectômico=cisticolitectómico
cisticotraquelotômico=cisticotraquelotómico
cisticotômico=cisticotómico
cistiectômico=cistiectómico
cistinêmico=cistinémico
cistiotômico=cistiotómico
cistissômida=cistissómida
cistiêmico=cistiémico
cistoclônio=cistoclónio
cistogênico=cistogénico
cistotraquelotômico=cistotraquelotómico
cistotômico=cistotómico
cistoêmico=cistoémico
cistêmico=cistémico
cistômetro=cistómetro
citematômetro=citematómetro
citoarquitectônico=citoarquitectónico
citoarquitetônico=citoarquitetónico
citocrômico=citocrómico
citocrômio=citocrómio
citofotômetro=citofotómetro
citogênese=citogénese
citogênico=citogénico
citogênio=citogénio
citomitômio=citomitómio
citopatogênico=citopatogénico
citopênico=citopénico
citostômico=citostómico
citotaxionômico=citotaxionómico
citotênia=citoténia
citêmico=citémico
citômero=citómero
citômetro=citómetro
citônio=citónio
ciênida=ciénida
ciônida=ciónida
cladogênese=cladogénese
cladogênico=cladogénico
cladomônado=cladomónado
cladonêmida=cladonémida
cladônia=cladónia
clamidomônada=clamidomónada
clamidômona=clamidómona
clarênio=clarénio
clastômano=clastómano
claytônia=claytónia
clazomênio=clazoménio
cleptômano=cleptómano
cleronômico=cleronómico
cletômano=cletómano
cleônia=cleónia
clidectômico=clidectómico
clidotômico=clidotómico
clidênia=clidénia
clidônia=clidónia
cliftônia=cliftónia
climatogênese=climatogénese
climatogênico=climatogénico
climatômetro=climatómetro
climênia=climénia
climênida=climénida
clinoiperstênio=clinoipersténio
clinopiroxênio=clinopiroxénio
clintônia=clintónia
clinêmia=clinémia
clinômano=clinómano
clinômetro=clinómetro
clistogênico=clistogénico
clitoridectômico=clitoridectómico
clitoridotômico=clitoridotómico
clitrômano=clitrómano
clitômano=clitómano
cliônida=cliónida
clodrônico=clodrónico
clopêmano=clopémano
clopômano=clopómano
cloralômano=cloralómano
cloretilênico=cloretilénico
cloretêmico=cloretémico
cloridêmico=cloridémico
cloroanêmico=cloroanémico
clorobenzênico=clorobenzénico
clorocarbônico=clorocarbónico
clorocianogênio=clorocianogénio
clorofônia=clorofónia
clorogênico=clorogénico
clorogônio=clorogónio
cloroiodobenzênico=cloroiodobenzénico
cloroiodonitrobenzênico=cloroiodonitrobenzénico
cloroleucocitêmico=cloroleucocitémico
cloroleucêmico=cloroleucémico
clorolianogênico=clorolianogénico
clorolianogênio=clorolianogénio
cloroprênico=cloroprénico
clorosplênio=clorosplénio
clorossulfônico=clorossulfónico
clorurêmico=clorurémico
clorêmico=clorémico
clorômetro=clorómetro
clupanodônico=clupanodónico
clêmatis=clématis
clêmis=clémis
clênio=clénio
clônico=clónico
cnêmide=cnémide
coagulômetro=coagulómetro
coanotênia=coanoténia
cocainômano=cocainómano
coccigotômico=coccigotómico
cocogênico=cocogénico
cocogônio=cocogónio
codiguêmico=codiguémico
codonofônico=codonofónico
codônida=codónida
colagênico=colagénico
colagênio=colagénio
colalêmico=colalémico
colangienterostômico=colangienterostómico
colangiostômico=colangiostómico
colangiotômico=colangiotómico
colecistectômico=colecistectómico
colecistenterostômico=colecistenterostómico
colecistoduodenostômico=colecistoduodenostómico
colecistogastrotômico=colecistogastrotómico
colecistostômico=colecistostómico
colecistotômico=colecistotómico
colectômico=colectómico
coledocenterostômico=coledocenterostómico
coledocoduodenostômico=coledocoduodenostómico
coledocoenterostômico=coledocoenterostómico
coledocogastrostômico=coledocogastrostómico
coledocolitotômico=coledocolitotómico
coledocostômico=coledocostómico
coledocotômico=coledocotómico
colelitotômico=colelitotómico
colerigênico=colerigénico
colerogênico=colerogénico
colerômano=colerómano
colesteatômico=colesteatómico
colesterinêmico=colesterinémico
colesterologênese=colesterologénese
colesterolêmico=colesterolémico
colesterêmico=colesterémico
coletômico=coletómico
colfisterectômico=colfisterectómico
colfisterostômico=colfisterostómico
colibacilêmico=colibacilémico
colinsônia=colinsónia
collinsônia=collinsónia
colobacilêmico=colobacilémico
colocolostômico=colocolostómico
colofênio=colofénio
colofônia=colofónia
colofônio=colofónio
coloidômico=coloidómico
colorretostômico=colorretostómico
colossigmoidostômico=colossigmoidostómico
colostômico=colostómico
colotômico=colotómico
colpectômico=colpectómico
colpisterectômico=colpisterectómico
colpisteropectômico=colpisteropectómico
colpisterostômico=colpisterostómico
colpoceliotômico=colpoceliotómico
colpocistotômico=colpocistotómico
colpocisturetrocistostômico=colpocisturetrocistostómico
colpomiomectômico=colpomiomectómico
colpomiotômico=colpomiotómico
colpoproctectômico=colpoproctectómico
colpoproctotômico=colpoproctotómico
colpotômico=colpotómico
colpônico=colpónico
colêmese=colémese
colêmico=colémico
colênis=colénis
colômia=colómia
colônia=colónia
colônico=colónico
comedogênico=comedogénico
comissurotômico=comissurotómico
compressômetro=compressómetro
compônio=compónio
comênico=coménico
concanônico=concanónico
concotômico=concotómico
concômetro=concómetro
condilotômico=condilotómico
condradenômico=condradenómico
condrectômico=condrectómico
condrinogênio=condrinogénio
condriossômico=condriossómico
condriômero=condriómero
condriômico=condriómico
condroadenômico=condroadenómico
condroangiômico=condroangiómico
condroblastômico=condroblastómico
condroendoteliômico=condroendoteliómico
condrofibrômico=condrofibrómico
condrogênese=condrogénese
condrogênico=condrogénico
condrogênio=condrogénio
condrolipômico=condrolipómico
condromixossarcômico=condromixossarcómico
condrossarcômico=condrossarcómico
condrotômico=condrotómico
condrômetro=condrómetro
condrômice=condrómice
condrômico=condrómico
condutômetro=condutómetro
condômino=condómino
congênere=congénere
congênito=congénito
conidiômico=conidiómico
coniômetro=coniómetro
consistômetro=consistómetro
conta-quilômetro=conta-quilómetro
contarênia=contarénia
contra-harmônico=contra-harmónico
contra-homônimo=contra-homónimo
contrassistêmico=contrassistémico
convênio=convénio
conômetro=conómetro
coordenatômetro=coordenatómetro
coordinatômetro=coordinatómetro
copofônico=copofónico
coprêmese=coprémese
coprêmico=coprémico
coprômano=coprómano
coprômico=coprómico
corbulômio=corbulómio
cordectômico=cordectómico
cordofônico=cordofónico
cordofônio=cordofónio
cordotômico=cordotómico
cordômetro=cordómetro
corectômico=corectómico
coretômico=coretómico
coreômano=coreómano
corifênida=corifénida
corindônico=corindónico
corioadenômico=corioadenómico
corioangiômico=corioangiómico
corissômero=corissómero
coriônico=coriónico
cornofônico=cornofónico
cornofônio=cornofónio
coroidectômico=coroidectómico
correntômetro=correntómetro
corticosterônico=corticosterónico
cortisônico=cortisónico
cortonômico=cortonómico
corêmetro=corémetro
corêmio=corémio
corônide=corónide
corônimo=corónimo
corônio=corónio
corônis=corónis
corônopo=corónopo
corônula=corónula
cosmodrômico=cosmodrómico
cosmogênese=cosmogénese
cosmogênico=cosmogénico
cosmogônico=cosmogónico
cosmonômico=cosmonómico
cosmômetra=cosmómetra
costectômico=costectómico
costofrênico=costofrénico
costotransversectômico=costotransversectómico
costotômico=costotómico
cotarnônico=cotarnónico
cotiledôneo=cotiledóneo
coulômetro=coulómetro
courbônia=courbónia
coxotômico=coxotómico
crabônida=crabónida
crangônida=crangónida
craniectômico=craniectómico
cranioanfitômico=cranioanfitómico
cranioplagiômetro=cranioplagiómetro
craniotômico=craniotómico
craniômetro=craniómetro
craterômio=craterómio
cratogênico=cratogénico
cratônico=cratónico
creatinêmico=creatinémico
crematonômico=crematonómico
cremnômetro=cremnómetro
cremômetro=cremómetro
crenônimo=crenónimo
creogênico=creogénico
cresilglicurônico=cresilglicurónico
cresilpropiônico=cresilpropiónico
cricetômio=cricetómio
cricoidectômico=cricoidectómico
cricostômico=cricostómico
cricotireotômico=cricotireotómico
cricotômico=cricotómico
criminogênese=criminogénese
criminogênico=criminogénico
crinômiro=crinómiro
crioeletrônico=crioeletrónico
criogênico=criogénico
criogênio=criogénio
criotrônio=criotrónio
criptadênia=criptadénia
cripterônia=cripterónia
criptocotiledôneo=criptocotiledóneo
criptofônio=criptofónio
criptogênese=criptogénese
criptogênico=criptogénico
criptomônade=criptomónade
criptômero=criptómero
criptômetro=criptómetro
criptômona=criptómona
criptônico=criptónico
criptônimo=criptónimo
criptônio=criptónio
crisedônico=crisedónico
crisimênia=crisiménia
crisofênico=crisofénico
crisogênico=crisogénico
crisogênio=crisogénio
crisogônia=crisogónia
crisonômico=crisonómico
crisoquinônico=crisoquinónico
crisosplênio=crisosplénio
crisotêmide=crisotémide
cristalatômico=cristalatómico
cristaloatômico=cristaloatómico
cristalogênese=cristalogénese
cristalogênico=cristalogénico
cristalonômico=cristalonómico
cristalotômico=cristalotómico
cristômaco=cristómaco
crisênico=crisénico
crisênio=crisénio
crisômela=crisómela
crisômelo=crisómelo
crisônomo=crisónomo
critogênese=critogénese
critônia=critónia
criômetro=criómetro
crocônico=crocónico
crocônio=crocónio
cromatogênico=cromatogénico
cromatoptômetro=cromatoptómetro
cromatômetro=cromatómetro
cromocitômetro=cromocitómetro
cromofônico=cromofónico
cromogêneo=cromogéneo
cromogênese=cromogénese
cromogênico=cromogénico
cromogênio=cromogénio
cromomolibdênico=cromomolibdénico
cromomolibdênio=cromomolibdénio
cromonêmico=cromonémico
cromoplastofônico=cromoplastofónico
cromoptômetro=cromoptómetro
cromorradiômetro=cromorradiómetro
cromossômico=cromossómico
cromossômio=cromossómio
cromômero=cromómero
cromômetro=cromómetro
crondiossômico=crondiossómico
cronofônico=cronofónico
cronogoniômetro=cronogoniómetro
cronogênese=cronogénese
cronomegafônico=cronomegafónico
cronotelêmetro=cronotelémetro
cronêmico=cronémico
cronômetro=cronómetro
cronônimo=cronónimo
crotacônico=crotacónico
crotofônio=crotofónio
crotonilênico=crotonilénico
crotopodômano=crotopodómano
crotônico=crotónico
croômia=croómia
crucigênia=crucigénia
cruômano=cruómano
crênico=crénico
crênula=crénula
crômico=crómico
crômida=crómida
crômio=crómio
crômula=crómula
crônica=crónica
crônico=crónico
crônicon=crónicon
ctenotênia=ctenoténia
ctonogênico=ctonogénico
ctonogênio=ctonogénio
ctênida=cténida
ctênio=cténio
ctênodon=cténodon
ctênomo=cténomo
ctônico=ctónico
ctônio=ctónio
cubebênico=cubebénico
cubebênio=cubebénio
cufênio=cufénio
culturêmico=culturémico
cultômano=cultómano
cumarônico=cumarónico
cumazônico=cumazónico
cuneoisterectômico=cuneoisterectómico
cunônia=cunónia
cupramônio=cupramónio
cupriamônico=cupriamónico
cuproamônia=cuproamónia
cuproamônico=cuproamónico
cuprocrômico=cuprocrómico
curculiônida=curculiónida
curiônia=curiónia
cursômetro=cursómetro
cursônia=cursónia
cussônia=cussónia
cênia=cénia
cênico=cénico
cênio=cénio
cênis=cénis
cômaro=cómaro
cômedo=cómedo
cômica=cómica
cômico=cómico
cômio=cómio
cômoda=cómoda
cômodo=cómodo
cômoro=cómoro
cônega=cónega
cônego=cónego
cônica=cónica
cônico=cónico
cônida=cónida
cônio=cónio
dacnomonômano=dacnomonómano
dacnômano=dacnómano
dacriadenectômico=dacriadenectómico
dacriocistectômico=dacriocistectómico
dacriocistorrinostômico=dacriocistorrinostómico
dacriocistossiringotômico=dacriocistossiringotómico
dacriocistotômico=dacriocistotómico
dacriostômico=dacriostómico
dacriômice=dacriómice
dacurônio=dacurónio
daltônico=daltónico
damasônio=damasónio
darlingtônia=darlingtónia
decamerônico=decamerónico
decametônio=decametónio
declinômetro=declinómetro
decênio=decénio
deditônio=deditónio
degênere=degénere
demoniômano=demoniómano
demonômano=demonómano
demostênico=demosténico
demônico=demónico
demônio=demónio
denatônio=denatónio
dendrotômico=dendrotómico
dendrômetro=dendrómetro
densitômetro=densitómetro
dermatotômico=dermatotómico
derotômico=derotómico
desarmônico=desarmónico
descerimônia=descerimónia
desconfiômetro=desconfiómetro
descômodo=descómodo
desidrogênase=desidrogénase
desidrêmico=desidrémico
desmacidônida=desmacidónida
desmodrômico=desmodrómico
desmotômico=desmotómico
desviômetro=desviómetro
deuterocanônico=deuterocanónico
deuterocômide=deuterocómide
deuterocônia=deuterocónia
deuterogênese=deuterogénese
deuterogênico=deuterogénico
deuteronômico=deuteronómico
deuteronômio=deuteronómio
deuterostômico=deuterostómico
deuterostômio=deuterostómio
deuterotônico=deuterotónico
deutialossômico=deutialossómico
deutoneurônico=deutoneurónico
deutoneurônio=deutoneurónio
deutossômico=deutossómico
deutômala=deutómala
devônico=devónico
dextrinogênico=dextrinogénico
dextrômano=dextrómano
diabetogênese=diabetogénese
diabetogênico=diabetogénico
diabetômetro=diabetómetro
diabriônia=diabriónia
diabriônico=diabriónico
diacetilacetônico=diacetilacetónico
diacetilenodicarbônico=diacetilenodicarbónico
diacetilênico=diacetilénico
diacetinilcarbônico=diacetinilcarbónico
diacetêmico=diacetémico
diacetônico=diacetónico
diacidônio=diacidónio
diacolpoproctectômico=diacolpoproctectómico
diacrômico=diacrómico
diacrônico=diacrónico
diacônico=diacónico
diadêmida=diadémida
diadênio=diadénio
diafanômetro=diafanómetro
diafisectômico=diafisectómico
diafonômetro=diafonómetro
diafragmômetro=diafragmómetro
diafônico=diafónico
diafônio=diafónio
diagênese=diagénese
diagômetro=diagómetro
dialiostêmone=dialiostémone
dialistêmone=dialistémone
dialitostêmone=dialitostémone
diamagnetômetro=diamagnetómetro
diamasêmico=diamasémico
diamidogênico=diamidogénico
diamidogênio=diamidogénio
diamidopropiônico=diamidopropiónico
diaminobenzênico=diaminobenzénico
diaminogênio=diaminogénio
diamônico=diamónico
diamônio=diamónio
dianiônico=dianiónico
dianomômetro=dianomómetro
diantracênico=diantracénico
diapnogênico=diapnogénico
diapnômetro=diapnómetro
diaquênio=diaquénio
diarrêmico=diarrémico
diarsênico=diarsénico
diarsênio=diarsénio
diarsônico=diarsónico
diarsônio=diarsónio
diasporômetro=diasporómetro
diassintônico=diassintónico
diassistêmico=diassistémico
diassênico=diassénico
diastasiômetro=diastasiómetro
diastasêmico=diastasémico
diastemômetro=diastemómetro
diastereoisômetro=diastereoisómetro
diastesêmico=diastesémico
diastimômetro=diastimómetro
diastêmico=diastémico
diastômetro=diastómetro
diatômico=diatómico
diatônico=diatónico
diazaminobenzênico=diazaminobenzénico
diazetanossulfônico=diazetanossulfónico
diazoaminobenzênico=diazoaminobenzénico
diazobenzolsulfônico=diazobenzolsulfónico
diazobenzênico=diazobenzénico
diazoxiaminobenzênico=diazoxiaminobenzénico
diazônico=diazónico
diazônio=diazónio
dibenzilacetônico=dibenzilacetónico
dibenzilocarbônico=dibenzilocarbónico
dibenzoilobenzênico=dibenzoilobenzénico
dibenzoilomalônico=dibenzoilomalónico
dibromantraquinônico=dibromantraquinónico
dibromobenzênico=dibromobenzénico
dibromopropiônico=dibromopropiónico
dicanfenodiônico=dicanfenodiónico
dicetônico=dicetónico
dicianogênio=dicianogénio
diciêmida=diciémida
diciêmio=diciémio
diciônico=diciónico
diclidotômico=diclidotómico
dicloracetônico=dicloracetónico
dicloroacetônico=dicloroacetónico
diclorobenzênico=diclorobenzénico
dicloropropilênico=dicloropropilénico
diclônico=diclónico
dicoriônico=dicoriónico
dicotiledônea=dicotiledónea
dicotiledôneo=dicotiledóneo
dicotômico=dicotómico
dicranotênia=dicranoténia
dicresiletilênico=dicresiletilénico
dicresilopropiônico=dicresilopropiónico
dicrômico=dicrómico
dicsônia=dicsónia
dictiossômico=dictiossómico
dicômice=dicómice
didimozoônida=didimozoónida
didêmnida=didémnida
diedrogomômetro=diedrogomómetro
diedrogoniômetro=diedrogoniómetro
dietilacetônico=dietilacetónico
dietilamônio=dietilamónio
dietilcetônico=dietilcetónico
dietiloacetônico=dietiloacetónico
dietilobenzênico=dietilobenzénico
dietilofenilopropiônico=dietilofenilopropiónico
dietilênico=dietilénico
difenilcetônico=difenilcetónico
difeniletilênico=difeniletilénico
difenililênico=difenililénico
difenilobenzênico=difenilobenzénico
difenilodicloretilênico=difenilodicloretilénico
difenilofenilênico=difenilofenilénico
difenilopropiônico=difenilopropiónico
difenilsulfônico=difenilsulfónico
difenilênico=difenilénico
diferenciômetro=diferenciómetro
difigênico=difigénico
difosgênio=difosgénio
difractômetro=difractómetro
difratômetro=difratómetro
diftônico=diftónico
difusiômetro=difusiómetro
difênico=difénico
difônico=difónico
digitalênico=digitalénico
digitalônico=digitalónico
digoxigênico=digoxigénico
digênese=digénese
digênico=digénico
digênie=digénie
dilatômetro=dilatómetro
dillênia=dillénia
dilênia=dilénia
dimecolônio=dimecolónio
dimentoxiviolantrônico=dimentoxiviolantrónico
dimerômice=dimerómice
dimetilacetilênico=dimetilacetilénico
dimetilbenzênico=dimetilbenzénico
dimetilcetônico=dimetilcetónico
dimetiletilobenzênico=dimetiletilobenzénico
dimetiletilênico=dimetiletilénico
dimetilmalônico=dimetilmalónico
dimetilobenzênico=dimetilobenzénico
dimorfômice=dimorfómice
dinaftalenossulfônico=dinaftalenossulfónico
dinamiogênese=dinamiogénese
dinamiogênico=dinamiogénico
dinamiômetro=dinamiómetro
dinamogênese=dinamogénese
dinamogênico=dinamogénico
dinamostênico=dinamosténico
dinamostênio=dinamosténio
dinamômetro=dinamómetro
dinarmônico=dinarmónico
dinatrônio=dinatrónio
dinitrobenzênico=dinitrobenzénico
dinitrofenilidrazônico=dinitrofenilidrazónico
dinitrogênico=dinitrogénico
dinitrogênio=dinitrogénio
dinitronaftalênico=dinitronaftalénico
dinitrostricnolcarbônico=dinitrostricnolcarbónico
dinitrotoluênico=dinitrotoluénico
dinomônada=dinomónada
dioctilacetônico=dioctilacetónico
diopsiômetro=diopsiómetro
dioptrômetro=dioptrómetro
dioptômetro=dioptómetro
diosmaleoptênico=diosmaleopténico
dioxiantraquinônico=dioxiantraquinónico
dioxifenantrênico=dioxifenantrénico
dioxiflavônico=dioxiflavónico
dioximalônico=dioximalónico
dipentênico=dipenténico
dipirrilmetênico=dipirrilmeténico
dipirênico=dipirénico
dipladênia=dipladénia
diplofônico=diplofónico
diplogênese=diplogénese
diplopartenogênese=diplopartenogénese
diplopiômetro=diplopiómetro
diplostêmone=diplostémone
diplômetro=diplómetro
dipneumôneo=dipneumóneo
dipnêumone=dipnéumone
dipsômano=dipsómano
dipônio=dipónio
disarteriotônico=disarteriotónico
disblênico=disblénico
discrômico=discrómico
discômetro=discómetro
discômite=discómite
discômito=discómito
discômodo=discómodo
disedemônico=disedemónico
disembrioplasmômico=disembrioplasmómico
disembriômico=disembriómico
disfogênio=disfogénio
disfrênico=disfrénico
disfêmico=disfémico
disfônico=disfónico
disgerminômico=disgerminómico
disgênico=disgénico
disgônico=disgónico
disidemônia=disidemónia
disiquônio=disiquónio
dislipidêmico=dislipidémico
dismiotônico=dismiotónico
dismênico=disménico
disontogênese=disontogénese
disontogênico=disontogénico
disparêunico=disparéunico
dispnêumico=dispnéumico
dissintônico=dissintónico
dissêmico=dissémico
dissômico=dissómico
distanciômetro=distanciómetro
distirênico=distirénico
distorciômetro=distorciómetro
distêmone=distémone
distênico=disténico
distênio=disténio
distômico=distómico
distômida=distómida
distômio=distómio
distônico=distónico
disêmese=disémese
disêmico=disémico
disômico=disómico
ditafônico=ditafónico
diterpênico=diterpénico
ditetraetilamônio=ditetraetilamónio
ditiocarbônico=ditiocarbónico
ditizônico=ditizónico
ditiênico=ditiénico
ditiônico=ditiónico
diverticulectômico=diverticulectómico
diênia=diénia
diênico=diénico
dodecafônico=dodecafónico
dodecasêmico=dodecasémico
dodecatônico=dodecatónico
dodecilênico=dodecilénico
dodeclônio=dodeclónio
dodônico=dodónico
dodônide=dodónide
dodônio=dodónio
dolicocnêmico=dolicocnémico
dolicônico=dolicónico
doliônio=doliónio
dolmênico=dolménico
dolômico=dolómico
donaldsônia=donaldsónia
dopsônico=dopsónico
dorstênia=dorsténia
dorônico=dorónico
dotefônio=dotefónio
dotônida=dotónida
doxômano=doxómano
drimônia=drimónia
dromômano=dromómano
dromômetro=dromómetro
drosômetro=drosómetro
dumnônio=dumnónio
duodecênio=duodecénio
duodenocistotômico=duodenocistotómico
duodenocoledocotômico=duodenocoledocotómico
duodenoenterostômico=duodenoenterostómico
duodenoileostômico=duodenoileostómico
duodenojejunostômico=duodenojejunostómico
duodenopancreatectômico=duodenopancreatectómico
duodenostômico=duodenostómico
duodenotômico=duodenotómico
duopsônio=duopsónio
durematômico=durematómico
durênico=durénico
durênio=durénio
durômetro=durómetro
dêmia=démia
dêmico=démico
dêmodex=démodex
dêmone=démone
dômico=dómico
dômina=dómina
dônace=dónace
dônia=dónia
eastônia=eastónia
eatônia=eatónia
eberthêmico=eberthémico
ebuliômetro=ebuliómetro
ecdêmico=ecdémico
ecfonêmico=ecfonémico
eclesiogênese=eclesiogénese
eclinômetro=eclinómetro
ecofênio=ecofénio
ecofônico=ecofónico
ecogênese=ecogénese
ecogênico=ecogénico
ecogônia=ecogónia
ecomônade=ecomónade
econômetra=económetra
econômico=económico
econômico-financeiro=económico-financeiro
econômico-social=económico-social
ecossistêmico=ecossistémico
ecronômetro=ecronómetro
ectimogênio=ectimogénio
ectotoxêmico=ectotoxémico
ectrogênico=ectrogénico
ectrômele=ectrómele
ectrômelo=ectrómelo
ectômero=ectómero
ecumênico=ecuménico
eczemogênio=eczemogénio
ecômetro=ecómetro
ecômona=ecómona
ecônomo=ecónomo
edafônico=edafónico
edeotômico=edeotómico
ediôniquis=edióniquis
edogônio=edogónio
edrofônico=edrofónico
edrofônio=edrofónio
edêmone=edémone
edênico=edénico
edômetro=edómetro
edônio=edónio
efarmônico=efarmónico
efebogênese=efebogénese
efusiômetro=efusiómetro
efêmero=efémero
egobroncofônico=egobroncofónico
egodistônico=egodistónico
egofônico=egofónico
egosintônico=egosintónico
einstêinico=einstéinico
einstênico=einsténico
einstênio=einsténio
elaiômetro=elaiómetro
elastogênese=elastogénese
elastogênico=elastogénico
elastômero=elastómero
elastômetro=elastómetro
elaterômetro=elaterómetro
electrodinamômetro=electrodinamómetro
electroelectrônico=electroelectrónico
electrofônico=electrofónico
electrofônio=electrofónio
electrogênese=electrogénese
electroigrômetro=electroigrómetro
electrômetro=electrómetro
eleoplanctônico=eleoplanctónico
eleoptênio=eleopténio
eletreletrônico=eletreletrónico
eletrobiogênese=eletrobiogénese
eletrocrômico=eletrocrómico
eletrodinamômetro=eletrodinamómetro
eletroeletrônico=eletroeletrónico
eletrofotômetro=eletrofotómetro
eletrofônico=eletrofónico
eletrofônio=eletrofónio
eletrogênese=eletrogénese
eletroigrômetro=eletroigrómetro
eletromicrômetro=eletromicrómetro
eletropirômetro=eletropirómetro
eletrorradiômetro=eletrorradiómetro
eletrosselênio=eletrosselénio
eletrotônico=eletrotónico
eletrotônus=eletrotónus
eletrovegetômetro=eletrovegetómetro
eletrozônico=eletrozónico
eletrozônio=eletrozónio
eletrômero=eletrómero
eletrômetro=eletrómetro
eletrônico=eletrónico
eletrônio=eletrónio
eleuterostêmone=eleuterostémone
eleuterômano=eleuterómano
eleômetro=eleómetro
elipsômetro=elipsómetro
elitrotômico=elitrotómico
eliômis=eliómis
elêmico=elémico
elênia=elénia
embletônia=embletónia
embolectômico=embolectómico
embolêmico=embolémico
embolômero=embolómero
embriogênese=embriogénese
embriogênico=embriogénico
embrioperitônico=embrioperitónico
embriotômico=embriotómico
embriônico=embriónico
emenogênico=emenogénico
emeprônio=emeprónio
emirônio=emirónio
empedêmia=empedémia
emênico=eménico
emônida=emónida
enalogênico=enalogénico
enantiossêmico=enantiossémico
enantiômero=enantiómero
enarmônico=enarmónico
encefalotômico=encefalotómico
encefalêmico=encefalémico
encefalômero=encefalómero
encefalômetro=encefalómetro
enclinômeno=enclinómeno
encênia=encénia
encênio=encénio
encômio=encómio
endectômico=endectómico
endemepidêmico=endemepidémico
endemoepidêmico=endemoepidémico
endemônico=endemónico
endergônico=endergónico
enderônico=enderónico
endogastrectômico=endogastrectómico
endogênese=endogénese
endogênico=endogénico
endogônio=endogónio
endometrectômico=endometrectómico
endosmômetro=endosmómetro
endostômio=endostómio
endrômide=endrómide
endrômina=endrómina
endrômio=endrómio
endêmico=endémico
endômice=endómice
endômico=endómico
energumênico=energuménico
engenheiro-agrônomo=engenheiro-agrónomo
enobarômetro=enobarómetro
enocromômetro=enocromómetro
enomanômetro=enomanómetro
enoseômano=enoseómano
enslênia=enslénia
enteradênico=enteradénico
enteradênio=enteradénio
enterectômico=enterectómico
enterocolostômico=enterocolostómico
enterogastrônico=enterogastrónico
enteromônade=enteromónade
enterostômico=enterostómico
enterotoxêmico=enterotoxémico
enterotômico=enterotómico
enterêmico=enterémico
enterômetro=enterómetro
enterômona=enterómona
enteômano=enteómano
entofitogênese=entofitogénese
entomogênio=entomogénio
entonêmico=entonémico
entozoogênese=entozoogénese
entômico=entómico
enxertômetro=enxertómetro
enzimômetro=enzimómetro
enzêmola=enzémola
enêmico=enémico
enômano=enómano
enômetro=enómetro
eocênico=eocénico
eodevônico=eodevónico
eogênico=eogénico
eosinopênico=eosinopénico
epacrômia=epacrómia
epagômeno=epagómeno
epicistotômico=epicistotómico
epictônio=epictónio
epicênio=epicénio
epididimectômico=epididimectómico
epidêmico=epidémico
epidêmio=epidémio
epifenomênico=epifenoménico
epifenômeno=epifenómeno
epifonêmico=epifonémico
epifrênico=epifrénico
epiginômeno=epiginómeno
epiglotidectômico=epiglotidectómico
epigênese=epigénese
epigênico=epigénico
epigônico=epigónico
epigônio=epigónio
epileptogênese=epileptogénese
epileptogênico=epileptogénico
epimênide=epiménide
epimênio=epiménio
epiplanctônico=epiplanctónico
epipodômetro=epipodómetro
epirogênese=epirogénese
epirogênico=epirogénico
episcênio=episcénio
episiotômico=episiotómico
epissômico=epissómico
epistemônimo=epistemónimo
epistêmico=epistémico
epistômio=epistómio
epitetômano=epitetómano
epitêmia=epitémia
epiômida=epiómida
epiônico=epiónico
epoxipropiônico=epoxipropiónico
epoxistilênico=epoxistilénico
epônimo=epónimo
equinômetro=equinómetro
equiônio=equiónio
erastênico=erasténico
eremônimo=eremónimo
ergasiômano=ergasiómano
ergastênico=ergasténico
ergiômetro=ergiómetro
ergogênese=ergogénese
ergogênico=ergogénico
ergonômico=ergonómico
ergômano=ergómano
ergômetro=ergómetro
ergônimo=ergónimo
ergônio=ergónio
ergônomo=ergónomo
eriadênia=eriadénia
erictônio=erictónio
eriostêmone=eriostémone
eriostêmono=eriostémono
eritematogênio=eritematogénio
eritemogênio=eritemogénio
eritrocitômetro=eritrocitómetro
eritrogênio=eritrogénio
eritrêmico=eritrémico
eritrônico=eritrónico
eritrônio=eritrónio
eritêmato=eritémato
eriômetro=eriómetro
erotogênio=erotogénio
erotômano=erotómano
errônea=errónea
errôneo=erróneo
erêmia=erémia
escallônia=escallónia
escalênico=escalénico
escalômetro=escalómetro
escalônia=escalónia
escamônea=escamónea
escamônea-de-mompilher=escamónea-de-mompilher
escamônia=escamónia
escamônico=escamónico
escapulectômico=escapulectómico
escatofônico=escatofónico
escatolcarbônico=escatolcarbónico
escatolcromogênio=escatolcromogénio
esclavônico=esclavónico
esclavônio=esclavónio
escleraxônia=escleraxónia
esclerectômico=esclerectómico
esclerogênico=esclerogénico
esclerogênio=esclerogénio
escleroticotômico=escleroticotómico
esclerotômico=esclerotómico
esclerômero=esclerómero
esclerômetro=esclerómetro
esclerônomo=esclerónomo
escoliômetro=escoliómetro
escorbutigênico=escorbutigénico
escorodônia=escorodónia
escorpiônico=escorpiónico
escorpênida=escorpénida
escribômano=escribómano
escriônico=escriónico
escrotectômico=escrotectómico
esfenômetro=esfenómetro
esferômetro=esferómetro
esferômida=esferómida
esfigmobolômetro=esfigmobolómetro
esfigmodinamômetro=esfigmodinamómetro
esfigmofônico=esfigmofónico
esfigmofônio=esfigmofónio
esfigmomanômetro=esfigmomanómetro
esfigmômetro=esfigmómetro
esfincterectômico=esfincterectómico
esfincterotômico=esfincterotómico
esfingômetro=esfingómetro
esfirectômico=esfirectómico
esfirotômico=esfirotómico
esfirênida=esfirénida
esfênico=esfénico
esfênio=esfénio
esfênopo=esfénopo
eslavofônico=eslavofónico
eslavônico=eslavónico
eslavônio=eslavónio
eslovênico=eslovénico
esofagectômico=esofagectómico
esofagogastrotômico=esofagogastrotómico
esofagostômico=esofagostómico
esofagotômico=esofagotómico
esofagômetro=esofagómetro
espasmogênico=espasmogénico
espectrobolômetro=espectrobolómetro
espectrofluorômetro=espectrofluorómetro
espectrofotômetro=espectrofotómetro
espectronatrômetro=espectronatrómetro
espectrômetro=espectrómetro
espeleotômico=espeleotómico
espeleônimo=espeleónimo
espelho-de-vênus=espelho-de-vénus
espermagênese=espermagénese
espermagônico=espermagónico
espermagônio=espermagónio
espermatocistectômico=espermatocistectómico
espermatogênese=espermatogénese
espermatogênico=espermatogénico
espermatogônico=espermatogónico
espermatogônio=espermatogónio
espermiogênese=espermiogénese
espermogônico=espermogónico
espermogônio=espermogónio
esperqueônida=esperqueónida
espetrofotômetro=espetrofotómetro
espetronatrômetro=espetronatrómetro
espetrômetro=espetrómetro
espintarômetro=espintarómetro
espinterômetro=espinterómetro
espirostômida=espirostómida
espirotênia=espiroténia
espirômetro=espirómetro
esplancnicectômico=esplancnicectómico
esplancnicotômico=esplancnicotómico
esplancnotômico=esplancnotómico
esplancnômero=esplancnómero
esplenectômico=esplenectómico
esplenofrênico=esplenofrénico
esplenopneumônico=esplenopneumónico
esplenotômico=esplenotómico
esplenêmico=esplenémico
esplênico=esplénico
esplênio=esplénio
espodumênio=espoduménio
espondilectômico=espondilectómico
espongômona=espongómona
esporogênese=esporogénese
esporogênio=esporogénio
esporogônio=esporogónio
esquistossômulo=esquistossómulo
esquistômetro=esquistómetro
esquizimênia=esquiziménia
esquizofrênico=esquizofrénico
esquizogênese=esquizogénese
esquizogênio=esquizogénio
esquizogônico=esquizogónico
esquizogônio=esquizogónio
esquizossacarômice=esquizossacarómice
esquizômido=esquizómido
essedônio=essedónio
essênio=essénio
estadiômetro=estadiómetro
estafilectômico=estafilectómico
estafilotômico=estafilotómico
estalagmômetro=estalagmómetro
estapedectômico=estapedectómico
estasigênese=estasigénese
estatômetro=estatómetro
estauntônia=estauntónia
estearoptênio=estearopténio
esteatadenômico=esteatadenómico
esteatômio=esteatómio
estecogênico=estecogénico
estefanocênia=estefanocénia
estefanômetro=estefanómetro
estefanômia=estefanómia
esteganotênia=esteganoténia
estenaquênio=estenaquénio
estenômetro=estenómetro
estenômona=estenómona
estenônimo=estenónimo
estequiogênico=estequiogénico
estercorêmico=estercorémico
estercurônio=estercurónio
estereocrômico=estereocrómico
estereofotômetro=estereofotómetro
estereofônico=estereofónico
estereogoniômetro=estereogoniómetro
estereoisômere=estereoisómere
estereoisômero=estereoisómero
estereomicrômetro=estereomicrómetro
estereonômico=estereonómico
estereotelêmetro=estereotelémetro
estereotopômetro=estereotopómetro
estereotômico=estereotómico
estereômetro=estereómetro
esternogoniômetro=esternogoniómetro
esternotômico=esternotómico
esterotômico=esterotómico
estesiogênico=estesiogénico
estesiotômico=estesiotómico
estesiômano=estesiómano
estesiômetro=estesiómetro
estetofonômetro=estetofonómetro
estetogoniômetro=estetogoniómetro
estetômetro=estetómetro
estevênia=estevénia
estibônio=estibónio
estigeoclônio=estigeoclónio
estigmatômice=estigmatómice
estigmatônimo=estigmatónimo
estigmônimo=estigmónimo
estilbênico=estilbénico
estiloquitônia=estiloquitónia
estilostêmono=estilostémono
estilômetro=estilómetro
estilônio=estilónio
estimpsônia=estimpsónia
estirolênico=estirolénico
estirênico=estirénico
estiômeno=estiómeno
estomatomênico=estomatoménico
estomatômico=estomatómico
estrabismômetro=estrabismómetro
estrabotômico=estrabotómico
estrabômetro=estrabómetro
estrabônia=estrabónia
estrabônico=estrabónico
estramônio=estramónio
estratonômico=estratonómico
estratômetro=estratómetro
estreptococêmico=estreptococémico
estressômetro=estressómetro
estretococêmico=estretococémico
estricninodissulfônico=estricninodissulfónico
estricninomonossulfônico=estricninomonossulfónico
estricninossulfônico=estricninossulfónico
estricnômano=estricnómano
estricturotômico=estricturotómico
estrimônio=estrimónio
estriturotômico=estriturotómico
estrogênico=estrogénico
estrogênio=estrogénio
estruciônida=estruciónida
estrumectômico=estrumectómico
estrutiônida=estrutiónida
estrênuo=estrénuo
estrômano=estrómano
estrômato=estrómato
esturiônida=esturiónida
esturiônio=esturiónio
esturônida=esturónida
esturônio=esturónio
estêmato=estémato
estêmone=estémone
estênia=esténia
estênico=esténico
estênopo=esténopo
estômato=estómato
estômia=estómia
estômis=estómis
estônico=estónico
estônio=estónio
esvietênia=esvieténia
etanossulfônico=etanossulfónico
etanotetracarbônico=etanotetracarbónico
eterômano=eterómano
etidrônico=etidrónico
etilacetêmico=etilacetémico
etilamônio=etilamónio
etilbenzênico=etilbenzénico
etilcarbônico=etilcarbónico
etilclorocarbônico=etilclorocarbónico
etilocarbônico=etilocarbónico
etiloclorocarbônico=etiloclorocarbónico
etilossulfônico=etilossulfónico
etilsulfônico=etilsulfónico
etilênico=etilénico
etilênio=etilénio
etilômetro=etilómetro
etiogênico=etiogénico
etiopatogênese=etiopatogénese
etiopatogênico=etiopatogénico
etiônico=etiónico
etnogênico=etnogénico
etnônimo=etnónimo
etogênico=etogénico
etogênio=etogénio
etotoxêmico=etotoxémico
etoxicrotônico=etoxicrotónico
euadênia=euadénia
eucaliptênio=eucalipténio
eucantarômice=eucantarómice
eucinostômida=eucinostómida
eucnêmis=eucnémis
eucrômico=eucrómico
eucrônico=eucrónico
eucômia=eucómia
eudemônico=eudemónico
eudiômetro=eudiómetro
eudrômia=eudrómia
eudêmone=eudémone
euefêmera=euefémera
eufrônia=eufrónia
eufrônide=eufrónide
eufêmico=eufémico
eufônico=eufónico
eufônio=eufónio
euglicêmico=euglicémico
euglênido=euglénido
eugênia=eugénia
eugênica=eugénica
eugênico=eugénico
eumênide=euménide
eunômia=eunómia
eupetômena=eupetómena
eupitônico=eupitónico
eupogônia=eupogónia
euquitônia=euquitónia
euquêumato=euquéumato
euriônico=euriónico
eurobônus=eurobónus
eurônoto=eurónoto
eussêmico=eussémico
eustômico=eustómico
euxantônico=euxantónico
euxênia=euxénia
euxônia=euxónia
euêmico=euémico
evaporômetro=evaporómetro
evêmico=evémico
evônimo=evónimo
exantemogênio=exantemogénio
excitrônio=excitrónio
exergônico=exergónico
exoeletrônico=exoeletrónico
exogêneo=exogéneo
exogênico=exogénico
exogônio=exogónio
exosmômetro=exosmómetro
exostômio=exostómio
extensômetro=extensómetro
exômata=exómata
exômeno=exómeno
exômetra=exómetra
exômide=exómide
exônimo=exónimo
fabrônia=fabrónia
facômetro=facómetro
fadiênia=fadiénia
fadômetro=fadómetro
fagedênico=fagedénico
fagônia=fagónia
falcipênis=falcipénis
falcônida=falcónida
falectônio=falectónio
falsa-verônica=falsa-verónica
falso-sicômoro=falso-sicómoro
falênia=falénia
fanatrônio=fanatrónio
fanerocodônico=fanerocodónico
fanerocotiledônea=fanerocotiledónea
fanerogênico=fanerogénico
fanerozônia=fanerozónia
fanerozônico=fanerozónico
fantômico=fantómico
faradômetro=faradómetro
faraônico=faraónico
faringectômico=faringectómico
faringotômico=faringotómico
farmacoeconômico=farmacoeconómico
farmacogenômico=farmacogenómico
farmacogênico=farmacogénico
farmacômano=farmacómano
farmacônimo=farmacónimo
farrimônia=farrimónia
fascolômida=fascolómida
fasitrônio=fasitrónio
fasômetro=fasómetro
favônio=favónio
fecalômico=fecalómico
feculômetro=feculómetro
felandrênico=felandrénico
felogênico=felogénico
felogênio=felogénio
felônio=felónio
femtômetro=femtómetro
fenantrênico=fenantrénico
fenantrênio=fenantrénio
fenclexônio=fenclexónio
fenilacetocarbônico=fenilacetocarbónico
fenilbenzênico=fenilbenzénico
fenilmetilcetônico=fenilmetilcetónico
fenilopropiônico=fenilopropiónico
fenilpropiônico=fenilpropiónico
fenilênico=fenilénico
fenolsulfônico=fenolsulfónico
fenomênico=fenoménico
fentômetro=fentómetro
fentônio=fentónio
fenômeno=fenómeno
fermiônico=fermiónico
feromônico=feromónico
feromônio=feromónio
ferormônio=ferormónio
ferricianogênio=ferricianogénio
ferrocarbônico=ferrocarbónico
ferrocianogênio=ferrocianogénio
ferrocrômico=ferrocrómico
ferrocrômio=ferrocrómio
ferroiperstênio=ferroipersténio
ferromolibdênico=ferromolibdénico
ferromolibdênio=ferromolibdénio
ferrosselênio=ferrosselénio
ferrotungstênico=ferrotungsténico
ferrotungstênio=ferrotungsténio
ferrozircônico=ferrozircónico
ferrozircônio=ferrozircónio
ferônia=ferónia
fibrinogênese=fibrinogénese
fibrinogênico=fibrinogénico
fibrinogênio=fibrinogénio
fibrogênico=fibrogénico
ficciônimo=ficciónimo
fidônia=fidónia
filagônia=filagónia
filantropômano=filantropómano
filarmônica=filarmónica
filarmônico=filarmónico
filelênico=filelénico
filmogênio=filmogénio
filodrômia=filodrómia
filogênese=filogénese
filogênico=filogénico
filolacedemônio=filolacedemónio
filomacedônico=filomacedónico
filomacedônio=filomacedónio
filossifônia=filossifónia
filostômida=filostómida
filômaco=filómaco
filômano=filómano
filômico=filómico
filônico=filónico
filônio=filónio
fisarmônica=fisarmónica
fisicogênese=fisicogénese
fisicogênico=fisicogénico
fisieconômico=fisieconómico
fisioeconômico=fisioeconómico
fisiognomônico=fisiognomónico
fisiognômico=fisiognómico
fisiogênese=fisiogénese
fisiogênico=fisiogénico
fisionômetro=fisionómetro
fisionômico=fisionómico
fisoidiômetro=fisoidiómetro
fissurectômico=fissurectómico
fistulectômico=fistulectómico
fitocrômico=fitocrómico
fitoestrogênio=fitoestrogénio
fitofisionômico=fitofisionómico
fitognomônica=fitognomónica
fitognomônico=fitognomónico
fitogêneo=fitogéneo
fitogênese=fitogénese
fitogênico=fitogénico
fitonômico=fitonómico
fitormônico=fitormónico
fitormônio=fitormónio
fitossarcônida=fitossarcónida
fitotaxonômico=fitotaxonómico
fitotômico=fitotómico
fitotômida=fitotómida
fitênico=fiténico
fitômetro=fitómetro
fitônia=fitónia
fitônimo=fitónimo
fitônomo=fitónomo
fiônida=fiónida
flagelômano=flagelómano
flavônico=flavónico
flebectômico=flebectómico
flebocimênico=flebociménico
fleboftalmotômico=fleboftalmotómico
flebotômico=flebotómico
flebômero=flebómero
flectômetro=flectómetro
fletômetro=fletómetro
fleônico=fleónico
flictênula=flicténula
flogogênico=flogogénico
flogogênio=flogogénio
floiônico=floiónico
floobafênio=floobafénio
floroglucinocarbônico=floroglucinocarbónico
floroglucinotricarbônico=floroglucinotricarbónico
florômano=florómano
floêmico=floémico
fludazônio=fludazónio
fluorbenzênico=fluorbenzénico
fluorênico=fluorénico
fluorômetro=fluorómetro
fluossulfônico=fluossulfónico
fluotungstênico=fluotungsténico
fluviogênese=fluviogénese
fluviogênico=fluviogénico
fluviômetro=fluviómetro
fluxômetro=fluxómetro
flômide=flómide
focênico=focénico
focômele=focómele
focômelo=focómelo
focômetro=focómetro
foladômia=foladómia
fonastênico=fonasténico
fonogênico=fonogénico
fonêmica=fonémica
fonêmico=fonémico
fonômano=fonómano
fonômetro=fonómetro
fonônico=fonónico
fonônimo=fonónimo
foquiênia=foquiénia
formilênio=formilénio
formênico=forménico
foronômico=foronómico
forônida=forónida
fosfagênio=fosfagénio
fosfarsônio=fosfarsónio
fosforogêneo=fosforogéneo
fosforogênico=fosforogénico
fosfônico=fosfónico
fosfônio=fosfónio
fosgênio=fosgénio
fosmênico=fosménico
fossombrônia=fossombrónia
fotelectrônica=fotelectrónica
fotelectrônio=fotelectrónio
foteletrônica=foteletrónica
foteletrônio=foteletrónio
fotoactinômetro=fotoactinómetro
fotocromogênio=fotocromogénio
fotocromômetro=fotocromómetro
fotocronômetro=fotocronómetro
fotocrômico=fotocrómico
fotodensitômetro=fotodensitómetro
fotodiômetro=fotodiómetro
fotoelectrônica=fotoelectrónica
fotoelectrônio=fotoelectrónio
fotoeletrônica=fotoeletrónica
fotoeletrônio=fotoeletrónio
fotofônico=fotofónico
fotofônio=fotofónio
fotogoniômetro=fotogoniómetro
fotografômetro=fotografómetro
fotogênese=fotogénese
fotogênico=fotogénico
fotogênio=fotogénio
fotoneutrônio=fotoneutrónio
fotoptômetro=fotoptómetro
fotossantônico=fotossantónico
fotossintetômetro=fotossintetómetro
fotossintômetro=fotossintómetro
fotostômia=fotostómia
fototelefônico=fototelefónico
fototermômetro=fototermómetro
fototipocrômico=fototipocrómico
fototônico=fototónico
fotômetro=fotómetro
fotônico=fotónico
fotônio=fotónio
fragmocônico=fragmocónico
framaçônico=framaçónico
francofônico=francofónico
francômano=francómano
francônio=francónio
franquênia=franquénia
fraseômano=fraseómano
frenastênico=frenasténico
frenicectômico=frenicectómico
frenicotômico=frenicotómico
frenocômio=frenocómio
frenosplênico=frenosplénico
frenotômico=frenotómico
frenômetro=frenómetro
frequenciômetro=frequenciómetro
freônico=freónico
frictômetro=frictómetro
frigômetro=frigómetro
frontogênese=frontogénese
frontônia=frontónia
frêmito=frémito
frênico=frénico
frênulo=frénulo
frônia=frónia
frônimo=frónimo
fubrogônio=fubrogónio
fulgurômetro=fulgurómetro
furfuralmalônico=furfuralmalónico
furfuropropiônico=furfuropropiónico
furnatrônio=furnatrónio
furtretônio=furtretónio
furônico=furónico
fuscipêneo=fuscipéneo
fusetrônio=fusetrónio
fusiômetro=fusiómetro
fusênico=fusénico
futevôlei=futevólei
fêmico=fémico
fêmur=fémur
fênico=fénico
fênix=fénix
fômite=fómite
fônica=fónica
fônico=fónico
gadobênico=gadobénico
galactobutirômetro=galactobutirómetro
galactogênio=galactogénio
galacturônico=galacturónico
galactêmico=galactémico
galactômetro=galactómetro
galactônico=galactónico
galatogênio=galatogénio
galatêmico=galatémico
galcônia=galcónia
galeômida=galeómida
galipênico=galipénico
galtônia=galtónia
galvanômetro=galvanómetro
galênia=galénia
galênico=galénico
galômano=galómano
gamalinolênico=gamalinolénico
gametogênese=gametogénese
gametogênico=gametogénico
gametogônio=gametogónio
gamogênese=gamogénese
gamogênico=gamogénico
gamolênico=gamolénico
gamostêmone=gamostémone
gamômano=gamómano
gangliectômico=gangliectómico
gardênia=gardénia
gasocarbônico=gasocarbónico
gasogênio=gasogénio
gasterectômico=gasterectómico
gasterostômida=gasterostómida
gastrastênico=gastrasténico
gastrectômico=gastrectómico
gastrelitrotômico=gastrelitrotómico
gastresplênico=gastresplénico
gastristerotômico=gastristerotómico
gastroatônico=gastroatónico
gastrocnêmico=gastrocnémico
gastrocnêmio=gastrocnémio
gastrocolostômico=gastrocolostómico
gastrocolotômico=gastrocolotómico
gastrocolpotômico=gastrocolpotómico
gastroduodenostômico=gastroduodenostómico
gastroelitrotômico=gastroelitrotómico
gastroesplênico=gastroesplénico
gastrofrênico=gastrofrénico
gastrogênico=gastrogénico
gastroisterotômico=gastroisterotómico
gastrojejunostômico=gastrojejunostómico
gastromênico=gastroménico
gastronômico=gastronómico
gastroquênida=gastroquénida
gastrosplênico=gastrosplénico
gastrostômico=gastrostómico
gastrotômico=gastrotómico
gastrômelo=gastrómelo
gastrônomo=gastrónomo
gasômetro=gasómetro
gatimônia=gatimónia
gecônido=gecónido
geloquelidônia=geloquelidónia
gelsêmico=gelsémico
gelsêmio=gelsémio
gelômetro=gelómetro
gelônio=gelónio
gemônia=gemónia
geneagênese=geneagénese
genômero=genómero
genômica=genómica
genômico=genómico
geocorônio=geocorónio
geocosmogênico=geocosmogénico
geoeconômico=geoeconómico
geoecônomo=geoecónomo
geogênico=geogénico
geogônico=geogónico
geomorfogênese=geomorfogénese
geomorfogênico=geomorfogénico
geonômico=geonómico
geopônico=geopónico
geossocioeconômico=geossocioeconómico
geotectônica=geotectónica
geotectônico=geotectónico
geotermômetro=geotermómetro
geoxênio=geoxénio
geriônia=geriónia
geriônida=geriónida
germanofônico=germanofónico
germinogônico=germinogónico
gerocômico=gerocómico
gerocômio=gerocómio
gerontocômio=gerontocómio
gerônico=gerónico
gestagênio=gestagénio
gestêmico=gestémico
gesônia=gesónia
geômetra=geómetra
geômoro=geómoro
geônimo=geónimo
geônomo=geónomo
gildônico=gildónico
gilênia=gilénia
gimnadênia=gimnadénia
gimnofiônico=gimnofiónico
gimnofiônio=gimnofiónio
gimnêmico=gimnémico
ginecômano=ginecómano
ginecônimo=ginecónimo
ginecônomo=ginecónomo
ginogênese=ginogénese
ginostêmio=ginostémio
gipsômetro=gipsómetro
girostemônea=girostemónea
girostêmone=girostémone
girômetro=girómetro
gitogênico=gitogénico
glacigênico=glacigénico
glandônia=glandónia
glaucônia=glaucónia
glaucônico=glaucónico
gleichênia=gleichénia
gleiquênia=gleiquénia
gleucômetro=gleucómetro
glicagônico=glicagónico
glicagônio=glicagónio
glicogenogênese=glicogenogénese
glicogênase=glicogénase
glicogênese=glicogénese
glicogênico=glicogénico
glicogênio=glicogénio
gliconeogênese=gliconeogénese
gliconeogênico=gliconeogénico
glicopirrônio=glicopirrónio
glicorônico=glicorónico
glicosêmico=glicosémico
glicurônico=glicurónico
glicêmia=glicémia
glicêmico=glicémico
glicômetro=glicómetro
glicônico=glicónico
glicônio=glicónio
gliptogênese=gliptogénese
gliptogênico=gliptogénico
gliptoteconômico=gliptoteconómico
glitogênese=glitogénese
glitoteconômico=glitoteconómico
globinômetro=globinómetro
glossectômico=glossectómico
glossifônia=glossifónia
glossossifônia=glossossifónia
glossossifônida=glossossifónida
glossotômico=glossotómico
glossêmico=glossémico
glossômetro=glossómetro
glossônimo=glossónimo
glotônimo=glotónimo
glucagônico=glucagónico
glucagônio=glucagónio
glucogênese=glucogénese
gluconeogênese=gluconeogénese
gluconeogênico=gluconeogénico
glucurônico=glucurónico
glucônico=glucónico
glutacônico=glutacónico
glutônico=glutónico
glômere=glómere
glômeris=glómeris
gnomônica=gnomónica
gnomônico=gnomónico
gnômico=gnómico
gnômon=gnómon
golgiossômico=golgiossómico
gonadectômico=gonadectómico
gonartrotômico=gonartrotómico
goniômetro=goniómetro
gonoartrotômico=gonoartrotómico
gonococcêmico=gonococcémico
gonococêmico=gonococémico
gonostômida=gonostómida
gonotômico=gonotómico
goodênia=goodénia
gordônia=gordónia
gorgôneo=gorgóneo
gorgônia=gorgónia
gorgônida=gorgónida
govênia=govénia
gradiômetro=gradiómetro
gradômetro=gradómetro
grafofônio=grafofónio
grafonômico=grafonómico
grafêmico=grafémico
grafômano=grafómano
grafômetro=grafómetro
grafônomo=grafónomo
gramofônico=gramofónico
gramêmico=gramémico
gramômetro=gramómetro
granucômata=granucómata
granulômetro=granulómetro
gravitônico=gravitónico
grecofônico=grecofónico
grecômano=grecómano
grêmio=grémio
grômia=grómia
grômida=grómida
guaiacossulfônico=guaiacossulfónico
guaiacônico=guaiacónico
guanidônio=guanidónio
gulônico=gulónico
gêmeo=gémeo
gêmina=gémina
gêmino=gémino
gêmito=gémito
gêmula=gémula
gênero=género
gênese=génese
gênesis=génesis
gênico=génico
gênio=génio
gênito=génito
gômico=gómico
gômito=gómito
gônada=gónada
gônio=gónio
gônion=gónion
gônis=gónis
habrônia=habrónia
habênula=habénula
hadrônico=hadrónico
hafestesiômetro=hafestesiómetro
hagiotopônimo=hagiotopónimo
hagiômaco=hagiómaco
hagiônimo=hagiónimo
hagênia=hagénia
halimênia=haliménia
haliquelidôneo=haliquelidóneo
haliquelidônio=haliquelidónio
halmatogênese=halmatogénese
halocarbônico=halocarbónico
halocrômico=halocrómico
halogêneo=halogéneo
halogênico=halogénico
halogênio=halogénio
halopênio=halopénio
halênia=halénia
halômetro=halómetro
hamiltônia=hamiltónia
hapalêmure=hapalémure
haplocnêmia=haplocnémia
haploglênio=haploglénio
haploquitônida=haploquitónida
haplostêmone=haplostémone
haplostêmono=haplostémono
haplotômico=haplotómico
haplômero=haplómero
haplômice=haplómice
haplônomo=haplónomo
haptogêneo=haptogéneo
haptênico=hapténico
harmonômetro=harmonómetro
harmotômio=harmotómio
harmônica=harmónica
harmônico=harmónico
harmônio=harmónio
harmônium=harmónium
harrisônia=harrisónia
haxixômano=haxixómano
hebdômada=hebdómada
hebdômade=hebdómade
hebefrênico=hebefrénico
hebetômico=hebetómico
hectoquilômetro=hectoquilómetro
hectômetro=hectómetro
hediônico=hediónico
hedreotônico=hedreotónico
hedônico=hedónico
hegemônico=hegemónico
helicômetro=helicómetro
helicônia=helicónia
helicônio=helicónio
heliocrômico=heliocrómico
heliodônio=heliodónio
heliofotômetro=heliofotómetro
heliogênico=heliogénico
heliomagnetômetro=heliomagnetómetro
heliotermômetro=heliotermómetro
helixômetro=helixómetro
heliômetro=heliómetro
helênia=helénia
helênico=helénico
helênio=helénio
helônia=helónia
hemadromômetro=hemadromómetro
hematodinamômetro=hematodinamómetro
hematodromômetro=hematodromómetro
hematogênese=hematogénese
hematogênico=hematogénico
hematogênio=hematogénio
hematogônia=hematogónia
hematêmese=hematémese
hematômetro=hematómetro
hemerofotômetro=hemerofotómetro
hemerônimo=hemerónimo
hemicariônico=hemicariónico
hemiclônico=hemiclónico
hemicolectômico=hemicolectómico
hemicraniectômico=hemicraniectómico
hemifalangectômico=hemifalangectómico
hemifônico=hemifónico
hemigastrectômico=hemigastrectómico
hemiglossectômico=hemiglossectómico
hemilaringectômico=hemilaringectómico
heminefrectômico=heminefrectómico
heminefroureterectômico=heminefroureterectómico
hemiprostatectômico=hemiprostatectómico
hemipênis=hemipénis
hemisferectômico=hemisferectómico
hemocitômetro=hemocitómetro
hemocromogênico=hemocromogénico
hemocromogênio=hemocromogénio
hemocromômetro=hemocromómetro
hemocrômio=hemocrómio
hemocônia=hemocónia
hemodinamômetro=hemodinamómetro
hemodromômetro=hemodromómetro
hemodrômetro=hemodrómetro
hemodrômico=hemodrómico
hemoglobinêmico=hemoglobinémico
hemoglobinômetro=hemoglobinómetro
hemogênico=hemogénico
hemoperitônio=hemoperitónio
hemorroidectômico=hemorroidectómico
hemossialêmese=hemossialémese
hemotacômetro=hemotacómetro
hemômetro=hemómetro
hemônio=hemónio
heortônimo=heortónimo
hepatectômico=hepatectómico
hepaticenterostômico=hepaticenterostómico
hepaticostômico=hepaticostómico
hepatoesplênico=hepatoesplénico
hepatogênico=hepatogénico
hepatosplênico=hepatosplénico
hepatostômico=hepatostómico
hepatotômico=hepatotómico
heptastêmone=heptastémone
heptosêmico=heptosémico
hercotectônica=hercotectónica
hercotectônico=hercotectónico
hercotetônico=hercotetónico
hermiônico=hermiónico
hermiônio=hermiónio
herniotômico=herniotómico
herofônio=herofónio
heroi-cômico=heroi-cómico
heroinômano=heroinómano
herpetômona=herpetómona
hesiônida=hesiónida
hessocênico=hessocénico
heteradênico=heteradénico
heteratômico=heteratómico
heteroatômico=heteroatómico
heterocnêmis=heterocnémis
heterocromossômico=heterocromossómico
heterocrômico=heterocrómico
heteroctônico=heteroctónico
heterofônico=heterofónico
heterogêneo=heterogéneo
heterogênese=heterogénese
heterogênico=heterogénico
heterogônico=heterogónico
heteromeiênia=heteromeiénia
heteronômico=heteronómico
heteropartenogênese=heteropartenogénese
heterostêmone=heterostémone
heterômero=heterómero
heterômetro=heterómetro
heterômio=heterómio
heterômisis=heterómisis
heterônimo=heterónimo
heterônio=heterónio
heterônomo=heterónomo
hetosêmico=hetosémico
hexaflurônio=hexaflurónio
hexagênia=hexagénia
hexagônia=hexagónia
hexametônio=hexametónio
hexassômico=hexassómico
hexastêmone=hexastémone
hexasônio=hexasónio
hexilênico=hexilénico
hexogênio=hexogénio
hexurônico=hexurónico
hexônico=hexónico
hialopômato=hialopómato
hialosfênia=hialosfénia
hialurônico=hialurónico
hialômero=hialómero
hibômetro=hibómetro
hidatogênico=hidatogénico
hidatopirogênico=hidatopirogénico
hidrazônico=hidrazónico
hidrazônio=hidrazónio
hidroatômico=hidroatómico
hidrobenzênico=hidrobenzénico
hidrobrômico=hidrobrómico
hidrocarbônico=hidrocarbónico
hidrocelectômico=hidrocelectómico
hidrociclônico=hidrociclónico
hidrocortisônico=hidrocortisónico
hidrocrocônico=hidrocrocónico
hidrocênida=hidrocénida
hidrodipsômano=hidrodipsómano
hidrofurônico=hidrofurónico
hidrogeniônico=hidrogeniónico
hidrognomônico=hidrognomónico
hidrogênase=hidrogénase
hidrogênico=hidrogénico
hidrogênio=hidrogénio
hidroigrômetro=hidroigrómetro
hidrolactômetro=hidrolactómetro
hidromecônico=hidromecónico
hidroperitônio=hidroperitónio
hidropiesmômetro=hidropiesmómetro
hidropigênico=hidropigénico
hidropneumoperitônio=hidropneumoperitónio
hidropônica=hidropónica
hidropônico=hidropónico
hidroquinônico=hidroquinónico
hidrotacômetro=hidrotacómetro
hidroterpênico=hidroterpénico
hidrotionêmico=hidrotionémico
hidrotiônico=hidrotiónico
hidrotômico=hidrotómico
hidroxicanforônico=hidroxicanforónico
hidroxicetônico=hidroxicetónico
hidroxilamônio=hidroxilamónio
hidroxipropiônico=hidroxipropiónico
hidroxitoluênico=hidroxitoluénico
hidroxônio=hidroxónio
hidrêmese=hidrémese
hidrêmico=hidrémico
hidrênida=hidrénida
hidrômano=hidrómano
hidrômetro=hidrómetro
hidrômio=hidrómio
hidrônico=hidrónico
hidrônimo=hidrónimo
hidrônio=hidrónio
hieromnêmone=hieromnémone
hierônico=hierónico
hierônimo=hierónimo
hietômetro=hietómetro
hifêmico=hifémico
higiocômio=higiocómio
higiênico=higiénico
higroelectômetro=higroelectómetro
higrômetro=higrómetro
hilocômio=hilocómio
hilogênese=hilogénese
hilogênico=hilogénico
hilômane=hilómane
hilônomo=hilónomo
himenectômico=himenectómico
himenotômico=himenotómico
himênio=himénio
hipalbuminêmico=hipalbuminémico
hiparrênia=hiparrénia
hiper-hedônico=hiper-hedónico
hiperaldesterônico=hiperaldesterónico
hipercalcêmico=hipercalcémico
hipercrômico=hipercrómico
hipercuprêmico=hipercuprémico
hipercêmico=hipercémico
hiperedônico=hiperedónico
hipereufêmico=hipereufémico
hiperfosfatêmico=hiperfosfatémico
hipergamaglobulinêmico=hipergamaglobulinémico
hiperglicêmico=hiperglicémico
hiperglobulinêmico=hiperglobulinémico
hiperiônico=hiperiónico
hiperiônio=hiperiónio
hiperjônico=hiperjónico
hiperlipêmico=hiperlipémico
hipernatrêmico=hipernatrémico
hiperplastogênese=hiperplastogénese
hiperpolêmico=hiperpolémico
hipersinerônico=hipersinerónico
hipersplênico=hipersplénico
hiperstênico=hipersténico
hiperstênio=hipersténio
hiperstômico=hiperstómico
hipersônia=hipersónia
hipersônico=hipersónico
hipertensinogênio=hipertensinogénio
hipertrigliceridêmico=hipertrigliceridémico
hipertônico=hipertónico
hiperêmese=hiperémese
hiperêmia=hiperémia
hiperêmico=hiperémico
hiperônimo=hiperónimo
hipnofônico=hipnofónico
hipoalergênico=hipoalergénico
hipocalêmico=hipocalémico
hipoclidônia=hipoclidónia
hipocnêmis=hipocnémis
hipocrênico=hipocrénico
hipocrômico=hipocrómico
hipoctônio=hipoctónio
hipocônido=hipocónido
hipodermotômico=hipodermotómico
hipodrômico=hipodrómico
hipoecogênico=hipoecogénico
hipofisectômico=hipofisectómico
hipofosfatêmico=hipofosfatémico
hipogliceridêmico=hipogliceridémico
hipoglicêmico=hipoglicémico
hipomagnesêmico=hipomagnesémico
hipoplastogênese=hipoplastogénese
hipoprotrombinêmico=hipoprotrombinémico
hiposcênio=hiposcénio
hipostênico=hiposténico
hipostômio=hipostómio
hipotrombinêmico=hipotrombinémico
hipotênaro=hipoténaro
hipotômico=hipotómico
hipotônico=hipotónico
hipoxêmico=hipoxémico
hipsocrômico=hipsocrómico
hipsogoniômetro=hipsogoniómetro
hipsômetro=hipsómetro
hipêmico=hipémico
hipômane=hipómane
hipômano=hipómano
hipômero=hipómero
hipômeso=hipómeso
hipômetro=hipómetro
hipômice=hipómice
hipônico=hipónico
hipônimo=hipónimo
hipônique=hipónique
hispanofônico=hispanofónico
histerectômico=histerectómico
histereseômetro=histereseómetro
histeriônica=histeriónica
histerogênico=histerogénico
histerolaparotômico=histerolaparotómico
histerostênico=histerosténico
histerotocotômico=histerotocotómico
histerotômico=histerotómico
histerômana=histerómana
histerômano=histerómano
histerômetro=histerómetro
histiodrômico=histiodrómico
histogêneo=histogéneo
histogênese=histogénese
histogênico=histogénico
histogênio=histogénio
histonômico=histonómico
historiônimo=historiónimo
histotrômico=histotrómico
histotômico=histotómico
histriônico=histriónico
histônico=histónico
hitchênia=hitchénia
hitquênia=hitquénia
hiênida=hiénida
hodogênese=hodogénese
hodotacômetro=hodotacómetro
hodômetro=hodómetro
hodônimo=hodónimo
holimênia=holiménia
holocênico=holocénico
holocênio=holocénio
hologênese=hologénese
holonômico=holonómico
holostômido=holostómido
holotômico=holotómico
holotônico=holotónico
holômetro=holómetro
holônimo=holónimo
holônomo=holónomo
homalônico=homalónico
homatômico=homatómico
homeômere=homeómere
homeômero=homeómero
homocrômico=homocrómico
homocrônico=homocrónico
homodrômico=homodrómico
homofônico=homofónico
homogêneo=homogéneo
homogênese=homogénese
homogênico=homogénico
homogônico=homogónico
homologômeno=homologómeno
homonômico=homonómico
homotômico=homotómico
homômero=homómero
homônimo=homónimo
homônomo=homónomo
honcquênia=honcquénia
honquênia=honquénia
hopantênico=hopanténico
hoplômaco=hoplómaco
hormogênese=hormogénese
hormogônio=hormogónio
hormonogênese=hormonogénese
hormonogênico=hormonogénico
hormônico=hormónico
hormônio=hormónio
horômetro=horómetro
hotônia=hotónia
hovênia=hovénia
hudsônia=hudsónia
hugônia=hugónia
huênia=huénia
hêmaris=hémaris
hêmase=hémase
hêmiso=hémiso
hêneto=héneto
hênrio=hénrio
hômolo=hómolo
iatrogênico=iatrogénico
iatrônimo=iatrónimo
ibandrônico=ibandrónico
ibiracêni=ibiracéni
ibêji=ibéji
icneumônida=icneumónida
icnêumone=icnéumone
iconogênio=iconogénio
iconômaco=iconómaco
iconômano=iconómano
iconômetro=iconómetro
icorêmico=icorémico
icosênico=icosénico
icterogênico=icterogénico
ictiolamônio=ictiolamónio
ictiômio=ictiómio
ictiônimo=ictiónimo
ictômetro=ictómetro
icônico=icónico
ideofrênico=ideofrénico
ideofônico=ideofónico
ideogênico=ideogénico
idiocrômico=idiocrómico
idiofonêmico=idiofonémico
idiofônico=idiofónico
idiofônio=idiofónio
idiogênico=idiogénico
idionômico=idionómico
idiômero=idiómero
idiônimo=idiónimo
idomênio=idoménio
idôneo=idóneo
idônico=idónico
iemênico=ieménico
ifigênia=ifigénia
ignitrônico=ignitrónico
ignitrônio=ignitrónio
ileileostômico=ileileostómico
ileocolostômico=ileocolostómico
ileoileostômico=ileoileostómico
ileoproctostômico=ileoproctostómico
ileorrectostômico=ileorrectostómico
ileossigmoidostômico=ileossigmoidostómico
ileostômico=ileostómico
iliogênia=iliogénia
ilmênio=ilménio
imidazolpropiônico=imidazolpropiónico
imidogênio=imidogénio
iminogênio=iminogénio
imogênio=imogénio
impedanciômetro=impedanciómetro
imunigênico=imunigénico
imunogênico=imunogénico
imunossimpatectômico=imunossimpatectómico
imêmore=imémore
inarmônico=inarmónico
inclinômetro=inclinómetro
incudectômico=incudectómico
incômodo=incómodo
indantrênico=indantrénico
indantrônico=indantrónico
indigômetro=indigómetro
indofênico=indofénico
indolpropiônico=indolpropiónico
indoxilglicorônico=indoxilglicorónico
indrômina=indrómina
indutômetro=indutómetro
indômito=indómito
infiltrômetro=infiltrómetro
infrassônico=infrassónico
ingorôci=ingoróci
ingênito=ingénito
ingênua=ingénua
ingênuo=ingénuo
inidôneo=inidóneo
inogênese=inogénese
inosêmico=inosémico
insônia=insónia
integrômetro=integrómetro
inter-helênico=inter-helénico
interacadêmico=interacadémico
interatômico=interatómico
interferômetro=interferómetro
intervalômetro=intervalómetro
intra-atômico=intra-atómico
intramorfênico=intramorfénico
intrassistêmico=intrassistémico
intrêmulo=intrémulo
iodobenzênico=iodobenzénico
iodoformogênio=iodoformogénio
iodogorgônico=iodogorgónico
iodooxiquinoleinossulfônico=iodooxiquinoleinossulfónico
iodêmico=iodémico
iodômetro=iodómetro
iodônio=iodónio
iolidônico=iolidónico
ionogênico=ionogénico
ionogênio=ionogénio
ionômero=ionómero
ionômetro=ionómetro
ioprocêmico=ioprocémico
ioprônico=ioprónico
iozômico=iozómico
ipsilênio=ipsilénio
iridectômico=iridectómico
iridosclerotômico=iridosclerotómico
iridotômico=iridotómico
iridêmico=iridémico
irênico=irénico
irênio=irénio
irônico=irónico
isanêmona=isanémona
isanômalo=isanómalo
isatogênico=isatogénico
iscnofônico=iscnofónico
iscnômera=iscnómera
iscoblênico=iscoblénico
iscomênico=iscoménico
isetiônico=isetiónico
ismênia=isménia
isoaglutinogênico=isoaglutinogénico
isoaglutinogênio=isoaglutinogénio
isoantigênico=isoantigénico
isobutilênico=isobutilénico
isocloroprênico=isocloroprénico
isocrômico=isocrómico
isocrônico=isocrónico
isodifênico=isodifénico
isoecogênico=isoecogénico
isoelectrônico=isoelectrónico
isoeletrônico=isoeletrónico
isofitônico=isofitónico
isofônico=isofónico
isogênese=isogénese
isogênico=isogénico
isogônico=isogónico
isoiônico=isoiónico
isomorfogênico=isomorfogénico
isonêmono=isonémono
isonômalo=isonómalo
isonômico=isonómico
isopartenogênese=isopartenogénese
isoprênico=isoprénico
isoquimênico=isoquiménico
isostêmone=isostémone
isotônico=isotónico
isquiopubitômico=isquiopubitómico
isquirosônico=isquirosónico
isquêmico=isquémico
isômalo=isómalo
isômere=isómere
isômeris=isómeris
isômero=isómero
isômetro=isómetro
isônefa=isónefa
isônefo=isónefo
isônico=isónico
isônimo=isónimo
isônomo=isónomo
itacônico=itacónico
italianofônico=italianofónico
italianômano=italianómano
italômano=italómano
ixiônio=ixiónio
ixômetro=ixómetro
iôni=ióni
iônico=iónico
iônico-ático=iónico-ático
iônio=iónio
jacksônia=jacksónia
jacsônia=jacsónia
jamesônia=jamesónia
jansônia=jansónia
japônia=japónia
japônico=japónico
jargônico=jargónico
jasônia=jasónia
jeffersônia=jeffersónia
jejunectômico=jejunectómico
jejunileostômico=jejunileostómico
jejunocecostômico=jejunocecostómico
jejunocolostômico=jejunocolostómico
jejunoileostômico=jejunoileostómico
jejunojejunostômico=jejunojejunostómico
jejunostômico=jejunostómico
jejunotômico=jejunotómico
jensênia=jensénia
jerdônia=jerdónia
jerônimo=jerónimo
jessênia=jessénia
juliênia=juliénia
junônio=junónio
justênia=justénia
jênia=jénia
jônico=jónico
jônico-ático=jónico-ático
jônio=jónio
labidômetro=labidómetro
labogênico=labogénico
laboulbênia=laboulbénia
labulbênia=labulbénia
lacedemônico=lacedemónico
lacedemônio=lacedemónio
lacnocaulônio=lacnocaulónio
lacrimogêneo=lacrimogéneo
lacrimogênio=lacrimogénio
lacrimotômico=lacrimotómico
lactacidêmico=lactacidémico
lacticêmico=lacticémico
lactobiônico=lactobiónico
lactobutirômetro=lactobutirómetro
lactocônio=lactocónio
lactogênico=lactogénico
lactogênio=lactogénio
lactômetro=lactómetro
lactônico=lactónico
lacônico=lacónico
lacônio=lacónio
ladrônico=ladrónico
lagerstrêmia=lagerstrémia
lagostômida=lagostómida
lagênia=lagénia
lagênida=lagénida
lagênula=lagénula
lagômio=lagómio
lalômano=lalómano
lamanônia=lamanónia
laminectômico=laminectómico
lampadômetro=lampadómetro
lamprofônico=lamprofónico
lamprômetro=lamprómetro
lamprômia=lamprómia
lamprônia=lamprónia
laparectômico=laparectómico
laparelitrotômico=laparelitrotómico
laparenterotômico=laparenterotómico
laparisterotômico=laparisterotómico
laparocistectômico=laparocistectómico
laparocolostômico=laparocolostómico
laparocolotômico=laparocolotómico
laparogastrectômico=laparogastrectómico
laparoileotômico=laparoileotómico
laparoisterectômico=laparoisterectómico
laparoisterooforectômico=laparoisterooforectómico
laparoisterotômico=laparoisterotómico
laparomiomectômico=laparomiomectómico
laparonefrectômico=laparonefrectómico
laparosplenectômico=laparosplenectómico
laparosplenotômico=laparosplenotómico
laparossalpingectômico=laparossalpingectómico
laparostômico=laparostómico
laparotômico=laparotómico
lapitônio=lapitónio
lapônico=lapónico
lapônio=lapónio
laringectômico=laringectómico
laringotraqueotômico=laringotraqueotómico
laringotômico=laringotómico
lasiadênia=lasiadénia
latacidêmico=latacidémico
laticêmico=laticémico
laticônico=laticónico
latônico=latónico
laudêmio=laudémio
lauralcônio=lauralcónio
laurolênico=laurolénico
lausônia=lausónia
lazarônico=lazarónico
lebre-da-patagônia=lebre-da-patagónia
lebretônia=lebretónia
lecitinêmico=lecitinémico
legitimônio=legitimónio
lemônia=lemónia
lemônico=lemónico
lensômetro=lensómetro
lentectômico=lentectómico
lepicênio=lepicénio
lepidadênia=lepidadénia
lepidastênia=lepidasténia
lepidoblênio=lepidoblénio
lepidomênia=lepidoménia
lepidosirênida=lepidosirénida
lepidossirênida=lepidossirénida
lepilêmure=lepilémure
lepirônia=lepirónia
leprocômio=leprocómio
leptadênia=leptadénia
leptauquênia=leptauquénia
leptofônico=leptofónico
leptomônado=leptomónado
leptossômato=leptossómato
leptossômico=leptossómico
leptotênico=leptoténico
leptômero=leptómero
leptômetro=leptómetro
leptômisis=leptómisis
leptômona=leptómona
leptônico=leptónico
lepônico=lepónico
lernênico=lernénico
lessônia=lessónia
lestrigônio=lestrigónio
letossômico=letossómico
letsômia=letsómia
letômano=letómano
letônico=letónico
letônio=letónio
leucanêmico=leucanémico
leucemogênese=leucemogénese
leucemogênico=leucemogénico
leucocitogênese=leucocitogénese
leucocitopênico=leucocitopénico
leucocitêmico=leucocitémico
leucocitônio=leucocitónio
leucogênese=leucogénese
leucopênico=leucopénico
leucotômico=leucotómico
leucoxênio=leucoxénio
leucêmico=leucémico
leucêmide=leucémide
leucômio=leucómio
leucônia=leucónia
leucônico=leucónico
leucônida=leucónida
leuquêmico=leuquémico
levedurômetro=levedurómetro
levistônia=levistónia
levitrônio=levitrónio
levulosêmico=levulosémico
levurômetro=levurómetro
lexicogênico=lexicogénico
lexiogênico=lexiogénico
lexêmico=lexémico
leônico=leónico
libônia=libónia
libônoto=libónoto
licaênida=licaénida
licaônia=licaónia
licaônico=licaónico
licoctônico=licoctónico
licopênico=licopénico
licênida=licénida
licênio=licénio
licômetro=licómetro
licônida=licónida
lidadrônico=lidadrónico
lifêmia=lifémia
lifêmico=lifémico
ligeonêmato=ligeonémato
limexilônida=limexilónida
limnêmico=limnémico
limnômetro=limnómetro
limnônimo=limnónimo
limoctônico=limoctónico
limônia=limónia
limônio=limónio
lineômetro=lineómetro
linfadenectômico=linfadenectómico
linfadênico=linfadénico
linfangiotômico=linfangiotómico
linfaticostômico=linfaticostómico
linfoadenectômico=linfoadenectómico
linfoadênico=linfoadénico
linfocitogênese=linfocitogénese
linfocitêmico=linfocitémico
linfogênese=linfogénese
linfogênico=linfogénico
linfogônio=linfogónio
linfoidectômico=linfoidectómico
linfoidotoxêmico=linfoidotoxémico
linfopênico=linfopénico
linfossarcoleucêmico=linfossarcoleucémico
linfotômico=linfotómico
linfêmico=linfémico
lingulectômico=lingulectómico
linhinassulfônico=linhinassulfónico
linhinossulfônico=linhinossulfónico
linhonassulfônico=linhonassulfónico
linhossulfônico=linhossulfónico
linhômetro=linhómetro
linolênico=linolénico
linômetro=linómetro
lipacidêmico=lipacidémico
lipectômico=lipectómico
lipidêmico=lipidémico
lipocromêmico=lipocromémico
lipofrênico=lipofrénico
lipogênese=lipogénese
lipogênico=lipogénico
lipoidêmico=lipoidémico
lipoêmico=lipoémico
lipêmico=lipémico
liquênia=liquénia
liquênico=liquénico
liquômetro=liquómetro
lisigênio=lisigénio
lisinogênico=lisinogénico
lisiômetro=lisiómetro
lisogênese=lisogénese
lisogênico=lisogénico
lisossômico=lisossómico
lisêmico=lisémico
literômano=literómano
litocrômico=litocrómico
litogênese=litogénese
litoplatitômico=litoplatitómico
litopônio=litopónio
litotopônimo=litotopónimo
litotômico=litotómico
litêmico=litémico
litômetro=litómetro
livônico=livónico
livônio=livónio
lixônico=lixónico
liênase=liénase
liênico=liénico
liômero=liómero
liômeso=liómeso
liônia=liónia
liônico=liónico
lobectômico=lobectómico
lobotômico=lobotómico
lobônico=lobónico
lobônique=lobónique
lofiômio=lofiómio
lofômona=lofómona
logadectômico=logadectómico
logaritmômano=logaritmómano
logaritmômetro=logaritmómetro
logastênico=logasténico
logoclônico=logoclónico
logofônico=logofónico
logômano=logómano
logômetro=logómetro
loipônico=loipónico
lombocolostômico=lombocolostómico
lombocolotômico=lombocolotómico
lonômia=lonómia
lovênia=lovénia
loxodrômico=loxodrómico
loxossômida=loxossómida
loxotômico=loxotómico
ludômano=ludómano
lupênio=lupénio
lusofônico=lusofónico
lusônio=lusónio
lutectômico=lutectómico
luteogênico=luteogénico
luxômetro=luxómetro
lêmico=lémico
lêmingue=lémingue
lêmnico=lémnico
lêmnio=lémnio
lêmure=lémure
lômis=lómis
macarrônea=macarrónea
macarrônico=macarrónico
macaônia=macaónia
macedônia=macedónia
macedônico=macedónico
macedônio=macedónio
macradênia=macradénia
macrauquênia=macrauquénia
macroeconômico=macroeconómico
macroglobulinêmico=macroglobulinémico
macromicrômetro=macromicrómetro
macrossifônia=macrossifónia
macrossociômetra=macrossociómetra
macrossômico=macrossómico
macrostêmone=macrostémone
macrostômico=macrostómico
macrômero=macrómero
macrômetro=macrómetro
macrônice=macrónice
macrônico=macrónico
madjambêni=madjambéni
magnetoeletrônico=magnetoeletrónico
magnetofônico=magnetofónico
magnetofônio=magnetofónio
magnetogênico=magnetogénico
magnetoiônico=magnetoiónico
magnetossônico=magnetossónico
magnetrômetro=magnetrómetro
magnetrônio=magnetrónio
magnetômetro=magnetómetro
magônia=magónia
magônida=magónida
mahônia=mahónia
malacênico=malacénico
malacônio=malacónio
malanêmico=malanémico
malcômia=malcómia
malencônico=malencónico
maleotômico=maleotómico
malincônico=malincónico
maltobiônico=maltobiónico
maltômico=maltómico
malônico=malónico
mamogênese=mamogénese
mamogênico=mamogénico
mancopalênico=mancopalénico
mancômetro=mancómetro
mandibulectômico=mandibulectómico
mangônia=mangónia
manicômio=manicómio
manicônia=manicónia
manocriômetro=manocriómetro
manovacuômetro=manovacuómetro
mansônia=mansónia
mansônico=mansónico
manômetro=manómetro
manônico=manónico
maratônio=maratónio
marco de Colônia=marco de Colónia
marcômago=marcómago
mareômetro=mareómetro
maria-antônia=maria-antónia
mariônia=mariónia
marsdênia=marsdénia
marsônia=marsónia
marterênia=marterénia
marêmetro=marémetro
massônia=massónia
mastectômico=mastectómico
masticônico=masticónico
mastoidectômico=mastoidectómico
mastomênico=mastoménico
mastotômico=mastotómico
matrimônio=matrimónio
matrônimo=matrónimo
matusalênico=matusalénico
maxilectômia=maxilectómia
maxilectômico=maxilectómico
maçônico=maçónico
maônia=maónia
meatotômico=meatotómico
mebezônio=mebezónio
mecatrônica=mecatrónica
mecatrônico=mecatrónico
mecetrônio=mecetrónio
mecistômela=mecistómela
mecênico=mecénico
mecômetro=mecómetro
mecônico=mecónico
mecônio=mecónio
mediastinotômico=mediastinotómico
medicômano=medicómano
mediodevônico=mediodevónico
mediomarêmetro=mediomarémetro
mediônio=mediónio
medrônico=medrónico
medêmia=medémia
megafônico=megafónico
megagametogênese=megagametogénese
megalofônico=megalofónico
megalosplênico=megalosplénico
megalômano=megalómano
megaohmômetro=megaohmómetro
megaprêmio=megaprémio
megasporogênese=megasporogénese
megastômida=megastómida
megatectônico=megatectónico
megatrônio=megatrónio
megôhmetro=megóhmetro
meibômia=meibómia
meiostêmone=meiostémone
meiostêmono=meiostémono
melancônico=melancónico
melancônio=melancónio
melanogênese=melanogénese
melanogênico=melanogénico
melanoêmese=melanoémese
melanêmese=melanémese
melanêmico=melanémico
melenêmese=melenémese
melitêmico=melitémico
melofônico=melofónico
melofônio=melofónio
melotômico=melotómico
melpômene=melpómene
melênico=melénico
melômano=melómano
melômele=melómele
melômelo=melómelo
membranofônio=membranofónio
membranogêneo=membranogéneo
memnônia=memnónia
menadênio=menadénio
meningococêmico=meningococémico
meniscectômico=meniscectómico
menopômida=menopómida
menoxênico=menoxénico
mentênio=menténio
menêmero=menémero
menênio=menénio
menômeno=menómeno
mercaptopropiônico=mercaptopropiónico
mercedônio=mercedónio
meridostêmone=meridostémone
meringectômico=meringectómico
meringotômico=meringotómico
meristêmone=meristémone
meristêmono=meristémono
merogênese=merogénese
merogônico=merogónico
meroplanctônico=meroplanctónico
merostênico=merosténico
merotômico=merotómico
meroxênio=meroxénio
merrêmia=merrémia
merônimo=merónimo
mesacônico=mesacónico
mesadênia=mesadénia
mesaxônico=mesaxónico
mesaxônio=mesaxónio
mesembriantêmea=mesembriantémea
mesenterectômico=mesenterectómico
mesitilênico=mesitilénico
mesmerômano=mesmerómano
mesogênico=mesogénico
mesoneurectômico=mesoneurectómico
mesonômico=mesonómico
mesopênico=mesopénico
mesorreômetro=mesorreómetro
mesossômico=mesossómico
mesostômida=mesostómida
mesotômico=mesotómico
messênico=messénico
messênio=messénio
mestre de cerimônia=mestre de cerimónia
mesômacro=mesómacro
mesômero=mesómero
mesômetro=mesómetro
mesômio=mesómio
mesônefro=mesónefro
mesônico=mesónico
mesônio=mesónio
metabolômetro=metabolómetro
metacetônico=metacetónico
metacrômico=metacrómico
metacrômio=metacrómio
metacrônico=metacrónico
metacônulo=metacónulo
metadrômio=metadrómio
metaemoglobinêmico=metaemoglobinémico
metafisicômano=metafisicómano
metafônico=metafónico
metagnômico=metagnómico
metagênese=metagénese
metagônimo=metagónimo
metalcônio=metalcónio
metalocrômico=metalocrómico
metalogênese=metalogénese
metalogênico=metalogénico
metalunogênio=metalunogénio
metalônimo=metalónimo
metamilênio=metamilénio
metanogênese=metanogénese
metanômetro=metanómetro
metargônio=metargónio
metassêmico=metassémico
metassômico=metassómico
metastênico=metasténico
metastômio=metastómio
metatiônico=metatiónico
metatônico=metatónico
metaxiônica=metaxiónica
metaxênico=metaxénico
metazônico=metazónico
metemoglobinêmico=metemoglobinémico
meteoronômico=meteoronómico
meteorônomo=meteorónomo
metilamônio=metilamónio
metilarsênico=metilarsénico
metilbenzetônio=metilbenzetónio
metilbenzênico=metilbenzénico
metilcarbônico=metilcarbónico
metilcetônico=metilcetónico
metilenodifosfônico=metilenodifosfónico
metiletilcetônico=metiletilcetónico
metilisobutilcetônico=metilisobutilcetónico
metilisopropilcetônico=metilisopropilcetónico
metilmalônico=metilmalónico
metilpentanônico=metilpentanónico
metilênico=metilénico
metilênio=metilénio
metiônico=metiónico
metopônia=metopónia
metranêmico=metranémico
metratônico=metratónico
metriperêmico=metriperémico
metronômico=metronómico
metrotômico=metrotómico
metroêmico=metroémico
metrêmico=metrémico
metrômano=metrómano
metrômetro=metrómetro
metrônomo=metrónomo
metômano=metómano
metônica=metónica
mevalônico=mevalónico
meônida=meónida
meônio=meónio
mhômetro=mhómetro
miastênico=miasténico
miatônico=miatónico
micetogênese=micetogénese
micetogênico=micetogénico
micetêmico=micetémico
micogênico=micogénico
micramperômetro=micramperómetro
micranatômico=micranatómico
micreconômico=micreconómico
micrelectrômetro=micrelectrómetro
micreletrômetro=micreletrómetro
micreletrônico=micreletrónico
micreterogênico=micreterogénico
microcronômetro=microcronómetro
microeconômico=microeconómico
microelectrômetro=microelectrómetro
microelectrônico=microelectrónico
microeterogênico=microeterogénico
microfônico=microfónico
microfônio=microfónio
micromanômetro=micromanómetro
micromônaca=micromónaca
micropoliadênico=micropoliadénico
microrradiômetro=microrradiómetro
microssômico=microssómico
microstêmone=microstémone
microstômida=microstómida
micrôhmetro=micróhmetro
micrômato=micrómato
micrômega=micrómega
micrômego=micrómego
micrômelo=micrómelo
micrômero=micrómero
micrômetra=micrómetra
micrômetro=micrómetro
micrômio=micrómio
micrônio=micrónio
micênico=micénico
micênio=micénio
micônio=micónio
miectômico=miectómico
mielastênico=mielasténico
mieloblastêmico=mieloblastémico
mielocitêmico=mielocitémico
mielogênico=mielogénico
mielomênico=mieloménico
mielotômico=mielotómico
mielêmico=mielémico
mielômero=mielómero
mielônico=mielónico
mielônio=mielónio
migdônico=migdónico
migdônio=migdónio
miliamperômetro=miliamperómetro
milivoltômetro=milivoltómetro
millsônia=millsónia
milsônia=milsónia
miltônia=miltónia
miltônico=miltónico
milênio=milénio
mimo-de-vênus=mimo-de-vénus
minibafômetro=minibafómetro
minibônus=minibónus
minigênio=minigénio
miniônibus=miniónibus
minodrônico=minodrónico
mioclônico=mioclónico
miocênico=miocénico
miodinamômetro=miodinamómetro
miodêmico=miodémico
miofônio=miofónio
miogênese=miogénese
miogênico=miogénico
miogênio=miogénio
miomectômico=miomectómico
miomotômico=miomotómico
mioneurastênico=mioneurasténico
miosinogênio=miosinogénio
miostêmone=miostémone
miotômico=miotómico
miotônico=miotónico
miotônus=miotónus
miristalcônio=miristalcónio
miriônimo=miriónimo
mirmedônia=mirmedónia
mirtênico=mirténico
mirônico=mirónico
miscigêneo=miscigéneo
miscigênese=miscigénese
miscigênio=miscigénio
misomacedônio=misomacedónio
mistrômio=mistrómio
mitogênica=mitogénica
mitogênio=mitogénio
mitrocômio=mitrocómio
mitêmico=mitémico
mitênia=miténia
mitômano=mitómano
mitônimo=mitónimo
mixedêmico=mixedémico
mixomônada=mixomónada
mixospôneida=mixospóneida
miômero=miómero
miômetro=miómetro
mnemotecnofônico=mnemotecnofónico
mnemômetro=mnemómetro
mnemônica=mnemónica
mnemônico=mnemónico
mnêmia=mnémia
mnêmico=mnémico
mogifônico=mogifónico
moglênico=moglénico
moglênio=moglénio
molibdênio=molibdénio
molifônio=molifónio
moliônide=moliónide
molpadômio=molpadómio
monadênia=monadénia
monadênio=monadénio
monarcômaco=monarcómaco
monatômico=monatómico
monaxônia=monaxónia
monaxônico=monaxónico
monaxônido=monaxónido
monecômice=monecómice
monembriônico=monembriónico
monetilênico=monetilénico
monoatômico=monoatómico
monoaxômia=monoaxómia
monoaxônico=monoaxónico
monoaxônido=monoaxónido
monobromobenzênico=monobromobenzénico
monocercômona=monocercómona
monocistrônico=monocistrónico
monoclorobenzênico=monoclorobenzénico
monoclônico=monoclónico
monocotiledônea=monocotiledónea
monocotiledôneo=monocotiledóneo
monocrômico=monocrómico
monocônico=monocónico
monoetilênico=monoetilénico
monofilogênese=monofilogénese
monofônico=monofónico
monofônio=monofónio
monogêneo=monogéneo
monogênese=monogénese
monogênico=monogénico
monogênio=monogénio
monogônico=monogónico
monogônio=monogónio
monoicômice=monoicómice
monomorfêmico=monomorfémico
mononitrogênico=mononitrogénico
mononitrogênio=mononitrogénio
monopirênico=monopirénico
monopneumôneo=monopneumóneo
monopnêumone=monopnéumone
monopsônico=monopsónico
monopsônio=monopsónio
monossêmico=monossémico
monossômico=monossómico
monotelefônico=monotelefónico
monotelefônio=monotelefónio
monotiônico=monotiónico
monotrêmato=monotrémato
monotônico=monotónico
monoxênia=monoxénia
monoxênico=monoxénico
monoêmero=monoémero
monsônia=monsónia
monçônico=monçónico
monêmero=monémero
monômano=monómano
monômero=monómero
monômetro=monómetro
monômico=monómico
monômio=monómio
monônico=monónico
monônimo=monónimo
monônique=monónique
morfinômano=morfinómano
morfofonêmico=morfofonémico
morfografêmico=morfografémico
morfogênese=morfogénese
morfogênico=morfogénico
morfonêmico=morfonémico
morfotectônico=morfotectónico
morfêmico=morfémico
morisônia=morisónia
mormônia=mormónia
mormônico=mormónico
mortônia=mortónia
moruôni=moruóni
morênia=morénia
morênico=morénico
moslêmico=moslémico
motoneurônio=motoneurónio
mucigênio=mucigénio
mucinêmico=mucinémico
mucobrômico=mucobrómico
mucogênio=mucogénio
mucrônalo=mucrónalo
mucrônico=mucrónico
mucrônulo=mucrónulo
mucômetro=mucómetro
mucônico=mucónico
multiatômico=multiatómico
multieletrônico=multieletrónico
multinômio=multinómio
multissistêmico=multissistémico
mulôji=mulóji
mungênio=mungénio
murchisônia=murchisónia
murquisônia=murquisónia
murênida=murénida
musculofrênico=musculofrénico
museômano=museómano
musicômano=musicómano
mutagênese=mutagénese
mutagênico=mutagénico
muônico=muónico
muônio=muónio
médio-helênico=médio-helénico
mêmnone=mémnone
mêmore=mémore
mênade=ménade
mênido=ménido
mênopon=ménopon
mômaro=mómaro
mônaco=mónaco
mônada=mónada
mônade=mónade
mônica=mónica
mônico=mónico
mônita=mónita
mônonix=mónonix
nablônio=nablónio
nadsônia=nadsónia
naftalenossulfônico=naftalenossulfónico
naftalinomonocarbônico=naftalinomonocarbónico
naftalênico=naftalénico
naftalênio=naftalénio
naftilaminossulfônico=naftilaminossulfónico
naftilênico=naftilénico
naftiônico=naftiónico
naftênico=nafténico
naftômano=naftómano
nanaoeletrônico=nanaoeletrónico
nanoeletrônico=nanoeletrónico
nanofotônico=nanofotónico
nanotermômetro=nanotermómetro
nanômelo=nanómelo
nanômetro=nanómetro
napoleônia=napoleónia
napoleônico=napoleónico
narcômano=narcómano
nasamônio=nasamónio
nasomanômetro=nasomanómetro
natrômetro=natrómetro
nauropômetro=nauropómetro
nautômetro=nautómetro
nautônia=nautónia
nearômetro=nearómetro
necrectômico=necrectómico
necrocômio=necrocómio
necroectômico=necroectómico
necrogêneo=necrogéneo
necrotômico=necrotómico
necrêmico=necrémico
necrômetro=necrómetro
necrônio=necrónio
nectômio=nectómio
nectônico=nectónico
neerlandofônia=neerlandofónia
nefelômetro=nefelómetro
nefogênio=nefogénio
nefradênia=nefradénia
nefratônico=nefratónico
nefrectômico=nefrectómico
nefrogênico=nefrogénico
nefrolitotômico=nefrolitotómico
nefrostômico=nefrostómico
nefrotômico=nefrotómico
nefroureterectômico=nefroureterectómico
nefrêmico=nefrémico
nefrômero=nefrómero
nefrômio=nefrómio
nefrônico=nefrónico
nefrônio=nefrónio
nefômetro=nefómetro
negatrônio=negatrónio
nelsônia=nelsónia
nematogônio=nematogónio
nematômice=nematómice
nemônico=nemónico
neo-helênico=neo-helénico
neobutônice=neobutónice
neocaledônio=neocaledónio
neocômio=neocómio
neoglicogênese=neoglicogénese
neogêneo=neogéneo
neogênese=neogénese
neogênico=neogénico
neomênia=neoménia
neomênida=neoménida
neomênio=neoménio
neonômio=neonómio
neoplatônico=neoplatónico
neoprênio=neoprénio
neossalomônico=neossalomónico
neosteogênico=neosteogénico
neotênico=neoténico
nepiônico=nepiónico
neridrônico=neridrónico
nerônico=nerónico
nerônio=nerónio
nesteostômico=nesteostómico
nestostômico=nestostómico
nestotômico=nestotómico
nesônimo=nesónimo
neuranêmico=neuranémico
neurastênico=neurasténico
neurectômico=neurectómico
neurelectrônico=neurelectrónico
neureletrônico=neureletrónico
neuroanatômico=neuroanatómico
neuroaxônio=neuroaxónio
neuroclônico=neuroclónico
neuroeletrônico=neuroeletrónico
neurofônico=neurofónico
neurogênese=neurogénese
neurogênico=neurogénico
neuropatogênico=neuropatogénico
neurostênico=neurosténico
neurotrofastênico=neurotrofasténico
neurotômico=neurotómico
neurotômio=neurotómio
neurotônico=neurotónico
neurômero=neurómero
neurômico=neurómico
neurômida=neurómida
neurônico=neurónico
neurônimo=neurónimo
neurônio=neurónio
neustônico=neustónico
neutropênico=neutropénico
neutrônico=neutrónico
neutrônio=neutrónio
nevrectômico=nevrectómico
nevrogênico=nevrogénico
nevrostênico=nevrosténico
nevrotômico=nevrotómico
nevrotômio=nevrotómio
nevrômero=nevrómero
nevômetro=nevómetro
neômeris=neómeris
neômiga=neómiga
neônio=neónio
nicholsônia=nicholsónia
nicolsônia=nicolsónia
nicrômico=nicrómico
nictofônico=nictofónico
nictêmero=nictémero
nidogênio=nidogénio
nilsônia=nilsónia
nilômetro=nilómetro
ninfectômico=ninfectómico
ninfotômico=ninfotómico
ninfômana=ninfómana
ninfômano=ninfómano
nipônico=nipónico
nistagmomioclônico=nistagmomioclónico
nitrobenzênico=nitrobenzénico
nitrobenzênio=nitrobenzénio
nitrocarbônio=nitrocarbónio
nitrogênio=nitrogénio
nitrossômona=nitrossómona
nitrosômona=nitrosómona
nitrotoluênico=nitrotoluénico
nitrômetro=nitrómetro
nitrômona=nitrómona
nitrônico=nitrónico
nitrônio=nitrónio
nitômetro=nitómetro
nitônio=nitónio
nivênia=nivénia
nivômetro=nivómetro
noegênese=noegénese
noematacômetro=noematacómetro
nomogênese=nomogénese
nomônico=nomónico
nomônimo=nomónimo
noogênese=noogénese
noogênico=noogénico
noostênico=noosténico
normocalcêmico=normocalcémico
normocrômico=normocrómico
normoglicêmico=normoglicémico
normovolêmico=normovolémico
norodônia=norodónia
nortênia=norténia
norônhia=norónhia
nosocômico=nosocómico
nosocômio=nosocómio
nosoeconômico=nosoeconómico
nosogênico=nosogénico
nosonômico=nosonómico
nostômano=nostómano
nosômano=nosómano
notiômetro=notiómetro
notiônomo=notiónomo
notogônia=notogónia
notossômalo=notossómalo
nototênia=nototénia
notômalo=notómalo
notômelo=notómelo
notôni=notóni
notônomo=notónomo
novênio=novénio
noz-vômica=noz-vómica
noêmia=noémia
noêmico=noémico
nucleogênese=nucleogénese
nucleônica=nucleónica
nucleônico=nucleónico
nulissômico=nulissómico
numênico=numénico
numênio=numénio
nutrigenômico=nutrigenómico
nêmato=némato
nêmedra=némedra
nêmese=némese
nêmesis=némesis
nêmete=némete
nêmofis=némofis
nêmonix=némonix
nênia=nénia
nênio=nénio
nômada=nómada
nômade=nómade
nômeno=nómeno
nômia=nómia
nômico=nómico
nômina=nómina
nômio=nómio
nômonix=nómonix
nônio=nónio
nônuplo=nónuplo
oariotômico=oariotómico
obcônico=obcónico
obdiplostêmone=obdiplostémone
oberônia=oberónia
obsônico=obsónico
ocotônida=ocotónida
ocrômetro=ocrómetro
ocrômia=ocrómia
octacêmida=octacémida
octafônio=octafónio
octogênio=octogénio
octostêmone=octostémone
octênomo=octénomo
odeofônio=odeofónio
odinômetro=odinómetro
odocnêmide=odocnémide
odocnêmis=odocnémis
odogênese=odogénese
odontiônica=odontiónica
odontoblastômio=odontoblastómio
odontogênese=odontogénese
odontogênico=odontogénico
odontômaco=odontómaco
odontômero=odontómero
odontômetro=odontómetro
odontômia=odontómia
odontônice=odontónice
odontônio=odontónio
odontônique=odontónique
odostômia=odostómia
odotaxômetro=odotaxómetro
odômetro=odómetro
odônimo=odónimo
oecogônia=oecogónia
ofidômona=ofidómona
ofidônais=ofidónais
ofiocnêmis=ofiocnémis
ofiocômida=ofiocómida
ofiopogônea=ofiopogónea
ofioquitônida=ofioquitónida
ofiômaco=ofiómaco
ofiômice=ofiómice
ofiônice=ofiónice
ofiônique=ofiónique
oftalmectômico=oftalmectómico
oftalmodiastasiômetro=oftalmodiastasiómetro
oftalmodinamômetro=oftalmodinamómetro
oftalmofacômetro=oftalmofacómetro
oftalmoflebotômico=oftalmoflebotómico
oftalmomiotômico=oftalmomiotómico
oftalmopônico=oftalmopónico
oftalmostatômetro=oftalmostatómetro
oftalmotermômetro=oftalmotermómetro
oftalmotonômetro=oftalmotonómetro
oftalmotropômetro=oftalmotropómetro
oftalmotômico=oftalmotómico
oftalmômetro=oftalmómetro
ofônio=ofónio
ohmamperômetro=ohmamperómetro
ohmômetro=ohmómetro
oicômona=oicómona
oleogasogênio=oleogasogénio
oleogênese=oleogénese
oleoptênio=oleopténio
oleorrefractômetro=oleorrefractómetro
oleorrefratômetro=oleorrefratómetro
oleômetro=oleómetro
olfactrônica=olfactrónica
olfactômetro=olfactómetro
olfatômetro=olfatómetro
olhômetro=olhómetro
oligoblênico=oligoblénico
oligocitêmico=oligocitémico
oligocromêmico=oligocromémico
oligocronômetro=oligocronómetro
oligocênico=oligocénico
oligoeritrocitêmico=oligoeritrocitémico
oligofrênico=oligofrénico
oligogênico=oligogénico
oligopiônico=oligopiónico
oligopsônico=oligopsónico
oligopsônio=oligopsónio
oligossiderêmico=oligossiderémico
oligostêmone=oligostémone
oligoêmico=oligoémico
oligêmico=oligémico
oligômano=oligómano
oligômero=oligómero
olpadrônico=olpadrónico
ombrômetro=ombrómetro
omentectômico=omentectómico
omentotômico=omentotómico
omiômetro=omiómetro
omnigênero=omnigénero
omnitônico=omnitónico
omofrônida=omofrónida
omoplatectômico=omoplatectómico
oncogênese=oncogénese
oncogênico=oncogénico
oncotômico=oncotómico
oncômero=oncómero
oncômetro=oncómetro
ondômetro=ondómetro
oneômano=oneómano
onfalectômico=onfalectómico
onfalotômico=onfalotómico
onicogênico=onicogénico
onigênero=onigénero
onitônico=onitónico
oniômano=oniómano
onomatômano=onomatómano
ontogênese=ontogénese
ontogênico=ontogénico
ontogônico=ontogónico
onômano=onómano
onônide=onónide
onônis=onónis
ooforectômico=ooforectómico
ooforossalpingectômico=ooforossalpingectómico
oogênese=oogénese
oogênico=oogénico
oogônia=oogónia
oogônio=oogónio
operômetro=operómetro
opiliônia=opiliónia
opiliônido=opiliónido
opistocômida=opistocómida
opistotônico=opistotónico
opistômida=opistómida
opisômetro=opisómetro
opiômano=opiómano
opsiômetro=opsiómetro
opsômano=opsómano
opsônico=opsónico
opsônomo=opsónomo
opticômetro=opticómetro
optoeletrônico=optoeletrónico
optofônico=optofónico
optomiômetro=optomiómetro
optrônica=optrónica
optômetro=optómetro
oquênia=oquénia
orbitômetro=orbitómetro
orcomênico=orcoménico
orcomênio=orcoménio
orcotômico=orcotómico
orcômene=orcómene
oregônia=oregónia
orexigênico=orexigénico
orfeônico=orfeónico
organogênese=organogénese
organogênico=organogénico
organonômico=organonómico
organozoonômico=organozoonómico
organônimo=organónimo
orgonômetro=orgonómetro
orgônio=orgónio
orinômio=orinómio
orixionômico=orixionómico
orizômio=orizómio
ormossolênia=ormossolénia
ornitofônico=ornitofónico
ornitofônio=ornitofónio
ornitotômico=ornitotómico
ornitômano=ornitómano
ornitômia=ornitómia
ornêmide=ornémide
orogênese=orogénese
orogênico=orogénico
orotopônimo=orotopónimo
orquestômano=orquestómano
orquidectômico=orquidectómico
orquiectômico=orquiectómico
orquiotômico=orquiotómico
ortigômetro=ortigómetro
ortoarsênico=ortoarsénico
ortocarbônico=ortocarbónico
ortocrômico=ortocrómico
ortodrômico=ortodrómico
ortofrênico=ortofrénico
ortofônico=ortofónico
ortognomônico=ortognomónico
ortogênese=ortogénese
ortogênico=ortogénico
ortogênida=ortogénida
ortoidrogênico=ortoidrogénico
ortoidrogênio=ortoidrogénio
ortopiroxênico=ortopiroxénico
ortopiroxênio=ortopiroxénio
ortossismômetro=ortossismómetro
ortotômico=ortotómico
ortotônico=ortotónico
ortoxilênico=ortoxilénico
ortômega=ortómega
ortômetro=ortómetro
ortônico=ortónico
ortônimo=ortónimo
ortônique=ortónique
orêinomis=oréinomis
orômetro=orómetro
orônimo=orónimo
oscilatrônio=oscilatrónio
oscilômetro=oscilómetro
osfresiômetro=osfresiómetro
osfrômeno=osfrómeno
osmogênico=osmogénico
osmozômeo=osmozómeo
osmômetro=osmómetro
osqueotômico=osqueotómico
ossiculotômico=ossiculotómico
osteartrotômico=osteartrotómico
ostectômico=ostectómico
osteofônico=osteofónico
osteofônio=osteofónio
osteogênese=osteogénese
osteogênico=osteogénico
osteotômico=osteotómico
osteômero=osteómero
ostraciônida=ostraciónida
ostêmico=ostémico
ostômida=ostómida
otectômico=otectómico
oticômetro=oticómetro
otilônio=otilónio
otocônia=otocónia
otocônio=otocónio
otoemineurastênico=otoemineurasténico
otofônio=otofónio
otomiastênico=otomiasténico
otoneurastênico=otoneurasténico
ototômico=ototómico
otômetro=otómetro
otômice=otómice
otômio=otómio
otônia=otónia
ovalocitêmico=ovalocitémico
ovariectômico=ovariectómico
ovariogênico=ovariogénico
ovarioisterectômico=ovarioisterectómico
ovariossalpingectômico=ovariossalpingectómico
ovariossalpingectômio=ovariossalpingectómio
ovariotômico=ovariotómico
ovigênese=ovigénese
ovogênese=ovogénese
ovogênico=ovogénico
ovogônico=ovogónico
ovogônio=ovogónio
ovulogênese=ovulogénese
ovômero=ovómero
oxalêmico=oxalémico
oxiacetilênico=oxiacetilénico
oxiacetlênica=oxiacetlénica
oxicarbonêmico=oxicarbonémico
oxicarbônico=oxicarbónico
oxiclorocarbônico=oxiclorocarbónico
oxidipentônio=oxidipentónio
oxidrônico=oxidrónico
oxiemoglobinômetro=oxiemoglobinómetro
oxifenônio=oxifenónio
oxifônico=oxifónico
oxigenômetro=oxigenómetro
oxigênase=oxigénase
oxigênio=oxigénio
oxigônia=oxigónia
oximalônico=oximalónico
oxipirrônio=oxipirrónio
oxipropiônico=oxipropiónico
oxirrubrênico=oxirrubrénico
oxistômata=oxistómata
oxisônio=oxisónio
oxitefônio=oxitefónio
oxitônico=oxitónico
oxozônide=oxozónide
oxozônio=oxozónio
oxônico=oxónico
oxônio=oxónio
ozonômetro=ozonómetro
ozostômico=ozostómico
ozênico=ozénico
ozômena=ozómena
ozônide=ozónide
ozônido=ozónido
ozônio=ozónio
pacômetro=pacómetro
paflagônio=paflagónio
palatômetro=palatómetro
palemônio=palemónio
paleocênico=paleocénico
paleogenômico=paleogenómico
paleogêneo=paleogéneo
paleogênico=paleogénico
paleontogênico=paleontogénico
palidectômico=palidectómico
paligênese=paligénese
palindrômico=palindrómico
palinfrômico=palinfrómico
palingênese=palingénese
palingênico=palingénico
paliogênese=paliogénese
palrônio=palrónio
palêmon=palémon
palêmone=palémone
pamidrônico=pamidrónico
pan-harmônico=pan-harmónico
pan-helênico=pan-helénico
pan-iônico=pan-iónico
panarmônio=panarmónio
pancitopênico=pancitopénico
pancolectômico=pancolectómico
pancreatectômico=pancreatectómico
pancreatocolecistectômico=pancreatocolecistectómico
pancreatojejunostômico=pancreatojejunostómico
pancreatosplênico=pancreatosplénico
pancreatotômico=pancreatotómico
pancreatônico=pancreatónico
pancrômico=pancrómico
pancrônico=pancrónico
pancurônio=pancurónio
pandemônico=pandemónico
pandemônio=pandemónio
pandinamômetro=pandinamómetro
pandêmico=pandémico
panelênia=panelénia
pangeômetra=pangeómetra
pangênese=pangénese
pangônia=pangónia
panjônico=panjónico
panleucopênico=panleucopénico
pantelefônico=pantelefónico
panteônico=panteónico
panteônimo=panteónimo
pantofônio=pantofónio
pantoplanctônico=pantoplanctónico
pantotênico=pantoténico
pantômetro=pantómetro
panônio=panónio
papilectômico=papilectómico
papiliônida=papiliónida
papilotômico=papilotómico
paquicnêmia=paquicnémia
paquigônea=paquigónea
paquilêmure=paquilémure
paquilômero=paquilómero
paquiotênico=paquioténico
paquistêmone=paquistémone
paquistômia=paquistómia
paquitênico=paquiténico
paquiurônis=paquiurónis
parabenzoquinônico=parabenzoquinónico
parabignônia=parabignónia
paracianogênio=paracianogénio
paracomênico=paracoménico
paracrônico=paracrónico
paracônico=paracónico
paracônide=paracónide
paracônido=paracónido
paracônulo=paracónulo
paradrômio=paradrómio
paraeconômico=paraeconómico
paraeletrônico=paraeletrónico
paraexilênico=paraexilénico
parafrênico=parafrénico
parafrônico=parafrónico
parafêmico=parafémico
parafônico=parafónico
paraglucônico=paraglucónico
paragênese=paragénese
paragônia=paragónia
paragônimo=paragónimo
paraidrogênico=paraidrogénico
paraidrogênio=paraidrogénio
paralipômeno=paralipómeno
paramecônico=paramecónico
paramioclônico=paramioclónico
paramiotônico=paramiotónico
paramênia=paraménia
paramênico=paraménico
paramônada=paramónada
paranitroazobenzênico=paranitroazobenzénico
parantisselênio=parantisselénio
parantracênico=parantracénico
paranômalo=paranómalo
paranômico=paranómico
paraormônico=paraormónico
paraormônio=paraormónio
parapetalostêmone=parapetalostémone
parapositrônio=parapositrónio
parasalênia=parasalénia
parasitogênico=parasitogénico
parasitêmico=parasitémico
parassacarômice=parassacarómice
parasselênico=parasselénico
parasselênio=parasselénio
parassimpaticotônico=parassimpaticotónico
parassimpatotônico=parassimpatotónico
parassêmico=parassémico
parastêmone=parastémone
paratireoidectômico=paratireoidectómico
paratiroidetômico=paratiroidetómico
paratiônico=paratiónico
paratormônio=paratormónio
paratênia=paraténia
paratômico=paratómico
paratônico=paratónico
parazônio=parazónio
parcimônia=parcimónia
parcômetro=parcómetro
pardocorênio=pardocorénio
parelectronômico=parelectronómico
parendômice=parendómice
paridrogênio=paridrogénio
parkinsônia=parkinsónia
parotidectômico=parotidectómico
paroxitônico=paroxitónico
partenogênese=partenogénese
partenogênico=partenogénico
partenogônico=partenogónico
partogênese=partogénese
partênia=parténia
partênio=parténio
partênope=parténope
parvônia=parvónia
parêmia=parémia
parênese=parénese
parêumene=paréumene
parômalo=parómalo
parônica=parónica
parônimo=parónimo
passageiro-quilômetro=passageiro-quilómetro
passômetro=passómetro
patagônico=patagónico
patagônio=patagónio
patagônula=patagónula
patarênio=patarénio
patelectômico=patelectómico
patersônia=patersónia
patocrônico=patocrónico
patognomônica=patognomónica
patognomônico=patognomónico
patogênese=patogénese
patogênico=patogénico
patonômico=patonómico
patrimônio=património
patrogênese=patrogénese
patrogênico=patrogénico
patrogônico=patrogónico
patrônimo=patrónimo
patrônomo=patrónomo
patômano=patómano
pausimênico=pausiménico
pavônia=pavónia
paxtônia=paxtónia
peagômetro=peagómetro
pecilocrômico=pecilocrómico
pecilômetro=pecilómetro
pedilônia=pedilónia
pediômetro=pediómetro
pediônomo=pediónomo
pedobarômetro=pedobarómetro
pedoflebotômico=pedoflebotómico
pedogênese=pedogénese
pedogênico=pedogénico
pedogônico=pedogónico
pedonômico=pedonómico
pedopartenogênese=pedopartenogénese
pedômetro=pedómetro
pedônomo=pedónomo
pegômia=pegómia
pelargônico=pelargónico
pelargônio=pelargónio
peletrônio=peletrónio
pelicotômico=pelicotómico
peliônia=peliónia
pelogênia=pelogénia
pelvectômico=pelvectómico
pelvicefalômetro=pelvicefalómetro
pelviclisiômetro=pelviclisiómetro
pelvitômico=pelvitómico
pelêmico=pelémico
pelônia=pelónia
pelônula=pelónula
pemênico=peménico
penoctônio=penoctónio
pentametônio=pentametónio
pentaplostêmone=pentaplostémone
pentatiônico=pentatiónico
pentatômico=pentatómico
pentatônico=pentatónico
pentolônio=pentolónio
peotômico=peotómico
peperômia=peperómia
peplônia=peplónia
pepsinogênico=pepsinogénico
pepsinogênio=pepsinogénio
peptogênico=peptogénico
peptônico=peptónico
pepônide=pepónide
pepônio=pepónio
perbrômico=perbrómico
percarbônico=percarbónico
percloretilênico=percloretilénico
percloroetilênico=percloroetilénico
pereônico=pereónico
periantômega=periantómega
periaxônico=periaxónico
periaxônio=periaxónio
pericardiofrênico=pericardiofrénico
pericardiotômico=pericardiotómico
peridrômio=peridrómio
perifônico=perifónico
perigênese=perigénese
perigônico=perigónico
perigônio=perigónio
perilômia=perilómia
perineostômico=perineostómico
perineotômico=perineotómico
periodômetro=periodómetro
periodônimo=periodónimo
periosteogênese=periosteogénese
periosteotômico=periosteotómico
peripneumônico=peripneumónico
perisifônia=perisifónia
perispômeno=perispómeno
perissifônia=perissifónia
peristerônico=peristerónico
peristômato=peristómato
peristômico=peristómico
peristômio=peristómio
perisônio=perisónio
peritômico=peritómico
peritônio=peritónio
permocarbônico=permocarbónico
peroxissômico=peroxissómico
perrênico=perrénico
persoônia=persoónia
perspectômetro=perspectómetro
perspetômetro=perspetómetro
persulfocianogênio=persulfocianogénio
persulfônico=persulfónico
perômelo=perómelo
perônia=perónia
perônio=perónio
pesticêmico=pesticémico
petalostêmone=petalostémone
petalômera=petalómera
petrogênese=petrogénese
petrogênico=petrogénico
petrômio=petrómio
petrônio=petrónio
petênia=peténia
pezômaco=pezómaco
peônia=peónia
peônico=peónico
peônio=peónio
piarêmico=piarémico
picnogônida=picnogónida
picnômero=picnómero
picnômetro=picnómetro
picramônio=picramónio
picroalumogênio=picroalumogénio
picrolônico=picrolónico
picrômero=picrómero
pictônico=pictónico
pielolitotômico=pielolitotómico
pielostômico=pielostómico
pielotômico=pielotómico
piezelectrômetro=piezelectrómetro
piezeletrômetro=piezeletrómetro
piezoelectrômetro=piezoelectrómetro
piezoeletrômetro=piezoeletrómetro
piezofototrônico=piezofototrónico
piezotrônico=piezotrónico
piezômetro=piezómetro
pigmentogênico=pigmentogénico
pigômelo=pigómelo
pilorectômico=pilorectómico
pilorogastrectômico=pilorogastrectómico
piloromiotômico=piloromiotómico
pilorotômico=pilorotómico
pilômetro=pilómetro
pinonônico=pinonónico
piogênese=piogénese
piogênico=piogénico
pioperitônio=pioperitónio
piopneumoperitônio=piopneumoperitónio
pioêmese=pioémese
pioêmico=pioémico
pipecurônio=pipecurónio
piperômio=piperómio
piptadênia=piptadénia
piranômetro=piranómetro
pirazolônico=pirazolónico
piraômetro=piraómetro
pirdônio=pirdónio
pireliômetro=pireliómetro
pirenêmico=pirenémico
piretogênese=piretogénese
piretogênico=piretogénico
pirgeômetro=pirgeómetro
piridrônico=piridrónico
piroeliômetro=piroeliómetro
pirofônio=pirofónio
pirogeômetro=pirogeómetro
piroglobulinêmico=piroglobulinémico
pirogênese=pirogénese
pirogênico=pirogénico
pirogênio=pirogénio
piromecônico=piromecónico
pironômico=pironómico
pirorracêmico=pirorracémico
pirossômido=pirossómido
pirosômido=pirosómido
pirotônide=pirotónide
pirotônido=pirotónido
piroxênico=piroxénico
piroxênio=piroxénio
pirozônio=pirozónio
pirralcônio=pirralcónio
pirrufônia=pirrufónia
pirrônico=pirrónico
piruvêmico=piruvémico
pirênio=pirénio
pirênula=pirénula
pirômaco=pirómaco
pirômano=pirómano
pirômetro=pirómetro
pirônio=pirónio
pisoodônofis=pisoodónofis
pisônia=pisónia
pitecoctênio=pitecocténio
pitômetro=pitómetro
pitônico=pitónico
pitônida=pitónida
piêmese=piémese
piêmico=piémico
piônio=piónio
placorganômetro=placorganómetro
placunanômia=placunanómia
planctônico=planctónico
planctônio=planctónio
plancônia=plancónia
planipênio=planipénio
plantômano=plantómano
plasmalêmico=plasmalémico
plasminogênio=plasminogénio
plasmogênico=plasmogénico
plasmogônico=plasmogónico
plasmotômico=plasmotómico
plasmônico=plasmónico
plastiduloperingênese=plastiduloperingénese
plastogênico=plastogénico
plastoquinônico=plastoquinónico
plastômero=plastómero
plastômetro=plastómetro
platagônio=platagónio
platianquênia=platianquénia
platicercômio=platicercómio
platicnêmico=platicnémico
platicnêmide=platicnémide
platicnêmis=platicnémis
platictênio=platicténio
platigônio=platigónio
platimênia=platiménia
platistêmone=platistémone
platiônico=platiónico
platêmio=platémio
platêmis=platémis
platônia=platónia
platônico=platónico
plectocômia=plectocómia
plectrônia=plectrónia
pleiocrômico=pleiocrómico
pleistocênico=pleistocénico
pleiômere=pleiómere
pleiômero=pleiómero
pleocrômico=pleocrómico
pleostêmone=pleostémone
plerêmico=plerémico
plesiarctômio=plesiarctómio
plessômetro=plessómetro
pleurectômico=pleurectómico
pleurogônio=pleurogónio
pleuroperipneumônico=pleuroperipneumónico
pleuropneumônico=pleuropneumónico
pleurossômico=pleurossómico
pleurotômico=pleurotómico
pleurômelo=pleurómelo
pleurônio=pleurónio
pleônico=pleónico
pleônio=pleónio
pliocrômico=pliocrómico
pliocênico=pliocénico
pliodinatrônio=pliodinatrónio
pliopleistocênico=pliopleistocénico
plioplistocênico=plioplistocénico
pliotrônio=pliotrónio
pliotômico=pliotómico
plistocênico=plistocénico
pliômere=pliómere
pliômero=pliómero
plurissêmico=plurissémico
plutonômico=plutonómico
plutônico=plutónico
plutônio=plutónio
pluviômetro=pluviómetro
pneumatofônico=pneumatofónico
pneumatogênico=pneumatogénico
pneumatêmico=pneumatémico
pneumatômaco=pneumatómaco
pneumatômetro=pneumatómetro
pneumectômico=pneumectómico
pneumobacilêmico=pneumobacilémico
pneumococêmico=pneumococémico
pneumonectômico=pneumonectómico
pneumonêmico=pneumonémico
pneumonômetro=pneumonómetro
pneumoperitônio=pneumoperitónio
pneumorretroperitônio=pneumorretroperitónio
pneumostômato=pneumostómato
pneumostômio=pneumostómio
pneumotômaco=pneumotómaco
pneumotômico=pneumotómico
pneumêmico=pneumémico
pneumômetro=pneumómetro
pneumônica=pneumónica
pneumônico=pneumónico
pneômetro=pneómetro
pnêumico=pnéumico
podocnêmide=podocnémide
podocnênis=podocnénis
pododinamômetro=pododinamómetro
podogônio=podogónio
podostêmone=podostémone
podômero=podómero
podômetro=podómetro
pogonostêmone=pogonostémone
pogônia=pogónia
pogônio=pogónio
poimênica=poiménica
polaquênio=polaquénio
polarigênese=polarigénese
polaristrobômetro=polaristrobómetro
poldônio=poldónio
polemonômico=polemonómico
polemônio=polemónio
poliadenômico=poliadenómico
poliadênia=poliadénia
poliaquênio=poliaquénio
poliartêmia=poliartémia
poliatômico=poliatómico
poliblênico=poliblénico
policitêmico=policitémico
policlônia=policlónia
policotiledôneo=policotiledóneo
policotômico=policotómico
policrômico=policrómico
policônico=policónico
polidrômico=polidrómico
polidrônio=polidrónio
polifênis=polifénis
polifônico=polifónico
poligônea=poligónea
poligôneo=poligóneo
poligônia=poligónia
polinêmico=polinémico
polinêmida=polinémida
polinômio=polinómio
polioximetilênico=polioximetilénico
polipectômico=polipectómico
polipeptidêmico=polipeptidémico
polipetidêmico=polipetidémico
polipotômico=polipotómico
poliprotônico=poliprotónico
polirribossômico=polirribossómico
polisoprênico=polisoprénico
polissifônia=polissifónia
polissifônico=polissifónico
polissêmico=polissémico
polissômico=polissómico
polistirênico=polistirénico
polistêmone=polistémone
polistêmono=polistémono
polistômio=polistómio
politicômano=politicómano
politênico=politénico
politônimo=politónimo
polixetônio=polixetónio
polizônida=polizónida
polizônio=polizónio
poliêmico=poliémico
poliômato=poliómato
poliônico=poliónico
poliônimo=poliónimo
polêmia=polémia
polêmica=polémica
polêmico=polémico
polêmono=polémono
polênia=polénia
político-econômico=político-económico
polônico=polónico
polônio=polónio
pomatômida=pomatómida
ponogêneo=ponogéneo
ponogênico=ponogénico
pontogênia=pontogénia
pontônia=pontónia
populônio=populónio
poradênico=poradénico
porfirinêmico=porfirinémico
porfirogênito=porfirogénito
poriômano=poriómano
pornofônico=pornofónico
porômetro=porómetro
porômia=porómia
porônia=porónia
poscênio=poscénio
poseidônia=poseidónia
posidonômia=posidonómia
posidônia=posidónia
positrônico=positrónico
positrônio=positrónio
possidônio=possidónio
postectômico=postectómico
postedênico=postedénico
posteotômico=posteotómico
postetômico=postetómico
postscênico=postscénico
postônico=postónico
posômetro=posómetro
potamônimo=potamónimo
potassêmico=potassémico
potenciômetro=potenciómetro
potenciônico=potenciónico
potômano=potómano
potômetro=potómetro
prasocrômio=prasocrómio
precipitinogênico=precipitinogénico
precipitinogênio=precipitinogénio
precipitogênico=precipitogénico
precipitogênio=precipitogénio
precipitrônio=precipitrónio
precônio=precónio
prednisônico=prednisónico
presbifrênico=presbifrénico
presbiofrênico=presbiofrénico
pressiômetro=pressiómetro
prestimônio=prestimónio
prestônia=prestónia
pretônico=pretónico
priabônico=priabónico
priamômano=priamómano
primigênio=primigénio
primogênito=primogénito
prionômero=prionómero
pristiopômida=pristiopómida
pristipômida=pristipómida
pristônico=pristónico
priônia=priónia
priônico=priónico
priônio=priónio
priônopo=priónopo
proctectômico=proctectómico
proctostômico=proctostómico
proctotômico=proctotómico
procônia=procónia
prodecônio=prodecónio
prodrômico=prodrómico
prodênia=prodénia
progesterônico=progesterónico
progestogênico=progestogénico
progênie=progénie
progênito=progénito
progônico=progónico
prolegômeno=prolegómeno
prolônio=prolónio
proneomênia=proneoménia
propanotricarbônico=propanotricarbónico
propanônico=propanónico
proparoxitônico=proparoxitónico
properispômeno=properispómeno
propilênico=propilénico
propiônico=propiónico
propômacro=propómacro
proscênio=proscénio
prosfisectômico=prosfisectómico
prosfisiectômico=prosfisiectómico
proslambanômeno=proslambanómeno
prosobônia=prosobónia
prosodêmico=prosodémico
prostatectômico=prostatectómico
prostatocistotônico=prostatocistotónico
prostatolitotômico=prostatolitotómico
prostatomiomectônico=prostatomiomectónico
prostatotômico=prostatotómico
prostatovesiculectômico=prostatovesiculectómico
prostatômetro=prostatómetro
prostômida=prostómida
prostômio=prostómio
prosônimo=prosónimo
proteidêmico=proteidémico
proteinêmico=proteinémico
proteuneurônio=proteuneurónio
proteômico=proteómico
protidêmico=protidémico
protocanônico=protocanónico
protocônide=protocónide
protocônido=protocónido
protocônulo=protocónulo
protofônico=protofónico
protomônada=protomónada
protoneurônio=protoneurónio
protortônia=protortónia
protostômio=protostómio
protoxilêmico=protoxilémico
protômala=protómala
protômero=protómero
protômetro=protómetro
protômice=protómice
protônefro=protónefro
protônico=protónico
protônio=protónio
proxêmica=proxémica
proxêmico=proxémico
proêmio=proémio
prussômano=prussómano
pré-abdômen=pré-abdómen
pré-agônico=pré-agónico
prê-helênico=pré-helénico
prêmio=prémio
prênico=prénico
prômero=prómero
prônefro=prónefro
prônubo=prónubo
psamômio=psamómio
psarônio=psarónio
pseudagênia=pseudagénia
pseudequêneis=pseudequéneis
pseudoanônimo=pseudoanónimo
pseudocônaro=pseudocónaro
pseudoeufêmico=pseudoeufémico
pseudoiônico=pseudoiónico
pseudomônada=pseudomónada
pseudomônade=pseudomónade
pseudorrandômico=pseudorrandómico
pseudoscorpiônido=pseudoscorpiónido
pseudostênico=pseudosténico
pseudourêmia=pseudourémia
pseudômero=pseudómero
pseudômona=pseudómona
pseudônimo=pseudónimo
psicastênico=psicasténico
psicautonômico=psicautonómico
psicoeconômico=psicoeconómico
psicofônico=psicofónico
psicogalvanômetro=psicogalvanómetro
psicogênese=psicogénese
psicogênico=psicogénico
psicogônico=psicogónico
psiconômico=psiconómico
psicotônico=psicotónico
psicrômetro=psicrómetro
psicômetra=psicómetra
psicômetro=psicómetro
psilostêmone=psilostémone
psilônia=psilónia
psiqueconômico=psiqueconómico
psofômetro=psofómetro
pterogônio=pterogónio
pterômalo=pterómalo
pterômio=pterómio
pterônia=pterónia
ptoseonômico=ptoseonómico
ptênio=pténio
ptênopo=pténopo
pubiotômico=pubiotómico
pubitômico=pubitómico
pugilômetro=pugilómetro
pulmômetro=pulmómetro
pulpectômico=pulpectómico
pulpotômico=pulpotómico
pulsômetro=pulsómetro
pulênia=pulénia
pupilômetro=pupilómetro
puranegatônio=puranegatónio
purapositônio=purapositónio
pêmeno=pémeno
pênalti=pénalti
pêni=péni
pênia=pénia
pênico=pénico
pênio=pénio
pênis=pénis
pênopo=pénopo
pênula=pénula
pênulo=pénulo
pós-abdômen=pós-abdómen
pômice=pómice
pômulo=pómulo
pônei=pónei
quadrafônico=quadrafónico
quadricotiledôneo=quadricotiledóneo
quadrigêmeo=quadrigémeo
quadrigêmino=quadrigémino
quadrinômio=quadrinómio
quadriênio=quadriénio
quantassômico=quantassómico
quantômetro=quantómetro
quartzarênico=quartzarénico
quaterniônico=quaterniónico
quatriênio=quatriénio
queiletômico=queiletómico
queiradênia=queiradénia
quelidônia=quelidónia
quelidônico=quelidónico
quelidônio=quelidónio
quelotômico=quelotómico
quelônio=quelónio
quenômede=quenómede
quenômero=quenómero
queratogênese=queratogénese
queratômetro=queratómetro
queratônico=queratónico
quercitrônio=quercitrónio
querdômetro=querdómetro
querimônia=querimónia
querogênico=querogénico
querogênio=querogénio
querômano=querómano
quetossômido=quetossómido
quetômio=quetómio
quiletômico=quiletómico
quilocrômis=quilocrómis
quilomônada=quilomónada
quilostômela=quilostómela
quilotômico=quilotómico
quilêmico=quilémico
quilômeno=quilómeno
quilômetro=quilómetro
quilômio=quilómio
quilômona=quilómona
quimômetro=quimómetro
quindênio=quindénio
quindônio=quindónio
quinoleinacarbônico=quinoleinacarbónico
quinolênico=quinolénico
quinolônico=quinolónico
quinolônio=quinolónio
quinquênio=quinquénio
quiradênia=quiradénia
quirognomônico=quirognomónico
quirognômone=quirognómone
quironômico=quironómico
quironômida=quironómida
quiropodômio=quiropodómio
quirotônico=quirotónico
quirurômio=quirurómio
quirômetro=quirómetro
quirômio=quirómio
quirônimo=quirónimo
quirônio=quirónio
quirônomo=quirónomo
quissênia=quissénia
quitonômice=quitonómice
quitôli=quitóli
quitôni=quitóni
quitônida=quitónida
quitônio=quitónio
quiônide=quiónide
quêmaque=quémaque
quênice=quénice
quênico=quénico
quênopo=quénopo
rabdadênia=rabdadénia
rabdogônio=rabdogónio
rabdossômico=rabdossómico
rabdômico=rabdómico
rabdônomo=rabdónomo
racêmase=racémase
racêmico=racémico
racômice=racómice
radarastronômico=radarastronómico
radiastronômico=radiastronómico
radiastrônomo=radiastrónomo
radicotômico=radicotómico
radiculectômico=radiculectómico
radielectrônico=radielectrónico
radieletrônico=radieletrónico
radioastronômico=radioastronómico
radioastrônomo=radioastrónomo
radiocarbônico=radiocarbónico
radiocarbônio=radiocarbónio
radiocromômetro=radiocromómetro
radioelectrônico=radioelectrónico
radioeletrônico=radioeletrónico
radiofônico=radiofónico
radiofônio=radiofónio
radiogoniômetro=radiogoniómetro
radiogênese=radiogénese
radiogênico=radiogénico
radiointerferômetro=radiointerferómetro
radiomanômetro=radiomanómetro
radiomicrômetro=radiomicrómetro
radiosclerômetro=radiosclerómetro
radiotelefônico=radiotelefónico
radiotoxêmico=radiotoxémico
radiotrônio=radiotrónio
radiômano=radiómano
radiômetro=radiómetro
radônio=radónio
rafidômona=rafidómona
ragônica=ragónica
ramônia=ramónia
randômico=randómico
rapacurônio=rapacurónio
raquiopneumônico=raquiopneumónico
raquiopnêumico=raquiopnéumico
raquiotômico=raquiotómico
raquitômico=raquitómico
raquiômetro=raquiómetro
ravsônia=ravsónia
ravênia=ravénia
rebeliônico=rebeliónico
rectotômico=rectotómico
redônico=redónico
reflexômetro=reflexómetro
refractômetro=refractómetro
refratômetro=refratómetro
religiômano=religiómano
remêmoro=remémoro
renômetro=renómetro
reotômico=reotómico
requiênia=requiénia
resnatrônio=resnatrónio
respirômetro=respirómetro
restênia=resténia
retectômico=retectómico
retossigmoidectômico=retossigmoidectómico
retotômico=retotómico
retrodontômio=retrodontómio
retroperitônio=retroperitónio
retropneumoperitônio=retropneumoperitónio
retrêmulo=retrémulo
retômetro=retómetro
reumatômetro=reumatómetro
reômetro=reómetro
reônomo=reónomo
riazênico=riazénico
ribossômico=ribossómico
riburônico=riburónico
ribônico=ribónico
richardsônia=richardsónia
rincômio=rincómio
rinofônico=rinofónico
rinotômico=rinotómico
rintônico=rintónico
rinêmio=rinémio
rinômacro=rinómacro
rinômetro=rinómetro
ripidômio=ripidómio
ripômetro=ripómetro
risedrônico=risedrónico
rissômato=rissómato
ritidectômico=ritidectómico
ritidômico=ritidómico
ritmômetro=ritmómetro
ritrodontômio=ritrodontómio
ritropirrônio=ritropirrónio
rizoclônio=rizoclónio
rizoctônio=rizoctónio
rizogênico=rizogénico
rizogônio=rizogónio
rizomônada=rizomónada
rizosolênia=rizosolénia
rizossolênia=rizossolénia
rizostômico=rizostómico
rizostômida=rizostómida
rizotômico=rizotómico
rizotônico=rizotónico
rizoxênia=rizoxénia
rizômana=rizómana
rizômero=rizómero
rizômio=rizómio
robsônia=robsónia
rocurônio=rocurónio
rodanogênio=rodanogénio
rodimênia=rodiménia
rodizônico=rodizónico
rodocrômio=rodocrómio
rodogênese=rodogénese
rodômela=rodómela
rodômetra=rodómetra
rombômero=rombómero
rombômis=rombómis
ropalômelo=ropalómelo
ropalômera=ropalómera
ropalômero=ropalómero
rosênia=rosénia
rotenônico=rotenónico
roxolônio=roxolónio
rubrênico=rubrénico
rugosômetro=rugosómetro
rumbatrônio=rumbatrónio
russofônico=russofónico
rutenamônio=rutenamónio
rutenodiamônio=rutenodiamónio
rutênico=ruténico
rutênio=ruténio
rêmige=rémige
rêmora=rémora
rênico=rénico
rênio=rénio
sacarômetro=sacarómetro
sacarômice=sacarómice
sacarônico=sacarónico
sacrotômico=sacrotómico
safenectômico=safenectómico
salicilsulfônico=salicilsulfónico
salinômetro=salinómetro
salmônida=salmónida
salofênio=salofénio
salomônia=salomónia
salomônico=salomónico
salpingectômico=salpingectómico
salpingoforectômico=salpingoforectómico
salpingossalpingostômico=salpingossalpingostómico
salpingostômico=salpingostómico
salpingotecectômico=salpingotecectómico
salpingotômico=salpingotómico
salpingovariectômico=salpingovariectómico
salpingêmico=salpingémico
salênia=salénia
sanatogênio=sanatogénio
sandersônia=sandersónia
sanfônica=sanfónica
santantônio=santantónio
santimônia=santimónia
santo-antônio=santo-antónio
santênio=santénio
saprogênese=saprogénese
saprogênico=saprogénico
saprêmico=saprémico
sapônase=sapónase
sapônico=sapónico
sarcinômice=sarcinómice
sarcolêmico=sarcolémico
sarcômero=sarcómero
sardônia=sardónia
sardônica=sardónica
sardônico=sardónico
sardônio=sardónio
sardônique=sardónique
sarracênia=sarracénia
sarracênico=sarracénico
sarrufônio=sarrufónio
sarônide=sarónide
saurômalo=saurómalo
saurômata=saurómata
saurômato=saurómato
savônulo=savónulo
saxofônio=saxofónio
saxônico=saxónico
saxônio=saxónio
secalônico=secalónico
secundigênito=secundigénito
secundogênito=secundogénito
sedimentômetro=sedimentómetro
seetzênia=seetzénia
segmentectômico=segmentectómico
segundogênito=segundogénito
selenônico=selenónico
selênia=selénia
selênico=selénico
selênido=selénido
selênio=selénio
selênis=selénis
sem-cerimônia=sem-cerimónia
semancômetro=semancómetro
semantêmico=semantémico
semeostômico=semeostómico
semiautônomo=semiautónomo
semicômico=semicómico
semostômida=semostómida
semprônia=semprónia
semprônio=semprónio
semêmico=semémico
seneciônea=seneciónea
seneciônico=seneciónico
senedônia=senedónia
senodônia=senodónia
sensitômetro=sensitómetro
sensofônio=sensofónio
senônico=senónico
senônio=senónio
sepazônio=sepazónio
sepedogênese=sepedogénese
sepedonogênese=sepedonogénese
sepedônio=sepedónio
septectômico=septectómico
septicopiêmico=septicopiémico
septicêmico=septicémico
septizônio=septizónio
septotômico=septotómico
septênio=septénio
septômetro=septómetro
sequestrectômico=sequestrectómico
sequestretômico=sequestretómico
sericostômida=sericostómida
sericômetro=sericómetro
servossistêmico=servossistémico
setetômico=setetómico
seticopiêmico=seticopiémico
seticêmia=seticémia
seticêmico=seticémico
setizônio=setizónio
setotômico=setotómico
setênio=seténio
sextogênito=sextogénito
sexênio=sexénio
sezônico=sezónico
siagônia=siagónia
sialogênico=sialogénico
sialolitectômico=sialolitectómico
sialolitotômico=sialolitotómico
sialêmese=sialémese
siciônico=siciónico
siciônide=siciónide
siciônio=siciónio
siciônis=siciónis
siclanêmico=siclanémico
sicômoro=sicómoro
sicônida=sicónida
sicônio=sicónio
siderocrômio=siderocrómio
sideroxênio=sideroxénio
sidêmia=sidémia
sidônio=sidónio
sifilicômio=sifilicómio
sifilidômano=sifilidómano
sifiliocômio=sifiliocómio
sifilocômio=sifilocómio
sifilômano=sifilómano
sifilômico=sifilómico
sifônia=sifónia
sifônulo=sifónulo
siglômano=siglómano
siglônimo=siglónimo
sigmodontômio=sigmodontómio
sigmoidectômico=sigmoidectómico
sigmoidoproctostômico=sigmoidoproctostómico
sigmoidostômico=sigmoidostómico
silicopropiônico=silicopropiónico
silicônico=silicónico
silicônio=silicónio
silênia=silénia
silênico=silénico
simbolêmico=simbolémico
simpatectômico=simpatectómico
simpaticectômico=simpaticectómico
simpaticostênico=simpaticosténico
simpaticotônico=simpaticotónico
simpatostênico=simpatosténico
simpatotônico=simpatotónico
simpiezômetro=simpiezómetro
simptômio=simptómio
sinadênio=sinadénio
sinanteronômico=sinanteronómico
sinarmônico=sinarmónico
sincolostêmone=sincolostémone
sincondrotômico=sincondrotómico
sincotiledôneo=sincotiledóneo
sincrômico=sincrómico
sincrônico=sincrónico
sindectômico=sindectómico
sindesmectômico=sindesmectómico
sindesmotômico=sindesmotómico
sindrômico=sindrómico
sinecotômico=sinecotómico
sinectenterotômico=sinectenterotómico
sinequiotômico=sinequiotómico
sinfiostêmone=sinfiostémone
sinfisectômico=sinfisectómico
sinfisiotômico=sinfisiotómico
sinfisotômico=sinfisotómico
sinfêmia=sinfémia
sinfônico=sinfónico
singênese=singénese
singônico=singónico
singônio=singónio
sinistrômano=sinistrómano
sinorogênese=sinorogénese
sinorogênico=sinorogénico
sinosteotômico=sinosteotómico
sinovectômico=sinovectómico
sintactêmico=sintactémico
sintatêmico=sintatémico
sintaxêmico=sintaxémico
sintonêmico=sintonémico
sintêmico=sintémico
sintômia=sintómia
sintômico=sintómico
sintônico=sintónico
sinêmio=sinémio
sinônimo=sinónimo
sirenômelo=sirenómelo
siringotômico=siringotómico
siringotômio=siringotómio
siriômetro=siriómetro
sirênico=sirénico
sirênida=sirénida
sirênio=sirénio
sismigênese=sismigénese
sismigênico=sismigénico
sismogênese=sismogénese
sismogênico=sismogénico
sismotectônico=sismotectónico
sismômetro=sismómetro
sissômico=sissómico
sistêmata=sistémata
sistêmico=sistémico
sitiômano=sitiómano
sitogoniômetro=sitogoniómetro
sitômano=sitómano
sitômetro=sitómetro
sitônio=sitónio
sobretônica=sobretónica
socieconômico=socieconómico
socioeconômico=socioeconómico
sociogênico=sociogénico
sociopsicogênico=sociopsicogénico
sodômico=sodómico
sofrônia=sofrónia
sofrônica=sofrónica
sofômano=sofómano
solanômetro=solanómetro
solarômetro=solarómetro
solenostêmone=solenostémone
solenômia=solenómia
solidônia=solidónia
solêmia=solémia
solênida=solénida
solênio=solénio
sonômetro=sonómetro
sorbônico=sorbónico
sorônia=sorónia
spintrônica=spintrónica
spintrônico=spintrónico
stevênia=stevénia
stimpsônia=stimpsónia
subarmômico=subarmómico
subarmônico=subarmónico
subatômico=subatómico
suberigênico=suberigénico
suberogênese=suberogénese
suberogênico=suberogénico
subgênero=subgénero
submicrônico=submicrónico
subsônico=subsónico
subtônica=subtónica
suessiônico=suessiónico
suessônico=suessónico
suicidômano=suicidómano
suiônio=suiónio
sulfacetilênico=sulfacetilénico
sulfamônio=sulfamónio
sulfantimônico=sulfantimónico
sulfantimônio=sulfantimónio
sulfarsênico=sulfarsénico
sulfidrômetro=sulfidrómetro
sulfitômetro=sulfitómetro
sulfocarbônico=sulfocarbónico
sulfocianogênio=sulfocianogénio
sulfocrômico=sulfocrómico
sulfoemoglobinêmico=sulfoemoglobinémico
sulfônico=sulfónico
sulfônio=sulfónio
sultropônio=sultropónio
supersônico=supersónico
supertônica=supertónica
suxametônio=suxametónio
suxetônio=suxetónio
suômi=suómi
sêmen=sémen
sêmen-contra=sémen-contra
sêmene=sémene
sêmica=sémica
sêmico=sémico
sêmis=sémis
sêmita=sémita
sêmnio=sémnio
sêmnone=sémnone
sêmola=sémola
sêneca=séneca
sênega=sénega
sênica=sénica
sênio=sénio
sênior=sénior
sênone=sénone
sêrio-cômico=sério-cómico
sírio-macedônico=sírio-macedónico
sônica=sónica
sônico=sónico
tabacômano=tabacómano
tabeliônico=tabeliónico
tacsônia=tacsónia
tactêmico=tactémico
tactômetro=tactómetro
tacômetro=tacómetro
tacônico=tacónico
tagmêmico=tagmémico
tagênia=tagénia
talamotômico=talamotómico
talassogênese=talassogénese
talassogênico=talassogénico
talassoplanctônico=talassoplanctónico
talassêmico=talassémico
talassômetro=talassómetro
talassônimo=talassónimo
talentômetro=talentómetro
talipômano=talipómano
talurônico=talurónico
tanatermômetro=tanatermómetro
tanatognomônico=tanatognomónico
tanatogênese=tanatogénese
tanatômano=tanatómano
tanatômetro=tanatómetro
tanigênio=tanigénio
tanômetro=tanómetro
tapajônia=tapajónia
tapajônico=tapajónico
taqueômetro=taqueómetro
taquidrômia=taquidrómia
taquidrômico=taquidrómico
taquifrênico=taquifrénico
taquifêmico=taquifémico
taquigênese=taquigénese
taquimênis=taquiménis
taquitômico=taquitómico
targiônia=targiónia
tarsectômico=tarsectómico
tarseotômico=tarseotómico
tarsetômico=tarsetómico
tarsotômico=tarsotómico
tartarômetro=tartarómetro
tartarônico=tartarónico
tasiômetro=tasiómetro
tatêmico=tatémico
taurigênico=taurigénico
tautocrônico=tautocrónico
tautofônico=tautofónico
tautômero=tautómero
tautônimo=tautónimo
taxinômico=taxinómico
taxionômico=taxionómico
taxiônomo=taxiónomo
taxonômico=taxonómico
taxônomo=taxónomo
teatrofônico=teatrofónico
tecnetrônio=tecnetrónio
tecnotrônico=tecnotrónico
tecnônimo=tecnónimo
tectogênese=tectogénese
tectogênico=tectogénico
tectônico=tectónico
tectônio=tectónio
teflônico=teflónico
tefrilômetro=tefrilómetro
tefrônia=tefrónia
telamônio=telamónio
telecardiofônico=telecardiofónico
telefonômetro=telefonómetro
telefônico=telefónico
telegênico=telegénico
telegônico=telegónico
teleneurônio=teleneurónio
telerradiofônico=telerradiofónico
teletermômetro=teletermómetro
teletrônio=teletrónio
telifônida=telifónida
telotrêmato=telotrémato
telurômetro=telurómetro
telêmaco=telémaco
telêmetro=telémetro
telênomo=telénomo
telômero=telómero
telônio=telónio
templetônia=templetónia
tenebriônida=tenebriónida
tenectômico=tenectómico
tenofônico=tenofónico
tenomiotômico=tenomiotómico
tenontectômico=tenontectómico
tenontotômico=tenontotómico
tenossinovectômico=tenossinovectómico
tenotômico=tenotómico
tensiômetro=tensiómetro
teocosmogônico=teocosmogónico
teofêmico=teofémico
teogônico=teogónico
teorêmico=teorémico
teoxênio=teoxénio
teracônico=teracónico
terapônida=terapónida
teratogênese=teratogénese
teratogênico=teratogénico
terceirogênito=terceirogénito
terebintênio=terebinténio
terebênico=terebénico
terebênio=terebénio
teredônio=teredónio
tergêmino=tergémino
teriotômico=teriotómico
termatômico=termatómico
termeletrômetro=termeletrómetro
termeletrônico=termeletrónico
termestesiômetro=termestesiómetro
termiônica=termiónica
termiônico=termiónico
termoatômico=termoatómico
termobarômetro=termobarómetro
termoeletrômetro=termoeletrómetro
termoeletrônico=termoeletrónico
termoestesiômetro=termoestesiómetro
termofônico=termofónico
termogalvanômetro=termogalvanómetro
termogêneo=termogéneo
termogênese=termogénese
termogênico=termogénico
termoiônico=termoiónico
termomanômetro=termomanómetro
termomicrofônio=termomicrofónio
termotelefônico=termotelefónico
termotonômetro=termotonómetro
termotônus=termotónus
termômetro=termómetro
ternstrêmia=ternstrémia
terpilênio=terpilénio
terpênico=terpénico
terpênio=terpénio
terra-japônica=terra-japónica
tessalônio=tessalónio
testectômico=testectómico
testosterônico=testosterónico
tetanômetro=tetanómetro
tetigônia=tetigónia
tetogênese=tetogénese
tetraclorobenzênico=tetraclorobenzénico
tetracrômico=tetracrómico
tetradônio=tetradónio
tetraetilamônio=tetraetilamónio
tetrafluoretilênico=tetrafluoretilénico
tetrafônico=tetrafónico
tetragônia=tetragónia
tetragônico=tetragónico
tetragônio=tetragónio
tetrametilamônio=tetrametilamónio
tetrametilênico=tetrametilénico
tetramilamônio=tetramilamónio
tetraneftalenossulfônico=tetraneftalenossulfónico
tetraplostêmone=tetraplostémone
tetrapnêumone=tetrapnéumone
tetraquênio=tetraquénio
tetrarsênico=tetrarsénico
tetrarsênio=tetrarsénio
tetrassômico=tetrassómico
tetrastêmone=tetrastémone
tetratiônico=tetratiónico
tetratômico=tetratómico
tetratônico=tetratónico
tetraxônico=tetraxónico
tetraxônio=tetraxónio
tetraônida=tetraónida
tetraônique=tetraónique
tetrilamônio=tetrilamónio
tetônico=tetónico
teutômano=teutómano
teutônia=teutónia
teutônico=teutónico
teômano=teómano
teônimo=teónimo
tiametônio=tiametónio
tiaprofênico=tiaprofénico
tibezônio=tibezónio
tibioperônio=tibioperónio
ticopartenogênese=ticopartenogénese
tiemônio=tiemónio
tiflatônico=tiflatónico
tiflectômico=tiflectómico
tiflostômico=tiflostómico
tiflotômico=tiflotómico
tiflômio=tiflómio
tifogênico=tifogénico
tifoêmico=tifoémico
tifêmico=tifémico
tifônico=tifónico
tiludrônico=tiludrónico
tilômio=tilómio
timectômico=timectómico
timênio=timénio
tioantimônico=tioantimónico
tioarsênico=tioarsénico
tiocarbônico=tiocarbónico
tiocianogênio=tiocianogénio
tiodônio=tiodónio
tiofosgênico=tiofosgénico
tiofosgênio=tiofosgénio
tiofênico=tiofénico
tiogênico=tiogénico
tiolcarbônico=tiolcarbónico
tioltionacarbônico=tioltionacarbónico
tionacarbônico=tionacarbónico
tipocrômico=tipocrómico
tipofônico=tipofónico
tipofônio=tipofónio
tipômano=tipómano
tipômetro=tipómetro
tiranômano=tiranómano
tiratrônico=tiratrónico
tiratrônio=tiratrónio
tireocondrotômico=tireocondrotómico
tireocricotômico=tireocricotómico
tireogênico=tireogénico
tireoidectômico=tireoidectómico
tireoidotômico=tireoidotómico
tireotômico=tireotómico
tirocondrotômico=tirocondrotómico
tirocricotômico=tirocricotómico
tirogênico=tirogénico
tiroidectômico=tiroidectómico
tiroidotômico=tiroidotómico
tirotômico=tirotómico
tirrênico=tirrénico
tirrênio=tirrénio
tirêmese=tirémese
tisiogênese=tisiogénese
titilômano=titilómano
titlônimo=titlónimo
titômico=titómico
titônia=titónia
titônico=titónico
titônio=titónio
tiêmico=tiémico
tiônico=tiónico
tiônido=tiónido
tocodinamômetro=tocodinamómetro
tocogônico=tocogónico
toconômico=toconómico
tocômetro=tocómetro
tolerogênio=tolerogénio
tolilênico=tolilénico
tolocônio=tolocónio
toluenossulfônico=toluenossulfónico
toluênico=toluénico
toluênio=toluénio
tolônio=tolónio
tomômano=tomómano
tomômio=tomómio
tonoclônico=tonoclónico
tonsilectômico=tonsilectómico
tonsilotômico=tonsilotómico
tonzônio=tonzónio
tonêmico=tonémico
tonômetro=tonómetro
topectômico=topectómico
topogênese=topogénese
topotermestesiômetro=topotermestesiómetro
topômetro=topómetro
topônimo=topónimo
toracectômico=toracectómico
toracidropnêumico=toracidropnéumico
toracofrenolaparotômico=toracofrenolaparotómico
toracolaparotômico=toracolaparotómico
toracostômico=toracostómico
toracotômico=toracotómico
toracêmico=toracémico
toracômelo=toracómelo
toracômetro=toracómetro
torsiômetro=torsiómetro
tortônico=tortónico
torênia=torénia
torônio=torónio
totêmico=totémico
toxanêmico=toxanémico
toxicodendrômico=toxicodendrómico
toxicoêmico=toxicoémico
toxicêmico=toxicémico
toxicômano=toxicómano
toxicômetro=toxicómetro
toxinêmico=toxinémico
toxiquêmico=toxiquémico
toxêmico=toxémico
tractotômico=tractotómico
tracônico=tracónico
tracônio=tracónio
traduciônimo=traduciónimo
tragicômico=tragicómico
tragofônico=tragofónico
transaminasêmico=transaminasémico
transarmônico=transarmónico
transgênero=transgénero
transgênico=transgénico
transistrônio=transistrónio
transitrônio=transitrónio
transversectômico=transversectómico
transversostômico=transversostómico
transônico=transónico
traquelectômico=traquelectómico
traquelômona=traquelómona
traqueofônico=traqueofónico
traqueolaringotômico=traqueolaringotómico
traqueostômico=traqueostómico
traqueotômico=traqueotómico
traquifônico=traquifónico
traquinêmida=traquinémida
traquistêmone=traquistémone
tratotômico=tratotómico
traumatogênico=traumatogénico
tredecênio=tredecénio
trepidômetro=trepidómetro
treponêmico=treponémico
trepostômico=trepostómico
trestônia=trestónia
trezênico=trezénico
trezênio=trezénio
triamilênio=triamilénio
triamônico=triamónico
triaquênio=triaquénio
triatômico=triatómico
triaxônio=triaxónio
triazoldissulfônico=triazoldissulfónico
tribosfênico=tribosfénico
tribômetro=tribómetro
tribômia=tribómia
tribônique=tribónique
tricetoidrindênico=tricetoidrindénico
triclobisônio=triclobisónio
triclorobenzênico=triclorobenzénico
triclorobutilmalônico=triclorobutilmalónico
triclênio=triclénio
tricocercômona=tricocercómona
tricoclaênio=tricoclaénio
tricoclêmio=tricoclémio
tricoestesiômetro=tricoestesiómetro
tricogônia=tricogónia
tricolômona=tricolómona
tricomônade=tricomónade
tricostêmone=tricostémone
tricotiledôneo=tricotiledóneo
tricotômico=tricotómico
tricrômico=tricrómico
tricênio=tricénio
tricômalo=tricómalo
tricômane=tricómane
tricômano=tricómano
tricômio=tricómio
tricômona=tricómona
trietilênico=trietilénico
trifônico=trifónico
trigatrônio=trigatrónio
trigonostêmone=trigonostémone
trigonostêmono=trigonostémono
trigonostômico=trigonostómico
trigonômetra=trigonómetra
trigêmeo=trigémeo
trigêmino=trigémino
trigênea=trigénea
trigênico=trigénico
trigônia=trigónia
trigônido=trigónido
trimetilbenzênico=trimetilbenzénico
trimetilenomalônico=trimetilenomalónico
trimetilênico=trimetilénico
trimilênio=trimilénio
trimênia=triménia
trimênopon=triménopon
trinaftalenossulfônico=trinaftalenossulfónico
trinitrofênico=trinitrofénico
trinitrofônico=trinitrofónico
trinitrolvênico=trinitrolvénico
trinômico=trinómico
trinômine=trinómine
trinômino=trinómino
trinômio=trinómio
trionômio=trionómio
trioxibenzênico=trioxibenzénico
tripanossômida=tripanossómida
tripilônico=tripilónico
triplostêmone=triplostémone
triplostêmono=triplostémono
triprotômico=triprotómico
tripsinogênese=tripsinogénese
tripsinogênico=tripsinogénico
tripsinogênio=tripsinogénio
triptolêmico=triptolémico
triptonêmico=triptonémico
tripônace=tripónace
trisisogônico=trisisogónico
trissômico=trissómico
tritiocarbônico=tritiocarbónico
tritolêmico=tritolémico
tritonêmico=tritonémico
tritotônico=tritotónico
tritêmide=tritémide
tritônia=tritónia
tritônico=tritónico
tritônida=tritónida
trixênia=trixénia
trizircônico=trizircónico
triênio=triénio
triônimo=triónimo
triônique=triónique
trofônia=trofónia
trogônida=trogónida
trombastênico=trombasténico
trombectômico=trombectómico
trombinogênico=trombinogénico
trombinogênio=trombinogénio
trombocitogênico=trombocitogénico
trombocitopênico=trombocitopénico
trombocitêmico=trombocitémico
trombogênese=trombogénese
trombogênico=trombogénico
trombogênio=trombogénio
tromboplastinopênico=tromboplastinopénico
trombopênico=trombopénico
trombômetro=trombómetro
trombônio=trombónio
tromômano=tromómano
tromômetro=tromómetro
troncocônico=troncocónico
troncônico=troncónico
tropogênese=tropogénese
troponômico=troponómico
tropossismômetro=tropossismómetro
tropômetro=tropómetro
troxônio=troxónio
trêmito=trémito
trêmulo=trémulo
trênico=trénico
trônio=trónio
tuberculêmico=tuberculémico
tubocônico=tubocónico
tubovariectômico=tubovariectómico
tugônia=tugónia
tularêmico=tularémico
tulipômano=tulipómano
tumenolamônio=tumenolamónio
tumenolsulfônico=tumenolsulfónico
tumorigênese=tumorigénese
tungstênico=tungsténico
tungstênio=tungsténio
tupônia=tupónia
turbidômetro=turbidómetro
turbinectômico=turbinectómico
turbinotômico=turbinotómico
turbinômetro=turbinómetro
turcofônico=turcofónico
turgênia=turgénia
turgômetro=turgómetro
turtônia=turtónia
turônico=turónico
turônio=turónio
tussigênico=tussigénico
têmenis=témenis
têmeno=témeno
têmia=témia
têmio=témio
têmnio=témnio
tênebra=ténebra
tênia=ténia
tênio=ténio
tênis=ténis
tênis de mesa=ténis de mesa
tênue=ténue
tômico=tómico
tômio=tómio
tômomis=tómomis
tômoro=tómoro
tôni=tóni
tônica=tónica
tônico=tónico
tônus=tónus
ubiquinônico=ubiquinónico
ucrônico=ucrónico
udômetro=udómetro
ufômano=ufómano
ulcerogênico=ulcerogénico
ulmarênio=ulmarénio
ulosônia=ulosónia
ulotômico=ulotómico
ultimogênito=ultimogénito
ultrassônico=ultrassónico
ultrôneo=ultróneo
umbigo-de-vênus=umbigo-de-vénus
umbrômano=umbrómano
umbônio=umbónio
undecilênico=undecilénico
unicotiledôneo=unicotiledóneo
unigênito=unigénito
unilênio=unilénio
unipômulo=unipómulo
uniônida=uniónida
uranotênia=uranoténia
uranômetro=uranómetro
uratêmico=uratémico
ureterectômico=ureterectómico
ureterotômico=ureterotómico
uretrectômico=uretrectómico
uretrocistotômico=uretrocistotómico
uretrostênico=uretrosténico
uretrotômico=uretrotómico
ureômetro=ureómetro
uricêmico=uricémico
urobilogênio=urobilogénio
urêmico=urémico
urômelo=urómelo
urômetro=urómetro
usnônico=usnónico
uterectômico=uterectómico
uterocistotômico=uterocistotómico
uterostênico=uterosténico
uterotômico=uterotómico
uterotônico=uterotónico
uterêmico=uterémico
uterômano=uterómano
uterômetro=uterómetro
uvitônico=uvitónico
uvulectômico=uvulectómico
uvulotômico=uvulotómico
vacinogênico=vacinogénico
vacuômetro=vacuómetro
vacênico=vacénico
vaginalectômico=vaginalectómico
vaginectômico=vaginectómico
vaginoperineotômico=vaginoperineotómico
vaginotômico=vaginotómico
vagotômico=vagotómico
vagotônico=vagotónico
valerênio=valerénio
valvotômico=valvotómico
valvulotômico=valvulotómico
valônia=valónia
valônico=valónico
valônio=valónio
vambenedênia=vambenedénia
varicectômico=varicectómico
varicocelectômico=varicocelectómico
varicotômico=varicotómico
variômetro=variómetro
vasculogênese=vasculogénese
vascônio=vascónio
vasectômico=vasectómico
vasipertônico=vasipertónico
vasogênio=vasogénio
vasoipertônico=vasoipertónico
vasoipotônico=vasoipotónico
vasotômico=vasotómico
vasovasostômico=vasovasostómico
vasovesiculectômico=vasovesiculectómico
vatiômetro=vatiómetro
vautompsônia=vautompsónia
vecurônio=vecurónio
velodrômico=velodrómico
venômero=venómero
verbômano=verbómano
verdeceledônio=verdeceledónio
vernônia=vernónia
vertebrectômico=vertebrectómico
vertômetro=vertómetro
verônica=verónica
verônica-das-botica=verónica-das-botica
vesiculectômico=vesiculectómico
vesiculotômico=vesiculotómico
vestibulotômico=vestibulotómico
vetulônio=vetulónio
veêmico=veémico
vibriônido=vibriónido
vibriônio=vibriónio
vibrômetro=vibrómetro
vicedômino=vicedómino
vicênio=vicénio
vilotoxêmico=vilotoxémico
vinhômetro=vinhómetro
vinilacetilênico=vinilacetilénico
vinilidênico=vinilidénico
vintênio=vinténio
virêmico=virémico
viscerotômico=viscerotómico
viscerotônico=viscerotónico
visiômetro=visiómetro
vitaminômano=vitaminómano
vitelogênese=vitelogénese
vitrênico=vitrénico
vitrênio=vitrénio
volapucômano=volapucómano
voltamperômetro=voltamperómetro
voltiômetro=voltiómetro
voltômetro=voltómetro
volumenômetro=volumenómetro
voluminômetro=voluminómetro
volêmico=volémico
votômetro=votómetro
vuerômetro=vuerómetro
vulcanogênico=vulcanogénico
vulvectômico=vulvectómico
vênedo=vénedo
vênero=vénero
vêneto=véneto
vênia=vénia
vênula=vénula
vôlei=vólei
vômer=vómer
vômica=vómica
vômico=vómico
vômito=vómito
vômito-negro=vómito-negro
washingtônia=washingtónia
watsônia=watsónia
wattômetro=wattómetro
wellingtônia=wellingtónia
widdringtônia=widdringtónia
wilkinsônia=wilkinsónia
wilsônia=wilsónia
wulfênia=wulfénia
xantocrômico=xantocrómico
xantogênico=xantogénico
xantogênio=xantogénio
xantêmico=xantémico
xeniexênico=xeniexénico
xenofônico=xenofónico
xenogênese=xenogénese
xenômano=xenómano
xenônio=xenónio
xerostômico=xerostómico
xilarmônico=xilarmónico
xilogênio=xilogénio
xilênico=xilénico
xilênio=xilénio
xilômetro=xilómetro
ximênia=ximénia
xênia=xénia
xênio=xénio
xênon=xénon
zacônico=zacónico
zacônio=zacónio
zarcônio=zarcónio
zenônico=zenónico
zignêmea=zignémea
zigotômero=zigotómero
zimogênico=zimogénico
zimogênio=zimogénio
zimosiômetro=zimosiómetro
zircônico=zircónico
zircônio=zircónio
zoledrônico=zoledrónico
zoogênico=zoogénico
zoogênio=zoogénio
zoonômico=zoonómico
zoopônica=zoopónica
zoômano=zoómano
zoônico=zoónico
zoônimo=zoónimo
zoônomo=zoónomo
zênite=zénite
zônula=zónula
êmero=émero
êmese=émese
êmico=émico
êmide=émide
êmis=émis
êmitron=émitron
êmulo=émulo
êneo=éneo
ênico=énico
ênidro=énidro
ênio=énio
ênula=énula
ênula-campana=énula-campana
ênuplo=énuplo
êumene=éumene
êumeno=éumeno
êumida=éumida
ôhmico=óhmico
ômega=ómega
ômicron=ómicron
ônagra=ónagra
ônagro=ónagro
ônibus=ónibus
ônix=ónix
ônus=ónus
aspectual=aspetual
aspecto=aspeto
autoinfecção=autoinfeção
convector=convetor
correspectivo=correspetivo
desinfeccionar=desinfecionar
desinfecção=desinfeção
detectabilidade=detetabilidade
detectar=detetar
detector=detetor
detectável=detetável
detecção=deteção
eletródio=electródio
eletrófilo=electrófilo
eletróforo=electróforo
eletrógeno=electrógeno
eletrógrafo=electrógrafo
eletrólise=electrólise
eletrólito=electrólito
elétrodo=eléctrodo
elétron=eléctron
excepcional=excecional
excepcionalidade=excecionalidade
excepcionalmente=excecionalmente
excepcionar=excecionar
expectorante=expetorante
expectoração=expetoração
extrospectivo=extrospetivo
extrospecção=extrospeção
heteroinfecção=heteroinfeção
infecciologia=infeciologia
infecciologista=infeciologista
infeccionado=infecionado
infeccionar=infecionar
infeccioso=infecioso
infectada=infetada
infectado=infetado
infectante=infetante
infectar=infetar
infectologia=infetologia
infectológico=infetológico
infectuosidade=infetuosidade
infectável=infetável
infecção=infeção
introspectivo=introspetivo
introspecção=introspeção
invectiva=invetiva
liquefato=liquefacto
onidirecional=omnidirecional
onilingue=omnilingue
perspectiva=perspetiva
perspectival=perspetival
perspectivar=perspetivar
perspectivação=perspetivação
perspectividade=perspetividade
perspectivismo=perspetivismo
perspectivista=perspetivista
perspectivo=perspetivo
perspectivístico=perspetivístico
prospectar=prospetar
prospectiva=prospetiva
prospectivo=prospetivo
prospecto=prospeto
prospector=prospetor
prospectora=prospetora
puntiforme=punctiforme
reinfeccionar=reinfecionar
reinfecção=reinfeção
respectivamente=respetivamente
respectivo=respetivo
retrospectiva=retrospetiva
retrospectivamente=retrospetivamente
retrospectividade=retrospetividade
retrospectivo=retrospetivo
retrospecto=retrospeto
retrospecção=retrospeção
superinfecção=superinfeção
balancê=balancé
bangalô=bangaló
bebê=bebé
bidê=bidé
cachê=caché
caratê=caraté
cocô=cocó
comitê=comité
crochê=croché
degradê=degradé
evasê=evasé
godê=godé
guichê=guiché
karatê=karaté
lamê=lamé
matinê=matiné
negligê=negligé
nenê=nené
parquê=parqué
pralinê=praliné
purê=puré
rosê=rosé
turnê=turné
dezesseis=dezasseis
dezessete=dezassete
dezenove=dezanove
