# Portuguese multiwords file used for chunking
#

América do Sul	NPFSG00
América Central	NPFSG00
América do Norte	NPFSG00
Augusto Guerra	NPMSO00
Braga Parque	NPMSG00
Braga Park	NPMSG00
Braga Jazz	NPMSO00
Frei Montalva	NPMSO00
Francisco Moita	NPMSO00
Luís Santos	NPMSO00
Matos Bravo	NPMSO00
Pólo Norte	NPMSO00
Pólo Sul	NPMSO00
Porto Rico	NPMSG00
Praceta Teixeira	NPFSO00
Rio de Janeiro	NPMSG00
Rio Grande do Sul	NPMSG00
Santos Romão	NPMSO00
União de Nações Sul-Americanas	NPMSO00
Vilas Leitão	NPMSO00

# Locuções                          #
#####################################

de modo algum	L_NEG
de jeito nenhum	L_NEG
de forma nenhuma	L_NEG

# Latim expressions                 #
#####################################
# From Catalan multiword.txt files - 08-11-2016
ad hoc	L_RG
ab initio	L_RG
ab intestato	L_RG
ab ovo	L_RG
ad hoc	LOC_ADJ
ad hominem	LOC_ADJ
ad interim	L_RG
ad lib	L_RG
ad libitum	L_RG
ad litem	L_RG
ad litteram	L_RG
ad nauseam	L_RG
ad quadrantum	L_RG
ad triangulum	L_RG
ad valorem	L_RG
cum laude	L_AQ0CN0
et al.	L_RG
in aeternum	L_RG
in albis	L_RG
in anima vili	L_RG
in articulo mortis	L_RG
in crescendo	L_RG
in extenso	L_RG
in extremis	L_RG
in fieri	L_RG
in fraganti	L_RG
in illo tempore	L_RG
in memoriam	L_RG
in partibus	L_AQ0CN0
in partibus infidelium	L_RG
in pectore	L_RG
in perpetuum	L_RG
in promptu	L_RG
in puribus	L_RG
in situ	L_RG
in solidum	L_RG
in vitro	L_AQ0CN0
in vitro	L_RG
in vivo	L_AQ0CN0
in vivo	L_RG
ipsis verbis	L_RG
ipso facto	L_RG
ipso jure	L_RG
mutatis mutandis	L_RG
tutti quanti	L_RG

#         Foreign expression        #
#####################################

# From Catalan multiword.txt
# Date 14-11-2016

ma non troppo	L_RG
sex symbol	NCCS000
drag queens	NCFP000
crème de la crème	NCFS000
dolce vita	NCFS000
drag queen	NCFS000
fumata blanca	NCFS000
fumata negra	NCFS000
nouvelle cuisine	NCFS000
pax romana	NCFS000
persona non grata	NCFS000
rara avis	NCFS000
tabula rasa	NCFS000
vox populi	NCFS000
coitus interruptus	NCMN000
delirium tremens	NCMN000
deus ex machina	NCMN000
mass media	NCMN000
mea culpa	NCMN000
modus operandi	NCMN000
modus vivendi	NCMN000
top manta	NCMN000
spaghetti westerns	NCMP000
think tanks	NCMP000
alter ego	NCMS000
annus horribilis	NCMS000
art déco	NCMS000
baby boom	NCMS000
big bang	NCMS000
carpe diem	NCMS000
coup de force	NCMS000
curriculum vitae	NCMS000
déjà vu	NCMS000
foc amic	NCMS000
foie gras	NCMS000
habeas corpus	NCMS000
heavy metal	NCMS000
Internet Archive	NPMS000
Internet Explorer	NPMS000
jet lag	NCMS000
laissez faire	NCMS000
making of	NCMS000
melting pot	NCMS000
prime time	NCMS000
rigor mortis	NCMS000
rock 'n' roll	NCMS000
sancta sanctorum	NCMS000
sex appeal	NCMS000
spaghetti western	NCMS000
status quo	NCMS000
think tank	NCMS000
totum revolutum	NCMS000
trompe-l'oeil	NCMS000
trompe-l'œil	NCMS000
veni, vidi, vici	NCMS000
via crucis	NCMS000
casus belli	NCMS000

#            Proper names           #
#####################################

Bartolomeu Dias	NPMS000

# From Catalan and Spanish multiword.txt
# Date 14-11-2016

All Blacks	NPMPG00
Arizona Cardinals	NPMPG00
Atlanta Falcons	NPMPG00
Atlanta Hawks	NPMPG00
Baltimore Ravens	NPMPG00
Boston Celtics	NPMPG00
Buffalo Bills	NPMPG00
Carolina Panthers	NPMPG00
Charlotte Bobcats	NPMPG00
Chicago Bears	NPMPG00
Chicago Bulls	NPMPG00
Cincinnati Bengals	NPMPG00
Cleveland Browns	NPMPG00
Cleveland Cavaliers	NPMPG00
Dallas Cowboys	NPMPG00
Dallas Mavericks	NPMPG00
Denver Broncos	NPMPG00
Denver Nuggets	NPMPG00
Detroit Lions	NPMPG00
Detroit Pistons	NPMPG00
Golden State Warriors	NPMPG00
Green Bay Packers	NPMPG00
Houston Rockets	NPMPG00
Houston Texans	NPMPG00
Indiana Pacers	NPMPG00
Indianapolis Colts	NPMPG00
Jacksonville Jaguars	NPMPG00
Kansas City Chiefs	NPMPG00
Los Angeles Clippers	NPMPG00
Los Angeles Lakers	NPMPG00
Memphis Grizzlies	NPMPG00
Miami Dolphins	NPMPG00
Miami Heat	NPMPG00
Microsoft Windows	NPMS000
Microsoft Office	NPMS000
Microsoft Excel	NPMS000
Microsoft PowerPoint	NPMS000
Microsoft Word	NPMS000
Microsoft Access	NPMS000
Milwaukee Bucks	NPMPG00
Minnesota Timberwolves	NPMPG00
Minnesota Vikings	NPMPG00
New England Patriots	NPMPG00
New Jersey Nets	NPMPG00
New Orleans Hornets	NPMPG00
New Orleans Saints	NPMPG00
New York Giants	NPMPG00
New York Jets	NPMPG00
New York Knicks	NPMPG00
Oakland Raiders	NPMPG00
Oklahoma City Thunder	NPMPG00
Orlando Magic	NPMPG00
Philadelphia 76ers	NPMPG00
Philadelphia Eagles	NPMPG00
Phoenix Suns	NPMPG00
Pittsburgh Steelers	NPMPG00
Portland Trail Blazers	NPMPG00
Sacramento Kings	NPMPG00
Saint Louis Rams	NPMPG00
San Antonio Spurs	NPMPG00
San Diego Chargers	NPMPG00
San Francisco 49ers	NPMPG00
Seattle Seahawks	NPMPG00
Tampa Bay Buccaneers	NPMPG00
Tennessee Titans	NPMPG00
Toronto Raptors	NPMPG00
Utah Jazz	NPMPG00
Washington Redskins	NPMPG00
Washington Wizards	NPMPG00
Aberri Eguna	NPMSO00
Abu Dhabi	NPCNG00
Abu Ghraib	NPCNG00
Abu Simbel	NPCNG00
Addis Abeba	NPCNG00
Adrar des Iforas	NPCNG00
Al Capone	NPMSSP0
Alba Iulia	NPCNG00
Alcalá de Guadaíra	NPCNG00
Alcalá de Henares	NPCNG00
Alfa Romeo	NPMNG00
Alps Càrnics	NPCNG00
Alta Vienne	NPFSG00
Altin Tagh	NPCNG00
Andhra Pradesh	NPCNG00
Antígua e Barbuda	NPFSG00
Ascoli Piceno	NPCNG00
Ax 3 Domaines	NPCNG00
Aïoun el-Atrouss	NPCNG00
Baba Amr	NPCNG00
Bahía Blanca	NPCNG00
Banda Aceh	NPCNG00
Bandar Abbas	NPCNG00
Bandar Seri Begawan	NPCNG00
Bani Walid	NPCNG00
Banja Luka	NPCNG00
Baton Rouge	NPCNG00
Beer Sheva	NPCNG00
Beit Hanoun	NPCNG00
Belo Horizonte	NPCNG00
Ben Jawad	NPCNG00
Beni Suef	NPCNG00
Boca Juniors	NPMSG00
Bosanska Krajina	NPCNG00
Bosanski Brod	NPCNG00
Burger King	NPCNO00
Bío Bío	NPCNG00
Cagayan de Oro	NPCNG00
Canet lo Roig	NPCNG00
Cape Coast	NPCNG00
Cargados Carajos	NPCNG00
Carson City	NPCNG00
Cartagena de Indias	NPCNG00
Castel Gandolfo	NPCNG00
Cayos de Florida	NPCNG00
Ceské Budejovice	NPCNG00
Chiang Mai	NPCNG00
Chiang Rai	NPCNG00
Ciudad Juárez	NPCNG00
Ciudad Real	NPCNG00
Colúmbia Britànica	NPCNG00
Consell de Cent	NPMSO00
Cortes d'Arenós	NPFPG00
Cortes de Pallars	NPFPG00
Costa da Morte	NPFSG00
Costes d'Armor	NPFPG00
Creative Commons	NPCNO00
Cristiano Ronaldo	NPCNO00
Croix de Montvieux	NPFSG00
D'Hondt	NPCNSP0
Dakhlet Nouadhibou	NPCNG00
Dar es Salaam	NPCNG00
Darra-e Bum	NPCNG00
Daytona Beach	NPCNG00
Der Spiegel	NPMSO00
Deir ez-Zor	NPCNG00
Des Moines	NPCNG00
Dien Bien Phu	NPCNG00
Donington Park	NPMSG00
Dos Valires	NPFPG00
Downing Street	NPCSG00
Dvina Occidental	NPCNG00
Dvina Septentrional	NPCNG00
East Side	NPCNG00
El Corte Inglés	NPMSO00
El Ejido	NPMSG00
El Escorial	NPMSG00
El Jueves	NPMSO00
El Mundo	NPMSO00
El Mundo Deportivo	NPMSO00
El Periódico	NPMSO00
Elobey Chico	NPCNG00
Elobey Grande	NPCNG00
Espíritu Santo	NPCNG00
Estats Units	NPMPG00
Eth Portilhon	NPCSG00
Europa Press	NPCSO00
Euskal Herria	NPCNG00
FC Barcelona	NPMSG00
Financial Times	NPMSO00
Foreign Policy	NPCSO00
Fort Lauderdale	NPCNG00
Fra Angelico	NPMSG00
Frankfurt am Main	NPCSG00
Galileo Galilei	NPMSSP0
Gracias a Dios	NPCNG00
Gran Bretanya	NPFSG00
Grand Canyon	NPCNG00
Guangxi Zhuang	NPCNG00
Hai Phong	NPCNG00
Hindu Kush	NPCNG00
Ho Chi Minh	NPCNG00
Hong Kong	NPCNG00
Hradec Králové	NPCNG00
Huang He	NPCNG00
In Amenas	NPCNG00
Internet Explorer	NPMSG00
Internet Archive	NPMSG00
Jefferson City	NPCNG00
José María	NPMSSP0
José Luis	NPMSSP0
Joventut de Badalona	NPMSG00
Juan José	NPMSSP0
Kafr Kanna	NPCNG00
Kansas City	NPCNG00
Karlovy Vary	NPCNG00
Key Biscayne	NPCNG00
Khan Yunis	NPCNG00
Khemis Miliana	NPCNG00
Kingston upon Hull	NPCNG00
Kingston upon Thames	NPCNG00
Kiryat Shmona	NPCNG00
Kuala Lumpur	NPCNG00
Kuria Muria	NPCNG00
L'Aquila	NPFSG00
La Alcarria	NPCNG00
La Cartuja	NPCNG00
La Chaux-de-Fonds	NPCNG00
La Condamine	NPCNG00
La Digue	NPCNG00
La Grande-Motte	NPCNG00
La Línea de la Concepción	NPCNG00
La Mosquitia	NPCNG00
La Paz	NPCNG00
La Pequeña Habana	NPCNG00
La Tour	NPCNG00
La Toussuire	NPCNG00
La Valletta	NPCNG00
La Vanguardia	NPFSO00
Las Alpujarras	NPCNG00
Las Casas	NPCNG00
Las Palmas	NPCNG00
Las Palmas de Gran Canaria	NPCNG00
Las Vegas	NPCNG00
Le Bourg-d'Oisans	NPCNG00
Le Castellet	NPCNG00
Le Corbusier	NPCNSP0
Le Creusot	NPCNG00
Le Figaro	NPMSO00
Le Havre	NPCNG00
Le Louron	NPCNG00
Le Mans	NPCNG00
Le Monde	NPMSO00
Le Pen	NPCNSP0
Le Puy-en-Velay	NPCNG00
Les Essarts	NPCNG00
Les Herbiers	NPCNG00
Les Rousses	NPCNG00
Little Rock	NPCNG00
Long Island	NPCNG00
Los Angeles	NPCNG00
Mae Sai	NPCNG00
Manchester United	NPMSG00
Mare Nostrum	NPMSG00
Mariánské Lázne	NPCNG00
Mariano Rajoy	NPMSSP0
María José	NPFSSP0
Marktl am Inn	NPCNG00
Mato Grosso	NPCNG00
Mazar-e Sharif	NPCNG00
Miguel de Unamuno	NPMSG00
Minas Gerais	NPCNG00
Montego Bay	NPCNG00
Mónica Oltra	NPFSG00
Nagorno Karabakh	NPCNG00
Neuhausen am Rheinfall	NPCNG00
New Providence	NPCNG00
New York Times	NPMSO00
Ningxia Hui	NPCNG00
Nou Hampshire	NPCNG00
Nova Jersey	NPCNG00
Novi Sad	NPCNG00
Old Trafford	NPMSG00
Opus Dei	NPMSO00
Ortega y Gasset	NPMSSP0
Ossama bin Laden	NPMSSP0
Pearl Harbor	NPCNG00
Phillip Island	NPCNG00
Phnom Penh	NPCNG00
Picos de Europa	NPMPG00
Ploski Tolbàtxik	NPCNG00
Port Louis	NPCSG00
Port Moresby	NPCSG00
Port Saïd	NPCSG00
Porto Alegre	NPCSG00
Post mortem	L_RG
Primo de Rivera	NPMNG00
Puerta del Sol	NPFSG00
Puerto Rico	NPMSG00
Punta Arenas	NPCNG00
Ramón y Cajal	NPCNSP0
Ras Ajdir	NPCNG00
Ras Lanuf	NPCNG00
Ras al-Khaimah	NPCNG00
Red River	NPCNG00
Reggio de Calàbria	NPCNG00
Reggio de l'Emília	NPCNG00
Rhode Island	NPCNG00
Rift Valley	NPCNG00
Rio de Janeiro	NPMSG00
Robin Hood	NPMNG00
Roquetas de Mar	NPCNG00
Rub al-Khali	NPCNG00
Río de la Plata	NPMSG00
Sadr City	NPCNG00
Saint George's	NPCNG00
Saint Louis	NPCNG00
Saint Germain	NPCNG00
Salt Lake City	NPCNG00
San Diego	NPCNG00
San Francisco	NPCNG00
San José	NPCNG00
San Juan	NPCNG00
San Lorenzo de El Escorial	NPCNG00
San Marino	NPCNG00
San Pedro Sula	NPCNG00
Sankt Pölten	NPCNG00
Sanski Most	NPCNG00
Sant Joan Lohitzune	NPCNG00
Santa Cruz de Tenerife	NPCNG00
Santa Luzia	NPCNG00
Santiago de los Caballeros	NPCNG00
Santiago del Estero	NPCNG00
Santo Antao	NPCNG00
Santo Domingo	NPCNG00
São Paulo	NPCSG00
São Tiago	NPCSG00
Sao Tomé e Príncipe	NPMSG00
Sao Vicente	NPCSG00
Sharm al-Sheikh	NPCNG00
Sidi Bouzid	NPCNG00
Sierra Leone	NPFSG00
Silicon Valley	NPCSG00
Son Servera	NPCNG00
Staten Island	NPCNG00
Sun Yat-sen	NPMSG00
Super Bowl	NP_GN_FN
Taj Mahal	NPMSG00
Tamil Nadu	NPCNG00
Tarin Kowt	NPCSG00
Tel Aviv	NPCSG00
Terra Nova e Labrador	NPCSG00
The Daily Telegraph	NPMSO00
The Economist	NPMSO00
The Guardian	NPMSO00
The New York Times	NPMSO00
The Telegraph	NPMSO00
The Times	NPMSO00
The Wall Street Journal	NPMSO00
The Washington Post	NPMSO00
Tristão da Cunha	NPCNG00
Tuxtla Gutiérrez	NPCNG00
Tîrgu Mures	NPCNG00
Tony Blair	NPMSSP0
Ulan Bator	NPCNG00
Umm al-Qaywayn	NPCNG00
US Open	NPMSG00
València CF	NPMSG00
Vanua Levu	NPCNG00
Veliko Tarnovo	NPCNG00
Venta del Moro	NPFSG00
Villa Cisneros	NPCNG00
Villa La Angostura	NPCNG00
Virginia Beach	NPCNG00
Viti Levu	NPCNG00
Wall Street	NPCSG00
Walvis Bay	NPCNG00
West Bromwich	NPCNG00
West Ham	NPCNG00
West Side	NPCNG00
Xi Jiang	NPCNG00
Zareh Sharan	NPCNG00

# English expressions

# French expressions


# Scientific names

# Legal expression from 
# https://ptwikipediaorg/wiki/Lista_de_express%C3%B5es_jur%C3%ADdicas_em_latim
# Date: 14-11-2016

ad substantia negotii	L_LEGAL
ad substantiam	L_LEGAL
audi alteram partem	L_LEGAL
audiatur et altera pars	L_LEGAL
a deo rex	L_LEGAL
a rege lex	L_LEGAL
a quo	L_LEGAL
ab ovo	L_LEGAL
aberratio ictus	L_LEGAL
abolitio criminis	L_LEGAL
accessorium sequitur principale	L_LEGAL
actio libera in causa	L_LEGAL
actio nondum nata non praescribitur	L_LEGAL
actore non probante	L_LEGAL
reus absolvitur	L_LEGAL
actori incumbit onus probandi	L_LEGAL
ad hoc	L_LEGAL
ad impossibilia nemo tenetur	L_LEGAL
ad infinitum	L_LEGAL
ad perpetuam rei memoriam	L_LEGAL
ad probationem	L_LEGAL
ad quem	L_LEGAL
ad referendum	L_LEGAL
allegatio partis non facit jus	L_LEGAL
amicus curiae	L_LEGAL
animus	L_LEGAL
apud	L_LEGAL
ap	L_LEGAL
bella matribus detestata	L_LEGAL
beneficium juris nemini est denegandi	L_LEGAL
bis in idem	L_LEGAL
bona est lex si quis ea legitime utatur	L_LEGAL
bona fide	L_LEGAL
bona publica	L_LEGAL
boni mores	L_LEGAL
caput	L_LEGAL
casus fortuitus	L_LEGAL
causa mortis	L_LEGAL
causa petendi	L_LEGAL
causidicus	L_LEGAL
cautio damnini infecti	L_LEGAL
cautio rei uxoriae	L_LEGAL
citra petita	L_LEGAL
cogitationis poenam nemo patitur	L_LEGAL
condicio sine qua non	L_LEGAL
consummatum est	L_LEGAL
contra jus	L_LEGAL
contra legem	L_LEGAL
corpus delicti	L_LEGAL
cuique suum	L_LEGAL
cum granu salis	L_LEGAL
custas ex lege	L_LEGAL
custos legis	L_LEGAL
data venia	L_LEGAL
de cujus	L_LEGAL
de facto	L_LEGAL
de jure	L_LEGAL
de minimis non curat praetor	L_LEGAL
dies a quo non computatur in termino	L_LEGAL
divortium aquarum	L_LEGAL
do ut facias	L_LEGAL
dolo agit qui petit statim redditurus est	L_LEGAL
dormientibus non sucurrit ius	L_LEGAL
dura lex sed lex	L_LEGAL
emptio non tollit locatum	L_LEGAL
erga omnes	L_LEGAL
error communis facit ius	L_LEGAL
error in judicando	L_LEGAL
error in procedendo	L_LEGAL
ex lege	L_LEGAL
ex nunc	L_LEGAL
ex tunc	L_LEGAL
ex vi	L_LEGAL
exceptio doli	L_LEGAL
excusatio non petita	L_LEGAL
accusatio manifesta	L_LEGAL
expressão	L_LEGAL
ficta confessio	L_LEGAL
fructus sine usu esse non potest	L_LEGAL
fumus boni iuris	L_LEGAL
fumus comissi delicti	L_LEGAL
genus numquam perit	L_LEGAL
habeas corpus	L_LEGAL
habeas data	L_LEGAL
ignorantia legis non excusat	L_LEGAL
impossibilium nulla est obligatio	L_LEGAL
in absentia	L_LEGAL
in bonam partem	L_LEGAL
in claris non fit interpretatio	L_LEGAL
in dubio pro reo	L_LEGAL
in illiquidis non fit mora	L_LEGAL
in malam partem	L_LEGAL
in re ipsa	L_LEGAL
in verbis	L_LEGAL
inadimplenti non est adimplendum	L_LEGAL
inaudita altera parte	L_LEGAL
inaudita altera parte	L_LEGAL
incidenter tantum	L_LEGAL
inter pars	L_LEGAL
inter vivos	L_LEGAL
intuito personae	L_LEGAL
ipso facto	L_LEGAL
iter criminis	L_LEGAL
iudex iuxta alligata et probata iudicare debet	L_LEGAL
iura novit curia	L_LEGAL
ius manendi	L_LEGAL
ambulandi	L_LEGAL
eundi	L_LEGAL
ultro citroque	L_LEGAL
ius primae noctis	L_LEGAL
juris et de jure	L_LEGAL
juris tantum	L_LEGAL
jurisdictio	L_LEGAL
lato sensu	L_LEGAL
lex est quod populus iubet atque constituit	L_LEGAL
lex loci rei sitae	L_LEGAL
lex populi	L_LEGAL
lex quanvis irrationabilis	L_LEGAL
dummodo sit clara	L_LEGAL
lex scripta	L_LEGAL
longa manus	L_LEGAL
lucrum cessans	L_LEGAL
mala fides superveniens non nocet	L_LEGAL
mare clausum	L_LEGAL
mare liberum	L_LEGAL
mens in corpore tantum molen regit	L_LEGAL
more uxorio	L_LEGAL
mortis causa	L_LEGAL
mutatis mutandis	L_LEGAL
nec vi	L_LEGAL
nec clam	L_LEGAL
nec precario	L_LEGAL
neminem laedit qui suo iure utitur	L_LEGAL
nemini res sua servit	L_LEGAL
nemo iudex in causa sua	L_LEGAL
nemo plus iuris ad alium transferre potest quam ipse habet	L_LEGAL
nemo potest ei dicere cur ita facis?	L_LEGAL
nemo pro parte testatus pro parte intestatus decedere potest	L_LEGAL
nemo tenetur ad impossibilia	L_LEGAL
nemo tenetur se detegere	L_LEGAL
nemo tenetur se ipsum accusare	L_LEGAL
non bis in idem	L_LEGAL
non omne quod licet honestum est	L_LEGAL
notitia criminis	L_LEGAL
novatio legis	L_LEGAL
novissima voluntas servatur	L_LEGAL
nulli conceditur	L_LEGAL
nullum crimen sine culpa	L_LEGAL
nullum crimen	L_LEGAL
nulla poena sine praevia lege poenali	L_LEGAL
o que é demais não é nocivo	L_LEGAL
pacta sunt servanda	L_LEGAL
pacto reservati dominii	L_LEGAL
pactum disciplicentiae ou pacto ad gustum	L_LEGAL
pari passu	L_LEGAL
periculum in mora	L_LEGAL
pietas est fundamentum omnium virtutum	L_LEGAL
quando bene se gesserit	L_LEGAL
quantum	L_LEGAL
quantum debeatur	L_LEGAL
qui iure suo utitur	L_LEGAL
neminem laedit	L_LEGAL
quid	L_LEGAL
quid latine dictum sit	L_LEGAL
altum sonatur	L_LEGAL
quod abundat non nocet	L_LEGAL
ratio juris	L_LEGAL
rebus sic stantibus	L_LEGAL
reformatio in melius	L_LEGAL
reformatio in pejus	L_LEGAL
reformatio in pejus indireta	L_LEGAL
res derelictae	L_LEGAL
res furtiva	L_LEGAL
res judicata pro veritate accipitur	L_LEGAL
res nullius	L_LEGAL
res perit domino	L_LEGAL
salus populi suprema lex esto	L_LEGAL
semel heres	L_LEGAL
semper heres	L_LEGAL
sermo usualis	L_LEGAL
servans servandis	L_LEGAL
si vera sunt	L_LEGAL
sine die	L_LEGAL
stare decisis	L_LEGAL
stricto sensu	L_LEGAL
sub judice	L_LEGAL
summum ius	L_LEGAL
summa iniuria	L_LEGAL
superficies solo cedit	L_LEGAL
supressio	L_LEGAL
surrectio	L_LEGAL
suum cuique tribuere	L_LEGAL
tam dixit quam voluit	L_LEGAL
tantum devolutum quantum appellatum	L_LEGAL
tantundem eiusdem generis	L_LEGAL
tempus regit actum	L_LEGAL
tertium genus	L_LEGAL
tertium non datur	L_LEGAL
tu quoque	L_LEGAL
fili	L_LEGAL
ubi lex voluit dixit	L_LEGAL
ubi noluit tacuit	L_LEGAL
ubi non est justitia	L_LEGAL
ibi non potest esse jus	L_LEGAL
ubi societas ibi ius	L_LEGAL
ultima ratio	L_LEGAL
ultra posse nemo obligator	L_LEGAL
unum castigabis	L_LEGAL
centum emendabis	L_LEGAL
ut res magis valeat quam pereat	L_LEGAL
uti possidetis	L_LEGAL
vg	L_LEGAL
verbi gratia	L_LEGAL
vacatio legis	L_LEGAL
vade mecum	L_LEGAL
venire contra factum proprium	L_LEGAL
verba volant scripta manent	L_LEGAL
verbis	L_LEGAL
vigilavit iustitiae oculus	L_LEGAL
vis absoluta	L_LEGAL
vis relativa	L_LEGAL
volenti non fit iniuria	L_LEGAL

# Nomes de freguesias e conselhos com mais de uma palavra retirados da Wikipedia
# https://github.com/TiagoSantos81/FreeLing/blob/1cc2bad987c5b04a2b3dc58d12b5d15438cf9fe6/LanguageTool/pt/LT%20specific/geo_multiwords

A dos Cunhados	NPCSG00
A dos Francos	NPCSG00
A dos Negros	NPCSG00
A Ver-o-Mar	NPCSG00
Abade de Neiva	NPCSG00
Abade de Vermoim	NPCSG00
Aboim da Nóbrega	NPCSG00
Aboim das Choças	NPCSG00
Achadas da Cruz	NPCSG00
Água de Alto	NPCSG00
Água de Pau	NPCSG00
Água de Pena	NPCSG00
Água Longa	NPCSG00
Água Retorta	NPCSG00
Água Revés e Crasto	NPCSG00
Aguada de Baixo	NPCSG00
Aguada de Cima	NPCSG00
Águas Belas	NPCSG00
Águas Boas	NPCSG00
Águas Santas	NPCSG00
Águas Vivas	NPCSG00
Aguiar da Beira	NPCSG00
Aguiar de Sousa	NPCSG00
Ajuda da Bretanha	NPCSG00
Ajuda, Salvador e Santo Ildefonso	NPCSG00
Albergaria da Serra	NPCSG00
Albergaria dos Doze	NPCSG00
Alcácer do Sal	NPCSG00
Alcaria Ruiva	NPCSG00
Aldeia da Mata	NPCSG00
Aldeia da Ponte	NPCSG00
Aldeia da Ribeira	NPCSG00
Aldeia das Dez	NPCSG00
Aldeia de Joanes	NPCSG00
Aldeia de João Pires	NPCSG00
Aldeia de Nacomba	NPCSG00
Aldeia de Paio Pires	NPCSG00
Aldeia de Santa Margarida	NPCSG00
Aldeia de Santo António	NPCSG00
Aldeia de São Francisco de Assis	NPCSG00
Aldeia do Bispo	NPCSG00
Aldeia do Mato	NPCSG00
Aldeia do Souto	NPCSG00
Aldeia dos Fernandes	NPCSG00
Aldeia Galega da Merceana	NPCSG00
Aldeia Gavinha	NPCSG00
Aldeia Nova	NPCSG00
Aldeia Nova do Cabo	NPCSG00
Aldeia Velha	NPCSG00
Aldeia Viçosa	NPCSG00
Além da Ribeira	NPCSG00
Alfândega da Fé	NPCSG00
Alfarela de Jales	NPCSG00
Algueirão - Mem Martins	NPCSG00
Alhos Vedros	NPCSG00
Almargem do Bispo	NPCSG00
Alpendurada e Matos	NPCSG00
Alqueidão da Serra	NPCSG00
Alter do Chão	NPCSG00
Alto do Pina	NPCSG00
Alto do Seixalinho	NPCSG00
Alto Estanqueiro - Jardia	NPCSG00
Alturas do Barroso	NPCSG00
Alvações do Corgo	NPCSG00
Alverca da Beira	NPCSG00
Alverca do Ribatejo	NPCSG00
Alvito da Beira	NPCSG00
Alvoco da Serra	NPCSG00
Alvoco das Várzeas	NPCSG00
Amiais de Baixo	NPCSG00
Amieira do Tejo	NPCSG00
Amoreira da Gândara	NPCSG00
Arco da Calheta	NPCSG00
Arco de Baúlhe	NPCSG00
Arco de São Jorge	NPCSG00
Arcos de Valdevez	NPCSG00
Arcozelo das Maias	NPCSG00
Areias de Vilar	NPCSG00
Arga de Baixo	NPCSG00
Arga de Cima	NPCSG00
Arga de São João	NPCSG00
Armação de Pêra	NPCSG00
Arneiro das Milhariças	NPCSG00
Arruda dos Pisões	NPCSG00
Arruda dos Vinhos	NPCSG00
Atalaia do Campo	NPCSG00
Atouguia da Baleia	NPCSG00
Aveiras de Baixo	NPCSG00
Aveiras de Cima	NPCSG00
Avelãs da Ribeira	NPCSG00
Avelãs de Ambom	NPCSG00
Avelãs de Caminho	NPCSG00
Avelãs de Cima	NPCSG00
Azinheira dos Barros e São Mamede do Sádão	NPCSG00
Azoia de Baixo	NPCSG00
Azoia de Cima	NPCSG00
Baguim do Monte	NPCSG00
Baixa da Banheira	NPCSG00
Banho e Carvalhosa	NPCSG00
Barão de São João	NPCSG00
Barão de São Miguel	NPCSG00
Barreiro de Besteiros	NPCSG00
Barril de Alva	NPCSG00
Barroças e Taias	NPCSG00
Beira Grande	NPCSG00
Beiral do Lima	NPCSG00
Belazaima do Chão	NPCSG00
Bem da Fé	NPCSG00
Benfica do Ribatejo	NPCSG00
Bidoeira de Cima	NPCSG00
Boa Aldeia	NPCSG00
Boa Vista	NPCSG00
Boavista dos Pinheiros	NPCSG00
Bogas de Baixo	NPCSG00
Bogas de Cima	NPCSG00
Bom Sucesso	NPCSG00
Borba de Montanha	NPCSG00
Borda do Campo	NPCSG00
Bornes de Aguiar	NPCSG00
Bouça Cova	NPCSG00
Cabana Maior	NPCSG00
Cabanas de Tavira	NPCSG00
Cabanas de Torres	NPCSG00
Cabanas de Viriato	NPCSG00
Cabeça Boa	NPCSG00
Cabeça Gorda	NPCSG00
Cabeça Santa	NPCSG00
Cabeceiras de Basto	NPCSG00
Cabeço de Vide	NPCSG00
Cabo da Praia	NPCSG00
Caia e São Pedro	NPCSG00
Caíde de Rei	NPCSG00
Caldas da Rainha	NPCSG00
Caldas de São Jorge	NPCSG00
Calheta de Nesquim	NPCSG00
Calvaria de Cima	NPCSG00
Câmara de Lobos	NPCSG00
Cambeses do Rio	NPCSG00
Campo de Besteiros	NPCSG00
Campo de Víboras	NPCSG00
Campo do Gerês	NPCSG00
Campo Grande	NPCSG00
Campo Maior	NPCSG00
Canas de Santa Maria	NPCSG00
Canas de Senhorim	NPCSG00
Canedo de Basto	NPCSG00
Carrazeda de Ansiães	NPCSG00
Carrazedo de Montenegro	NPCSG00
Carregal do Sal	NPCSG00
Carvalhal Benfeito	NPCSG00
Carvalhal de Vermilhas	NPCSG00
Carvalhal Meão	NPCSG00
Carvalhal Redondo	NPCSG00
Carvalho de Egas	NPCSG00
Carvalho de Rei	NPCSG00
Casa Branca	NPCSG00
Casal Comba	NPCSG00
Casal de Cambra	NPCSG00
Casal de Cinza	NPCSG00
Casal de Ermio	NPCSG00
Casal de Loivos	NPCSG00
Casal dos Bernardos	NPCSG00
Casal Pinheiro	NPCSG00
Casal Vasco	NPCSG00
Casas do Soeiro	NPCSG00
Castanheira de Pera	NPCSG00
Castanheira do Ribatejo	NPCSG00
Castanheira do Vouga	NPCSG00
Castanheiro do Sul	NPCSG00
Castelo Bom	NPCSG00
Castelo Branco	NPCSG00
Castelo de Paiva	NPCSG00
Castelo de Penalva	NPCSG00
Castelo de Vide	NPCSG00
Castelo do Neiva	NPCSG00
Castelo Melhor	NPCSG00
Castelo Mendo	NPCSG00
Castelo Novo	NPCSG00
Castelo Rodrigo	NPCSG00
Castelo Viegas	NPCSG00
Castelões de Cepeda	NPCSG00
Castro Daire	NPCSG00
Castro de Avelãs	NPCSG00
Castro Laboreiro	NPCSG00
Castro Marim	NPCSG00
Castro Verde	NPCSG00
Castro Vicente	NPCSG00
Cebolais de Cima	NPCSG00
Celorico da Beira	NPCSG00
Celorico de Basto	NPCSG00
Cercal do Alentejo	NPCSG00
Cernache do Bonjardim	NPCSG00
Chão de Couce	NPCSG00
Charneca de Caparica	NPCSG00
Chãs de Tavares	NPCSG00
Cimo de Vila da Castanheira	NPCSG00
Cinco Ribeiras	NPCSG00
Cinco Vilas	NPCSG00
Colmeal da Torre	NPCSG00
Coração de Jesus	NPCSG00
Corte do Pinto	NPCSG00
Cortes do Meio	NPCSG00
Corticeiro de Cima	NPCSG00
Cortiçô da Serra	NPCSG00
Couto de Baixo	NPCSG00
Couto de Cima	NPCSG00
Couto de Esteves	NPCSG00
Couto do Mosteiro	NPCSG00
Cova da Piedade	NPCSG00
Covão do Lobo	NPCSG00
Covas do Barroso	NPCSG00
Covas do Douro	NPCSG00
Covas do Rio	NPCSG00
Covelo de Paivô	NPCSG00
Covelo do Gerês	NPCSG00
Crato e Mártires	NPCSG00
Criação Velha	NPCSG00
Cristelo Covo	NPCSG00
Cruz de Pau	NPCSG00
Cruz Quebrada - Dafundo	NPCSG00
Cuide de Vila Verde	NPCSG00
Cunha Alta	NPCSG00
Cunha Baixa	NPCSG00
Curral das Freiras	NPCSG00
Dois Portos	NPCSG00
Dornelas do Zêzere	NPCSG00
Doze Ribeiras	NPCSG00
Duas Igrejas	NPCSG00
Eira Vedra	NPCSG00
Entre Ambos-os-Rios	NPCSG00
Enxara do Bispo	NPCSG00
Ervas Tenras	NPCSG00
Ervedosa do Douro	NPCSG00
Escalos de Baixo	NPCSG00
Escalos de Cima	NPCSG00
Espírito Santo	NPCSG00
Estreito da Calheta	NPCSG00
Estreito de Câmara de Lobos	NPCSG00
Évora de Alcobaça	NPCSG00
Faial da Terra	NPCSG00
Fajã da Ovelha	NPCSG00
Fajã de Baixo	NPCSG00
Fajã de Cima	NPCSG00
Fajã Grande	NPCSG00
Faro do Alentejo	NPCSG00
Fazendas de Almeirim	NPCSG00
Fenais da Ajuda	NPCSG00
Fenais da Luz	NPCSG00
Fernão Ferro	NPCSG00
Fernão Joanes	NPCSG00
Ferreira de Aves	NPCSG00
Ferreira do Alentejo	NPCSG00
Ferreira do Zêzere	NPCSG00
Ferreiros de Avões	NPCSG00
Ferreiros de Tendais	NPCSG00
Ferreirós do Dão	NPCSG00
Fiães do Rio	NPCSG00
Fiães do Tâmega	NPCSG00
Figueira da Foz	NPCSG00
Figueira de Castelo Rodrigo	NPCSG00
Figueira de Lorvão	NPCSG00
Figueira dos Cavaleiros	NPCSG00
Figueira e Barros	NPCSG00
Figueiredo das Donas	NPCSG00
Figueiredo de Alva	NPCSG00
Figueiró da Granja	NPCSG00
Figueiró da Serra	NPCSG00
Figueiró do Campo	NPCSG00
Figueiró dos Vinhos	NPCSG00
Flor da Rosa	NPCSG00
Fojo Lobal	NPCSG00
Fonte Arcada	NPCSG00
Fonte Boa	NPCSG00
Fonte Coberta	NPCSG00
Fonte de Angeão	NPCSG00
Fonte do Bastardo	NPCSG00
Fonte Longa	NPCSG00
Fornelo do Monte	NPCSG00
Forno Telheiro	NPCSG00
Fornos de Algodres	NPCSG00
Fornos de Maceira Dão	NPCSG00
Fornos do Pinhal	NPCSG00
Foros de Arrão	NPCSG00
Foros de Salvaterra	NPCSG00
Foros de Vale de Figueira	NPCSG00
Forte da Casa	NPCSG00
Foz de Arouce	NPCSG00
Foz do Arelho	NPCSG00
Foz do Douro	NPCSG00
Foz do Sousa	NPCSG00
Freixeda do Torrão	NPCSG00
Freixial do Campo	NPCSG00
Freixieiro de Soutelo	NPCSG00
Freixo da Serra	NPCSG00
Freixo de Baixo	NPCSG00
Freixo de Cima	NPCSG00
Freixo de Espada à Cinta	NPCSG00
Freixo de Numão	NPCSG00
Gafanha da Boa Hora	NPCSG00
Gafanha da Encarnação	NPCSG00
Gafanha da Nazaré	NPCSG00
Gafanha do Carmo	NPCSG00
Gâmbia - Pontes - Alto da Guerra	NPCSG00
Geraz do Minho	NPCSG00
Glória do Ribatejo	NPCSG00
Gomes Aires	NPCSG00
Gonçalo Bocas	NPCSG00
Gouvães da Serra	NPCSG00
Gouvães do Douro	NPCSG00
Granja do Tedo	NPCSG00
Granja do Ulmeiro	NPCSG00
Granja Nova	NPCSG00
Grijó de Parada	NPCSG00
Horta da Vilariça	NPCSG00
Horta das Figueiras	NPCSG00
Igreja Nova	NPCSG00
Igreja Nova do Sobral	NPCSG00
Imaculado Coração de Maria	NPCSG00
Janeiro de Baixo	NPCSG00
Janeiro de Cima	NPCSG00
Jardim da Serra	NPCSG00
Jardim do Mar	NPCSG00
João Antão	NPCSG00
Juncal do Campo	NPCSG00
Lagares da Beira	NPCSG00
Lagos da Beira	NPCSG00
Lajeosa do Dão	NPCSG00
Lajeosa do Mondego	NPCSG00
Lajes das Flores	NPCSG00
Lajes do Pico	NPCSG00
Lama de Arcos	NPCSG00
Lamas de Mouro	NPCSG00
Lamas de Olo	NPCSG00
Lamas de Orelhão	NPCSG00
Lamas do Vouga	NPCSG00
Lapa do Lobo	NPCSG00
Lapa dos Dinheiros	NPCSG00
Leça da Palmeira	NPCSG00
Leça do Balio	NPCSG00
Lixa do Alvão	NPCSG00
Lobão da Beira	NPCSG00
Lobelhe do Mato	NPCSG00
Loivos da Ribeira	NPCSG00
Loivos do Monte	NPCSG00
Lomba da Fazenda	NPCSG00
Lomba da Maia	NPCSG00
Lomba de São Pedro	NPCSG00
Longos Vales	NPCSG00
Longueira / Almograve	NPCSG00
Lordelo do Ouro	NPCSG00
Louriçal do Campo	NPCSG00
Luz de Tavira	NPCSG00
Maçal do Chão	NPCSG00
Maçãs de Caminho	NPCSG00
Maçãs de Dona Maria	NPCSG00
Macedo de Cavaleiros	NPCSG00
Macedo do Mato	NPCSG00
Macieira da Lixa	NPCSG00
Macieira da Maia	NPCSG00
Macieira de Alcoba	NPCSG00
Macieira de Cambra	NPCSG00
Macieira de Rates	NPCSG00
Macieira de Sarnes	NPCSG00
Macinhata da Seixa	NPCSG00
Macinhata do Vouga	NPCSG00
Madalena de Jolda	NPCSG00
Madalena do Mar	NPCSG00
Malhada Sorda	NPCSG00
Malpica do Tejo	NPCSG00
Mangualde da Serra	NPCSG00
Manique do Intendente	NPCSG00
Marco de Canaveses	NPCSG00
Marinha das Ondas	NPCSG00
Marinha Grande	NPCSG00
Martim Longo	NPCSG00
Mata da Rainha	NPCSG00
Mata de Lobos	NPCSG00
Mata Mourisca	NPCSG00
Meãs do Campo	NPCSG00
Meda de Mouros	NPCSG00
Mesão Frio	NPCSG00
Mexilhoeira Grande	NPCSG00
Milheirós de Poiares	NPCSG00
Mira de Aire	NPCSG00
Miranda do Corvo	NPCSG00
Miranda do Douro	NPCSG00
Mire de Tibães	NPCSG00
Mogo de Malta	NPCSG00
Moimenta da Beira	NPCSG00
Moimenta da Serra	NPCSG00
Moimenta de Maceira Dão	NPCSG00
Moinhos da Gândara	NPCSG00
Moita do Norte	NPCSG00
Moita dos Ferreiros	NPCSG00
Moitas Venda	NPCSG00
Mondim da Beira	NPCSG00
Mondim de Basto	NPCSG00
Monforte da Beira	NPCSG00
Monte Abraão	NPCSG00
Monte Córdova	NPCSG00
Monte da Pedra	NPCSG00
Monte de Fralães	NPCSG00
Monte do Trigo	NPCSG00
Monte Gordo	NPCSG00
Monte Margarida	NPCSG00
Monte Perobolço	NPCSG00
Monte Real	NPCSG00
Monte Redondo	NPCSG00
Montes da Senhora	NPCSG00
Moreira de Cónegos	NPCSG00
Moreira de Geraz do Lima	NPCSG00
Moreira de Rei	NPCSG00
Moreira do Castelo	NPCSG00
Moreira do Lima	NPCSG00
Moreira do Rei	NPCSG00
Mosteiro de Fráguas	NPCSG00
Moura da Serra	NPCSG00
Moura Morta	NPCSG00
Nagozelo do Douro	NPCSG00
Nave de Haver	NPCSG00
Ninho do Açor	NPCSG00
Nogueira da Montanha	NPCSG00
Nogueira da Regedoura	NPCSG00
Nogueira do Cravo	NPCSG00
Norte Grande	NPCSG00
Norte Pequeno	NPCSG00
Nossa Senhora da Anunciada	NPCSG00
Nossa Senhora da Boa Fé	NPCSG00
Nossa Senhora da Conceição	NPCSG00
Nossa Senhora da Expectação	NPCSG00
Nossa Senhora da Graça	NPCSG00
Nossa Senhora da Graça de Póvoa e Meadas	NPCSG00
Nossa Senhora da Graça do Divor	NPCSG00
Nossa Senhora da Graça dos Degolados	NPCSG00
Nossa Senhora da Piedade	NPCSG00
Nossa Senhora da Tourega	NPCSG00
Nossa Senhora da Vila	NPCSG00
Nossa Senhora das Misericórdias	NPCSG00
Nossa Senhora das Neves	NPCSG00
Nossa Senhora de Fátima	NPCSG00
Nossa Senhora de Guadalupe	NPCSG00
Nossa Senhora de Machede	NPCSG00
Nossa Senhora do Bispo	NPCSG00
Nossa Senhora do Pópulo	NPCSG00
Nossa Senhora do Rosário	NPCSG00
Nossa Senhora dos Remédios	NPCSG00
Oeiras e São Julião da Barra	NPCSG00
Óis da Ribeira	NPCSG00
Óis do Bairro	NPCSG00
Olho Marinho	NPCSG00
Olhos de Água	NPCSG00
Olival Basto	NPCSG00
Oliveira de Azeméis	NPCSG00
Oliveira de Frades	NPCSG00
Oliveira do Bairro	NPCSG00
Oliveira do Castelo	NPCSG00
Oliveira do Conde	NPCSG00
Oliveira do Douro	NPCSG00
Oliveira do Hospital	NPCSG00
Oliveira do Mondego	NPCSG00
Outeiro da Cabeça	NPCSG00
Outeiro da Cortiçada	NPCSG00
Outeiro de Gatos	NPCSG00
Outeiro Seco	NPCSG00
Paço de Arcos	NPCSG00
Paço de Sousa	NPCSG00
Paço Vedro de Magalhães	NPCSG00
Paços da Serra	NPCSG00
Paços de Brandão	NPCSG00
Paços de Ferreira	NPCSG00
Paços de Gaiolo	NPCSG00
Padim da Graça	NPCSG00
Padrela e Tazem	NPCSG00
Paio Mendes	NPCSG00
Palmeira de Faro	NPCSG00
Pampilhosa da Serra	NPCSG00
Panóias de Cima	NPCSG00
Parada de Cunhos	NPCSG00
Parada de Ester	NPCSG00
Parada de Gatim	NPCSG00
Parada de Gonta	NPCSG00
Parada de Monteiros	NPCSG00
Parada de Pinhão	NPCSG00
Parada de Tibães	NPCSG00
Parada de Todeia	NPCSG00
Parada do Bispo	NPCSG00
Parada do Bouro	NPCSG00
Parada do Monte	NPCSG00
Paradela de Guiães	NPCSG00
Paradinha Nova	NPCSG00
Paranhos da Beira	NPCSG00
Paredes da Beira	NPCSG00
Paredes de Coura	NPCSG00
Paredes de Viadores	NPCSG00
Paredes do Bairro	NPCSG00
Paredes Secas	NPCSG00
Paul do Mar	NPCSG00
Pedra Furada	NPCSG00
Pedro Miguel	NPCSG00
Pedrógão de São Pedro	NPCSG00
Pedrógão Grande	NPCSG00
Pedrógão Pequeno	NPCSG00
Pena Lobo	NPCSG00
Pena Verde	NPCSG00
Penalva de Alva	NPCSG00
Penalva do Castelo	NPCSG00
Penas Roias	NPCSG00
Penela da Beira	NPCSG00
Penha da Águia	NPCSG00
Penha de França	NPCSG00
Penha Garcia	NPCSG00
Penha Longa	NPCSG00
Penhas Juntas	NPCSG00
Pera do Moço	NPCSG00
Pera Velha	NPCSG00
Peredo da Bemposta	NPCSG00
Peredo dos Castelhanos	NPCSG00
Pereiro de Palhacana	NPCSG00
Pero Moniz	NPCSG00
Pêro Pinheiro	NPCSG00
Pêro Soares	NPCSG00
Pêro Viseu	NPCSG00
Peso da Régua	NPCSG00
Pessegueiro do Vouga	NPCSG00
Pico da Pedra	NPCSG00
Pico de Regalados	NPCSG00
Pilar da Bretanha	NPCSG00
Pindelo dos Milagres	NPCSG00
Pinhal do Norte	NPCSG00
Pinhal Novo	NPCSG00
Pinheiro da Bemposta	NPCSG00
Pinheiro de Ázere	NPCSG00
Pinheiro de Coja	NPCSG00
Pinheiro Grande	NPCSG00
Pinheiro Novo	NPCSG00
Pitões das Júnias	NPCSG00
Poço do Canto	NPCSG00
Pombeiro da Beira	NPCSG00
Pombeiro de Ribavizela	NPCSG00
Ponta Delgada	NPCSG00
Ponta do Pargo	NPCSG00
Ponta do Sol	NPCSG00
Ponta Garça	NPCSG00
Ponte da Barca	NPCSG00
Ponte de Lima	NPCSG00
Ponte de Sor	NPCSG00
Ponte de Vagos	NPCSG00
Ponte do Rol	NPCSG00
Portela das Cabras	NPCSG00
Portela do Fojo	NPCSG00
Portela Susã	NPCSG00
Porto Covo	NPCSG00
Porto da Carne	NPCSG00
Porto da Cruz	NPCSG00
Porto de Mós	NPCSG00
Porto de Ovelha	NPCSG00
Porto Formoso	NPCSG00
Porto Judeu	NPCSG00
Porto Martins	NPCSG00
Porto Moniz	NPCSG00
Porto Salvo	NPCSG00
Posto Santo	NPCSG00
Pousada de Saramagos	NPCSG00
Pousafoles do Bispo	NPCSG00
Póvoa da Isenta	NPCSG00
Póvoa de Agrações	NPCSG00
Póvoa de Atalaia	NPCSG00
Póvoa de Cervães	NPCSG00
Póvoa de El-Rei	NPCSG00
Póvoa de Lanhoso	NPCSG00
Póvoa de Midões	NPCSG00
Póvoa de Penela	NPCSG00
Póvoa de Rio de Moinhos	NPCSG00
Póvoa de Santa Iria	NPCSG00
Póvoa de Santarém	NPCSG00
Póvoa de Santo Adrião	NPCSG00
Póvoa de São Miguel	NPCSG00
Póvoa de Varzim	NPCSG00
Póvoa do Concelho	NPCSG00
Praia de Mira	NPCSG00
Praia do Almoxarife	NPCSG00
Praia do Norte	NPCSG00
Praia do Ribatejo	NPCSG00
Prazeres de Aljubarrota	NPCSG00
Prior Velho	NPCSG00
Quatro Ribeiras	NPCSG00
Quintã de Pêro Martins	NPCSG00
Quinta de São Bartolomeu	NPCSG00
Quinta do Anjo	NPCSG00
Quinta do Conde	NPCSG00
Quinta Grande	NPCSG00
Quintela de Azurara	NPCSG00
Quintela de Lampaças	NPCSG00
Rabo de Peixe	NPCSG00
Rapoula do Côa	NPCSG00
Refóios do Lima	NPCSG00
Refojos de Basto	NPCSG00
Refojos de Riba de Ave	NPCSG00
Rego da Murta	NPCSG00
Regueira de Pontes	NPCSG00
Reguengo do Fetal	NPCSG00
Reguengo Grande	NPCSG00
Reguengos de Monsaraz	NPCSG00
Riba de Âncora	NPCSG00
Riba de Ave	NPCSG00
Riba de Mouro	NPCSG00
Ribeira Branca	NPCSG00
Ribeira Brava	NPCSG00
Ribeira Chã	NPCSG00
Ribeira da Janela	NPCSG00
Ribeira das Tainhas	NPCSG00
Ribeira de Frades	NPCSG00
Ribeira de Fráguas	NPCSG00
Ribeira de Nisa	NPCSG00
Ribeira de Palheiros	NPCSG00
Ribeira de Pena	NPCSG00
Ribeira de São João	NPCSG00
Ribeira do Fárrio	NPCSG00
Ribeira dos Carinhos	NPCSG00
Ribeira Quente	NPCSG00
Ribeira Seca	NPCSG00
Rio Cabrão	NPCSG00
Rio Caldo	NPCSG00
Rio de Couros	NPCSG00
Rio de Galinhas	NPCSG00
Rio de Loba	NPCSG00
Rio de Mel	NPCSG00
Rio de Moinhos	NPCSG00
Rio de Mouro	NPCSG00
Rio de Onor	NPCSG00
Rio Douro	NPCSG00
Rio Frio	NPCSG00
Rio Maior	NPCSG00
Rio Mau	NPCSG00
Rio Meão	NPCSG00
Rio Tinto	NPCSG00
Rio Torto	NPCSG00
Rio Vide	NPCSG00
Rocas do Vouga	NPCSG00
Rossio ao Sul do Tejo	NPCSG00
Sabroso de Aguiar	NPCSG00
Salgueiro do Campo	NPCSG00
Salir de Matos	NPCSG00
Salir do Porto	NPCSG00
Salvador de Briteiros	NPCSG00
Salvador de Padreiro	NPCSG00
Salvador de Touvedo	NPCSG00
Salvador do Monte	NPCSG00
Salvaterra de Magos	NPCSG00
Salvaterra do Extremo	NPCSG00
Samora Correia	NPCSG00
Sanfins de Ferreira	NPCSG00
Sanfins do Douro	NPCSG00
Santa Bárbara	NPCSG00
Santa Bárbara de Nexe	NPCSG00
Santa Bárbara de Padrões	NPCSG00
Santa Catarina	NPCSG00
Santa Catarina da Fonte do Bispo	NPCSG00
Santa Catarina da Serra	NPCSG00
Santa Clara	NPCSG00
Santa Clara de Louredo	NPCSG00
Santa Clara-a-Nova	NPCSG00
Santa Clara-a-Velha	NPCSG00
Santa Comba	NPCSG00
Santa Comba Dão	NPCSG00
Santa Comba de Rossas	NPCSG00
Santa Comba de Vilariça	NPCSG00
Santa Combinha	NPCSG00
Santa Cristina	NPCSG00
Santa Cristina de Arões	NPCSG00
Santa Cristina de Figueiró	NPCSG00
Santa Cristina de Padreiro	NPCSG00
Santa Cristina do Couto	NPCSG00
Santa Cruz	NPCSG00
Santa Cruz da Graciosa	NPCSG00
Santa Cruz da Trapa	NPCSG00
Santa Cruz das Flores	NPCSG00
Santa Cruz do Bispo	NPCSG00
Santa Cruz do Douro	NPCSG00
Santa Cruz do Lima	NPCSG00
Santa Engrácia	NPCSG00
Santa Eufémia	NPCSG00
Santa Eufémia de Prazins	NPCSG00
Santa Eugénia	NPCSG00
Santa Eugénia de Rio Covo	NPCSG00
Santa Eulália	NPCSG00
Santa Eulália de Arnoso	NPCSG00
Santa Eulália de Rio Covo	NPCSG00
Santa Iria da Ribeira de Santarém	NPCSG00
Santa Iria de Azóia	NPCSG00
Santa Isabel	NPCSG00
Santa Joana	NPCSG00
Santa Justa	NPCSG00
Santa Leocádia	NPCSG00
Santa Leocádia de Briteiros	NPCSG00
Santa Leocádia de Geraz do Lima	NPCSG00
Santa Lucrécia de Algeriz	NPCSG00
Santa Luzia	NPCSG00
Santa Margarida da Coutada	NPCSG00
Santa Margarida da Serra	NPCSG00
Santa Margarida de Lousada	NPCSG00
Santa Maria	NPCSG00
Santa Maria da Devesa	NPCSG00
Santa Maria da Feira	NPCSG00
Santa Maria da Graça	NPCSG00
Santa Maria da Torre	NPCSG00
Santa Maria de Airão	NPCSG00
Santa Maria de Arnoso	NPCSG00
Santa Maria de Avioso	NPCSG00
Santa Maria de Belém	NPCSG00
Santa Maria de Emeres	NPCSG00
Santa Maria de Galegos	NPCSG00
Santa Maria de Geraz do Lima	NPCSG00
Santa Maria de Lamas	NPCSG00
Santa Maria de Marvão	NPCSG00
Santa Maria de Oliveira	NPCSG00
Santa Maria de Rebordões	NPCSG00
Santa Maria de Sardoura	NPCSG00
Santa Maria de Souto	NPCSG00
Santa Maria de Távora	NPCSG00
Santa Maria de Viseu	NPCSG00
Santa Maria do Bouro	NPCSG00
Santa Maria do Castelo	NPCSG00
Santa Maria do Castelo e São Miguel	NPCSG00
Santa Maria dos Olivais	NPCSG00
Santa Maria e São Miguel	NPCSG00
Santa Maria Maior	NPCSG00
Santa Marinha	NPCSG00
Santa Marinha de Oriz	NPCSG00
Santa Marinha do Zêzere	NPCSG00
Santa Marta	NPCSG00
Santa Marta da Montanha	NPCSG00
Santa Marta de Penaguião	NPCSG00
Santa Marta de Portuzelo	NPCSG00
Santa Marta do Bouro	NPCSG00
Santa Ovaia	NPCSG00
Santa Susana	NPCSG00
Santa Tecla de Basto	NPCSG00
Santa Valha	NPCSG00
Santa Vitória	NPCSG00
Santa Vitória do Ameixial	NPCSG00
Santana da Azinha	NPCSG00
Santana da Serra	NPCSG00
Santana de Cambas	NPCSG00
Santana do Mato	NPCSG00
Santiago da Guarda	NPCSG00
Santiago da Ribeira de Alhariz	NPCSG00
Santiago de Besteiros	NPCSG00
Santiago de Bougado	NPCSG00
Santiago de Candoso	NPCSG00
Santiago de Carreiras	NPCSG00
Santiago de Cassurrães	NPCSG00
Santiago de Figueiró	NPCSG00
Santiago de Litém	NPCSG00
Santiago de Montalegre	NPCSG00
Santiago de Piães	NPCSG00
Santiago de Riba-Ul	NPCSG00
Santiago de Subarrifana	NPCSG00
Santiago de Vila Chã	NPCSG00
Santiago do Cacém	NPCSG00
Santiago do Escoural	NPCSG00
Santiago dos Velhos	NPCSG00
Santiago Maior	NPCSG00
Santo Adrião	NPCSG00
Santo Adrião de Vizela	NPCSG00
Santo Agostinho	NPCSG00
Santo Aleixo	NPCSG00
Santo Aleixo da Restauração	NPCSG00
Santo Aleixo de Além-Tâmega	NPCSG00
Santo Amador	NPCSG00
Santo Amaro	NPCSG00
Santo André	NPCSG00
Santo André das Tojeiras	NPCSG00
Santo André de Poiares	NPCSG00
Santo André de Vagos	NPCSG00
Santo Antão	NPCSG00
Santo Antão do Tojal	NPCSG00
Santo António	NPCSG00
Santo António da Charneca	NPCSG00
Santo António da Serra	NPCSG00
Santo António das Areias	NPCSG00
Santo António de Monforte	NPCSG00
Santo António de Nordestinho	NPCSG00
Santo António de Vagos	NPCSG00
Santo António dos Cavaleiros	NPCSG00
Santo António dos Olivais	NPCSG00
Santo Condestável	NPCSG00
Santo Emilião	NPCSG00
Santo Espírito	NPCSG00
Santo Estêvão	NPCSG00
Santo Estêvão das Galés	NPCSG00
Santo Estêvão de Barrosas	NPCSG00
Santo Estêvão de Bastuço	NPCSG00
Santo Estêvão de Briteiros	NPCSG00
Santo Estêvão do Penso	NPCSG00
Santo Ildefonso	NPCSG00
Santo Isidoro	NPCSG00
Santo Isidro de Pegões	NPCSG00
Santo Onofre	NPCSG00
Santo Quintino	NPCSG00
Santo Tirso	NPCSG00
Santo Tirso de Prazins	NPCSG00
Santo Varão	NPCSG00
Santos Evos	NPCSG00
São Barnabé	NPCSG00
São Bartolomeu	NPCSG00
São Bartolomeu da Serra	NPCSG00
São Bartolomeu de Messines	NPCSG00
São Bartolomeu do Outeiro	NPCSG00
São Bartolomeu dos Galegos	NPCSG00
São Bartolomeu dos Regatos	NPCSG00
São Bento	NPCSG00
São Bento de Ana Loura	NPCSG00
São Bento do Ameixial	NPCSG00
São Bento do Cortiço	NPCSG00
São Bento do Mato	NPCSG00
São Bernardo	NPCSG00
São Brás	NPCSG00
São Brás dos Matos	NPCSG00
São Brás e São Lourenço	NPCSG00
São Brissos	NPCSG00
São Caetano	NPCSG00
São Cipriano	NPCSG00
São Clemente	NPCSG00
São Clemente de Basto	NPCSG00
São Clemente de Sande	NPCSG00
São Clemente de Silvares	NPCSG00
São Cosmado	NPCSG00
São Cosme	NPCSG00
São Cosme do Vale	NPCSG00
São Cosme e São Damião	NPCSG00
São Cristóvão	NPCSG00
São Cristóvão de Lafões	NPCSG00
São Cristóvão de Nogueira	NPCSG00
São Cristóvão de Selho	NPCSG00
São Cristóvão do Douro	NPCSG00
São Cristóvão e São Lourenço	NPCSG00
São Dinis	NPCSG00
São Domingos	NPCSG00
São Domingos de Ana Loura	NPCSG00
São Domingos de Benfica	NPCSG00
São Domingos de Rana	NPCSG00
São Facundo	NPCSG00
São Faustino	NPCSG00
São Félix	NPCSG00
São Félix da Marinha	NPCSG00
São Francisco	NPCSG00
São Francisco da Serra	NPCSG00
São Francisco Xavier	NPCSG00
São Gens	NPCSG00
São Gião	NPCSG00
São Gonçalo	NPCSG00
São Gregório	NPCSG00
São Jacinto	NPCSG00
São Joaninho	NPCSG00
São João	NPCSG00
São João Baptista	NPCSG00
São João Baptista de Airão	NPCSG00
São João Baptista de Lobrigos	NPCSG00
São João Baptista de Vila Chã	NPCSG00
São João da Boa Vista	NPCSG00
São João da Corveira	NPCSG00
São João da Fresta	NPCSG00
São João da Madeira	NPCSG00
São João da Pesqueira	NPCSG00
São João da Ribeira	NPCSG00
São João da Serra	NPCSG00
São João da Talha	NPCSG00
São João das Lampas	NPCSG00
São João de Areias	NPCSG00
São João de Bastuço	NPCSG00
São João de Brito	NPCSG00
São João de Caldas de Vizela	NPCSG00
São João de Deus	NPCSG00
São João de Fontoura	NPCSG00
São João de Loure	NPCSG00
São João de Lourosa	NPCSG00
São João de Negrilhos	NPCSG00
São João de Ovar	NPCSG00
São João de Rei	NPCSG00
São João de Tarouca	NPCSG00
São João de Ver	NPCSG00
São João do Campo	NPCSG00
São João do Monte	NPCSG00
São João do Peso	NPCSG00
São João do Souto	NPCSG00
São João dos Caldeireiros	NPCSG00
São João dos Montes	NPCSG00
São Jomil	NPCSG00
São Jorge	NPCSG00
São Jorge da Beira	NPCSG00
São Jorge de Arroios	NPCSG00
São Jorge de Selho	NPCSG00
São Jorge de Vizela	NPCSG00
São José	NPCSG00
São José da Lamarosa	NPCSG00
São José de São Lázaro	NPCSG00
São Julião	NPCSG00
São Julião da Figueira da Foz	NPCSG00
São Julião de Montenegro	NPCSG00
São Julião de Palácios	NPCSG00
São Julião do Tojal	NPCSG00
São Julião dos Passos	NPCSG00
São Lourenço	NPCSG00
São Lourenço de Mamporcão	NPCSG00
São Lourenço de Ribapinhão	NPCSG00
São Lourenço de Sande	NPCSG00
São Lourenço de Selho	NPCSG00
São Lourenço de Touvedo	NPCSG00
São Lourenço do Bairro	NPCSG00
São Lourenço do Douro	NPCSG00
São Luís	NPCSG00
São Mamede	NPCSG00
São Mamede de Coronado	NPCSG00
São Mamede de Escariz	NPCSG00
São Mamede de Este	NPCSG00
São Mamede de Infesta	NPCSG00
São Mamede de Negrelos	NPCSG00
São Mamede de Recezinhos	NPCSG00
São Mamede de Ribatua	NPCSG00
São Manços	NPCSG00
São Marcos	NPCSG00
São Marcos da Ataboeira	NPCSG00
São Marcos da Serra	NPCSG00
São Martinho	NPCSG00
São Martinho da Cortiça	NPCSG00
São Martinho da Gândara	NPCSG00
São Martinho das Amoreiras	NPCSG00
São Martinho das Chãs	NPCSG00
São Martinho das Moitas	NPCSG00
São Martinho de Alvito	NPCSG00
São Martinho de Angueira	NPCSG00
São Martinho de Anta	NPCSG00
São Martinho de Árvore	NPCSG00
São Martinho de Bougado	NPCSG00
São Martinho de Candoso	NPCSG00
São Martinho de Escariz	NPCSG00
São Martinho de Mouros	NPCSG00
São Martinho de Recezinhos	NPCSG00
São Martinho de Sande	NPCSG00
São Martinho de Sardoura	NPCSG00
São Martinho de Silvares	NPCSG00
São Martinho de Valbom	NPCSG00
São Martinho de Vila Frescaínha	NPCSG00
São Martinho do Bispo	NPCSG00
São Martinho do Campo	NPCSG00
São Martinho do Peso	NPCSG00
São Martinho do Porto	NPCSG00
São Martinho do Vale	NPCSG00
São Mateus	NPCSG00
São Mateus da Calheta	NPCSG00
São Mateus de Oliveira	NPCSG00
São Matias	NPCSG00
São Miguel	NPCSG00
São Miguel da Guarda	NPCSG00
São Miguel de Acha	NPCSG00
São Miguel de Alcainça	NPCSG00
São Miguel de Caldas de Vizela	NPCSG00
São Miguel de Carreiras	NPCSG00
São Miguel de Lobrigos	NPCSG00
São Miguel de Lousada	NPCSG00
São Miguel de Machede	NPCSG00
São Miguel de Oriz	NPCSG00
São Miguel de Paredes	NPCSG00
São Miguel de Poiares	NPCSG00
São Miguel de Seide	NPCSG00
São Miguel de Vila Boa	NPCSG00
São Miguel do Couto	NPCSG00
São Miguel do Jarmelo	NPCSG00
São Miguel do Mato	NPCSG00
São Miguel do Outeiro	NPCSG00
São Miguel do Pinheiro	NPCSG00
São Miguel do Prado	NPCSG00
São Miguel do Rio Torto	NPCSG00
São Nicolau	NPCSG00
São Paio	NPCSG00
São Paio de Gramaços	NPCSG00
São Paio de Jolda	NPCSG00
São Paio de Merelim	NPCSG00
São Paio de Oleiros	NPCSG00
São Paio de Seide	NPCSG00
São Paio de Vizela	NPCSG00
São Paio do Mondego	NPCSG00
São Paulo	NPCSG00
São Paulo de Frades	NPCSG00
São Pedro	NPCSG00
São Pedro da Afurada	NPCSG00
São Pedro da Cadeira	NPCSG00
São Pedro da Cova	NPCSG00
São Pedro da Torre	NPCSG00
São Pedro de Agostém	NPCSG00
São Pedro de Alva	NPCSG00
São Pedro de Alvito	NPCSG00
São Pedro de Avioso	NPCSG00
São Pedro de Castelões	NPCSG00
São Pedro de Este	NPCSG00
São Pedro de France	NPCSG00
São Pedro de Gafanhoeira	NPCSG00
São Pedro de Merelim	NPCSG00
São Pedro de Nordestinho	NPCSG00
São Pedro de Oliveira	NPCSG00
São Pedro de Penaferrim	NPCSG00
São Pedro de Rio Seco	NPCSG00
São Pedro de Sarracenos	NPCSG00
São Pedro de Solis	NPCSG00
São Pedro de Tomar	NPCSG00
São Pedro de Vade	NPCSG00
São Pedro de Valbom	NPCSG00
São Pedro de Veiga de Lila	NPCSG00
São Pedro de Vila Frescaínha	NPCSG00
São Pedro do Esteval	NPCSG00
São Pedro do Jarmelo	NPCSG00
São Pedro do Sul	NPCSG00
São Pedro e Santiago	NPCSG00
São Pedro Fins	NPCSG00
São Pedro Velho	NPCSG00
São Romão	NPCSG00
São Romão de Aregos	NPCSG00
São Romão de Arões	NPCSG00
São Romão do Coronado	NPCSG00
São Roque	NPCSG00
São Roque do Faial	NPCSG00
São Roque do Pico	NPCSG00
São Salvador	NPCSG00
São Salvador da Aramenha	NPCSG00
São Salvador de Lordelo	NPCSG00
São Salvador de Souto	NPCSG00
São Salvador de Viveiro	NPCSG00
São Salvador do Campo	NPCSG00
São Saturnino	NPCSG00
São Sebastião	NPCSG00
São Sebastião da Feira	NPCSG00
São Sebastião da Giesteira	NPCSG00
São Sebastião da Pedreira	NPCSG00
São Sebastião dos Carros	NPCSG00
São Silvestre	NPCSG00
São Simão	NPCSG00
São Simão de Gouveia	NPCSG00
São Simão de Litém	NPCSG00
São Teotónio	NPCSG00
São Tomé de Abação	NPCSG00
São Tomé de Covelas	NPCSG00
São Tomé de Negrelos	NPCSG00
São Tomé de Vade	NPCSG00
São Tomé do Castelo	NPCSG00
São Torcato	NPCSG00
São Vicente	NPCSG00
São Vicente da Beira	NPCSG00
São Vicente de Aljubarrota	NPCSG00
São Vicente de Fora	NPCSG00
São Vicente de Lafões	NPCSG00
São Vicente de Pereira Jusã	NPCSG00
São Vicente de Távora	NPCSG00
São Vicente do Paul	NPCSG00
São Vicente do Penso	NPCSG00
São Vicente do Pigeiro	NPCSG00
São Vicente e Ventosa	NPCSG00
São Vicente Ferreira	NPCSG00
São Victor	NPCSG00
Sarilhos Grandes	NPCSG00
Sarilhos Pequenos	NPCSG00
Sarnadas de Ródão	NPCSG00
Sarnadas de São Simão	NPCSG00
Sazes da Beira	NPCSG00
Sazes do Lorvão	NPCSG00
Sé e São Pedro	NPCSG00
Sé Nova	NPCSG00
Seara Velha	NPCSG00
Sebadelhe da Serra	NPCSG00
Seixo Amarelo	NPCSG00
Seixo da Beira	NPCSG00
Seixo de Ansiães	NPCSG00
Seixo de Gatões	NPCSG00
Seixo de Manhoses	NPCSG00
Seixo do Côa	NPCSG00
Sendim da Ribeira	NPCSG00
Sendim da Serra	NPCSG00
Senhora da Graça de Padrões	NPCSG00
Senhora da Hora	NPCSG00
Senhora da Saúde	NPCSG00
Serra d'El-Rei	NPCSG00
Serra de Água	NPCSG00
Serra de Santo António	NPCSG00
Serra do Bouro	NPCSG00
Serro Ventoso	NPCSG00
Sete Cidades	NPCSG00
Sever do Vouga	NPCSG00
Silvã de Cima	NPCSG00
Silva Escura	NPCSG00
Sobradelo da Goma	NPCSG00
Sobral da Abelheira	NPCSG00
Sobral da Adiça	NPCSG00
Sobral da Lagoa	NPCSG00
Sobral da Serra	NPCSG00
Sobral de Monte Agraço	NPCSG00
Sobral de São Miguel	NPCSG00
Sobral do Campo	NPCSG00
Sobral Pichorro	NPCSG00
Sobreira Formosa	NPCSG00
Sobreiró de Baixo	NPCSG00
Souro Pires	NPCSG00
Soutelinho da Raia	NPCSG00
Soutelo de Aguiar	NPCSG00
Soutelo do Douro	NPCSG00
Soutelo Mourisco	NPCSG00
Souto da Carpalhosa	NPCSG00
Souto da Casa	NPCSG00
Souto da Velha	NPCSG00
Souto de Aguiar da Beira	NPCSG00
Souto de Lafões	NPCSG00
Souto de Rebordões	NPCSG00
Souto Maior	NPCSG00
Tamel S. Pedro Fins	NPCSG00
Tamel S. Veríssimo	NPCSG00
Tamel Santa Leocádia	NPCSG00
Terra Chã	NPCSG00
Terras de Bouro	NPCSG00
Torre de Coelheiros	NPCSG00
Torre de Dona Chama	NPCSG00
Torre de Moncorvo	NPCSG00
Torre de Vale de Todos	NPCSG00
Torre de Vilela	NPCSG00
Torre do Pinhão	NPCSG00
Torre do Terrenho	NPCSG00
Torres do Mondego	NPCSG00
Torres Novas	NPCSG00
Torres Vedras	NPCSG00
Travanca de Lagos	NPCSG00
Travanca de Tavares	NPCSG00
Travanca do Mondego	NPCSG00
Unhais da Serra	NPCSG00
Val de Torno	NPCSG00
Valado dos Frades	NPCSG00
Vale Benfeito	NPCSG00
Vale Covo	NPCSG00
Vale da Amoreira	NPCSG00
Vale da Madre	NPCSG00
Vale da Mula	NPCSG00
Vale da Pedra	NPCSG00
Vale da Pinta	NPCSG00
Vale da Porca	NPCSG00
Vale da Senhora da Póvoa	NPCSG00
Vale das Éguas	NPCSG00
Vale das Fontes	NPCSG00
Vale das Mós	NPCSG00
Vale de Açor	NPCSG00
Vale de Água	NPCSG00
Vale de Alfonsinho	NPCSG00
Vale de Amoreira	NPCSG00
Vale de Anta	NPCSG00
Vale de Asnes	NPCSG00
Vale de Azares	NPCSG00
Vale de Bouro	NPCSG00
Vale de Cambra	NPCSG00
Vale de Cavalos	NPCSG00
Vale de Coelha	NPCSG00
Vale de Espinho	NPCSG00
Vale de Estrela	NPCSG00
Vale de Figueira	NPCSG00
Vale de Frades	NPCSG00
Vale de Gouvinhas	NPCSG00
Vale de Janeiro	NPCSG00
Vale de Madeira	NPCSG00
Vale de Mendiz	NPCSG00
Vale de Nogueiras	NPCSG00
Vale de Porco	NPCSG00
Vale de Prados	NPCSG00
Vale de Prazeres	NPCSG00
Vale de Remígio	NPCSG00
Vale de Salgueiro	NPCSG00
Vale de Santarém	NPCSG00
Vale de Santiago	NPCSG00
Vale de Telhas	NPCSG00
Vale de Vargo	NPCSG00
Vale do Paraíso	NPCSG00
Vale do Peso	NPCSG00
Vale do Seixo	NPCSG00
Vale Flor	NPCSG00
Vale Formoso	NPCSG00
Vale Frechoso	NPCSG00
Vale Longo	NPCSG00
Vale Pereiro	NPCSG00
Vale Verde	NPCSG00
Valença do Douro	NPCSG00
Vales do Rio	NPCSG00
Valongo de Milhais	NPCSG00
Valongo do Vouga	NPCSG00
Valongo dos Azeites	NPCSG00
Várzea Cova	NPCSG00
Várzea da Ovelha e Aliviada	NPCSG00
Várzea da Serra	NPCSG00
Várzea de Abrunhais	NPCSG00
Várzea de Meruge	NPCSG00
Várzea de Tavares	NPCSG00
Várzea de Trevões	NPCSG00
Várzea do Douro	NPCSG00
Várzea dos Cavaleiros	NPCSG00
Veiga de Lila	NPCSG00
Venda do Pinheiro	NPCSG00
Venda Nova	NPCSG00
Vendas Novas	NPCSG00
Ventosa do Bairro	NPCSG00
Vera Cruz	NPCSG00
Viade de Baixo	NPCSG00
Viana do Alentejo	NPCSG00
Viana do Castelo	NPCSG00
Vide Entre Vinhas	NPCSG00
Vieira de Leiria	NPCSG00
Vieira do Minho	NPCSG00
Vil de Matos	NPCSG00
Vil de Souto	NPCSG00
Vila Alva	NPCSG00
Vila Boa	NPCSG00
Vila Boa de Ousilhão	NPCSG00
Vila Boa de Quires	NPCSG00
Vila Boa do Bispo	NPCSG00
Vila Boa do Mondego	NPCSG00
Vila Boim	NPCSG00
Vila Cã	NPCSG00
Vila Caiz	NPCSG00
Vila Chã	NPCSG00
Vila Chã da Beira	NPCSG00
Vila Chã de Braciosa	NPCSG00
Vila Chã de Ourique	NPCSG00
Vila Chã de Sá	NPCSG00
Vila Chã do Marão	NPCSG00
Vila Cortês da Serra	NPCSG00
Vila Cortês do Mondego	NPCSG00
Vila Cova	NPCSG00
Vila Cova à Coelheira	NPCSG00
Vila Cova da Lixa	NPCSG00
Vila Cova de Alva	NPCSG00
Vila Cova de Carros	NPCSG00
Vila Cova de Perrinho	NPCSG00
Vila Cova do Covelo	NPCSG00
Vila da Ponte	NPCSG00
Vila das Aves	NPCSG00
Vila de Ala	NPCSG00
Vila de Frades	NPCSG00
Vila de Prado	NPCSG00
Vila de Punhe	NPCSG00
Vila de Rei	NPCSG00
Vila de São Sebastião	NPCSG00
Vila do Bispo	NPCSG00
Vila do Carvalho	NPCSG00
Vila do Conde	NPCSG00
Vila do Porto	NPCSG00
Vila do Topo	NPCSG00
Vila do Touro	NPCSG00
Vila Facaia	NPCSG00
Vila Fernando	NPCSG00
Vila Flor	NPCSG00
Vila Fonche	NPCSG00
Vila Franca da Beira	NPCSG00
Vila Franca da Serra	NPCSG00
Vila Franca das Naves	NPCSG00
Vila Franca de Xira	NPCSG00
Vila Franca do Deão	NPCSG00
Vila Franca do Rosário	NPCSG00
Vila Fria	NPCSG00
Vila Garcia	NPCSG00
Vila Jusã	NPCSG00
Vila Longa	NPCSG00
Vila Maior	NPCSG00
Vila Marim	NPCSG00
Vila Meã	NPCSG00
Vila Moreira	NPCSG00
Vila Mou	NPCSG00
Vila Nova	NPCSG00
Vila Nova da Barca	NPCSG00
Vila Nova da Baronia	NPCSG00
Vila Nova da Barquinha	NPCSG00
Vila Nova da Muía	NPCSG00
Vila Nova da Rainha	NPCSG00
Vila Nova da Telha	NPCSG00
Vila Nova de Anços	NPCSG00
Vila Nova de Cacela	NPCSG00
Vila Nova de Cerveira	NPCSG00
Vila Nova de Famalicão	NPCSG00
Vila Nova de Foz Côa	NPCSG00
Vila Nova de Gaia	NPCSG00
Vila Nova de Milfontes	NPCSG00
Vila Nova de Monsarros	NPCSG00
Vila Nova de Oliveirinha	NPCSG00
Vila Nova de Paiva	NPCSG00
Vila Nova de Sande	NPCSG00
Vila Nova de Santo André	NPCSG00
Vila Nova de São Bento	NPCSG00
Vila Nova de São Pedro	NPCSG00
Vila Nova de Souto d'El-Rei	NPCSG00
Vila Nova de Tazem	NPCSG00
Vila Nova do Ceira	NPCSG00
Vila Nune	NPCSG00
Vila Pouca da Beira	NPCSG00
Vila Pouca de Aguiar	NPCSG00
Vila Praia de Âncora	NPCSG00
Vila Real	NPCSG00
Vila Real de Santo António	NPCSG00
Vila Ruiva	NPCSG00
Vila Seca	NPCSG00
Vila Soeiro	NPCSG00
Vila Soeiro do Chão	NPCSG00
Vila Velha de Ródão	NPCSG00
Vila Verde	NPCSG00
Vila Verde da Raia	NPCSG00
Vila Verde de Ficalho	NPCSG00
Vila Verde dos Francos	NPCSG00
Vila Viçosa	NPCSG00
Vilar Barroco	NPCSG00
Vilar Chão	NPCSG00
Vilar da Veiga	NPCSG00
Vilar das Almas	NPCSG00
Vilar de Amargo	NPCSG00
Vilar de Andorinho	NPCSG00
Vilar de Besteiros	NPCSG00
Vilar de Cunhas	NPCSG00
Vilar de Ferreiros	NPCSG00
Vilar de Figos	NPCSG00
Vilar de Lomba	NPCSG00
Vilar de Maçada	NPCSG00
Vilar de Mouros	NPCSG00
Vilar de Murteda	NPCSG00
Vilar de Nantes	NPCSG00
Vilar de Ossos	NPCSG00
Vilar de Perdizes	NPCSG00
Vilar de Peregrinos	NPCSG00
Vilar de Rei	NPCSG00
Vilar do Monte	NPCSG00
Vilar do Paraíso	NPCSG00
Vilar do Pinheiro	NPCSG00
Vilar do Torno e Alentém	NPCSG00
Vilar Formoso	NPCSG00
Vilar Maior	NPCSG00
Vilar Seco	NPCSG00
Vilar Seco de Lomba	NPCSG00
Vilar Torpim	NPCSG00
Vilarelho da Raia	NPCSG00
Vilares de Vilariça	NPCSG00
Vilarinho da Castanheira	NPCSG00
Vilarinho das Azenhas	NPCSG00
Vilarinho das Cambas	NPCSG00
Vilarinho das Paranheiras	NPCSG00
Vilarinho de Agrochão	NPCSG00
Vilarinho de Cotas	NPCSG00
Vilarinho de Samardã	NPCSG00
Vilarinho de São Romão	NPCSG00
Vilarinho do Bairro	NPCSG00
Vilarinho do Monte	NPCSG00
Vilarinho dos Freires	NPCSG00
Vilarinho dos Galegos	NPCSG00
Vilas Boas	NPCSG00
Vilela do Tâmega	NPCSG00
Vilela Seca	NPCSG00
Vinha da Rainha	NPCSG00
Vitorino das Donas	NPCSG00
Vitorino dos Piães	NPCSG00
Vreia de Bornes	NPCSG00
Vreia de Jales	NPCSG00
Zambujeira do Mar	NPCSG00
