# A part-of-speech dictionary that's used additionally to the binary dictionary (*.dict).
# This does not add words to the spell checker, see hunspell/spelling.txt for that.
# File Encoding: UTF-8
# Format: three tab-separated fields: fullform baseform postags
КП(б)У	КП(б)У	noun:inanim:f:nv:prop:abbr
ВКП(б)	ВКП(б)	noun:inanim:f:nv:prop:abbr
СДПУ(о)	СДПУ(о)	noun:inanim:f:nv:prop:abbr
СДПУ(О)	СДПУ(О)	noun:inanim:f:nv:prop:abbr
РКП(б)	РКП(б)	noun:inanim:f:nv:prop:abbr
УКП(б)	УКП(б)	noun:inanim:f:nv:prop:abbr
ОУН(б)	ОУН(б)	noun:inanim:f:nv:prop:abbr
ОУН(Б)	ОУН(Б)	noun:inanim:f:nv:prop:abbr
ОУН(м)	ОУН(м)	noun:inanim:f:nv:prop:abbr
ОУН(М)	ОУН(М)	noun:inanim:f:nv:prop:abbr
ОУН(р)	ОУН(р)	noun:inanim:f:nv:prop:abbr
П(С)БО	П(С)БО	noun:inanim:n:nv:np:prop:abbr
Л/ДНР	Л/ДНР	noun:inanim:f:nv:prop:geo:abbr
РСДРП(б)	РСДРП(б)	noun:inanim:f:nv:prop:abbr
Роттердам+	Роттердам+	noninfl
KFOR	KFOR	noun:inanim:m:nv:prop:foreign
WBC	WBC	noun:inanim:m:nv:prop:foreign
WBA	WBA	noun:inanim:m:nv:prop:foreign
Гоголь-fest	Гоголь-fest	noun:inanim:m:nv:prop
Хуйло	Хуйло	noun:anim:m:v_naz:prop:fname:vulg
Хуйла	Хуйло	noun:anim:m:v_rod:prop:fname:vulg
Хуйлові	Хуйло	noun:anim:m:v_dav:prop:fname:vulg
Хуйлу	Хуйло	noun:anim:m:v_dav:prop:fname:vulg
Хуйла	Хуйло	noun:anim:m:v_zna:prop:fname:vulg
Хуйлом	Хуйло	noun:anim:m:v_oru:prop:fname:vulg
Хуйлі	Хуйло	noun:anim:m:v_mis:prop:fname:vulg
Хуйлові	Хуйло	noun:anim:m:v_mis:prop:fname:vulg
Хуйлу	Хуйло	noun:anim:m:v_mis:prop:fname:vulg
Хуйле	Хуйло	noun:anim:m:v_kly:prop:fname:vulg
вуса	вус	noun:inanim:p:v_zna
