# Ukrainian multiwords file used for chunking
# FR  frazeologism
#
до мажор	noun:m:nv
до минор	noun:m:nv
н. е.	noun
Пальма де Мальорка	noun:f:nv
да Вінчі	noun:m:nv
КП(б)У	noun:f:nv
#
до упаду	adv
до впаду	adv
для годиться	adv
значною мірою	adv
за дякую	adv
на дурняк	adv
значною мірою	adv
без перестанку	adv
де можна	adv
де тільки можна	adv
поміж люди	adv
