Heb je tenminste=Dan heb je tenminste|Nu heb je tenminste|Zo heb je tenminste|Daar heb je tenminste|Hier heb je tenminste	Maak hier liever een volzin van, dat leest gemakkelijker.
Is een kwestie van=Het is een kwestie van|Dat is een kwestie van|Dit is een kwestie van	Maak hier liever een volzin van, dat leest gemakkelijker.
Kan me voorstellen dat je er=Ik kan me voorstellen dat je er	Maak hier liever een volzin van, dat leest gemakkelijker.
Weer eens wat anders dan de=Dat is weer eens wat anders dan de	Maak hier liever een volzin van, dat leest gemakkelijker.
Op de hoogte blijven van al=Wilt u op de hoogte blijven van al	Maak hier liever een volzin van, dat leest gemakkelijker.
Goed om te lezen dat het=Het is goed om te lezen dat het	Maak hier liever een volzin van, dat leest gemakkelijker.
Voor het laatst bijgewerkt op=Dit is voor het laatst bijgewerkt op	Maak hier liever een volzin van, dat leest gemakkelijker.
Veel leuke reacties op gehad=Ik heb er veel leuke reacties op gehad|Ik heb hier veel leuke reacties op gehad	Maak hier liever een volzin van, dat leest gemakkelijker.
Een mooie afsluiter van een=Het was een mooie afsluiter van een	Maak hier liever een volzin van, dat leest gemakkelijker.
Een echte aanrader voor een=Het is een echte aanrader voor een	Maak hier liever een volzin van, dat leest gemakkelijker.
Kan me voorstellen dat dat=Ik kan me voorstellen dat dat|Maar ik kan me voorstellen dat dat	Maak hier liever een volzin van, dat leest gemakkelijker.
Iemand enig idee waar ik=Heeft iemand enig idee waar ik	Maak hier liever een volzin van, dat leest gemakkelijker.
Ligt ook een beetje aan=Het ligt ook een beetje aan	Maak hier liever een volzin van, dat leest gemakkelijker.
Al eens gedacht aan een=Heb je al eens gedacht aan een	Maak hier liever een volzin van, dat leest gemakkelijker.
Goed voor het milieu en=Dat is goed voor het milieu en|Dit is goed voor het milieu en	Maak hier liever een volzin van, dat leest gemakkelijker.
Jammer dat er niet meer=Het is jammer dat er niet meer	Maak hier liever een volzin van, dat leest gemakkelijker.
Iemand een idee waar ik=Heeft iemand een idee waar ik	Maak hier liever een volzin van, dat leest gemakkelijker.
Alles tot in de puntjes=Alles was tot in de puntjes|Alles is tot in de puntjes	Maak hier liever een volzin van, dat leest gemakkelijker.
Nog even terug naar het=Ik wil nog even terug naar het|Ik ga nog even terug naar het|We gaan nog even terug naar het|Ik keer nog even terug naar het	Maak hier liever een volzin van, dat leest gemakkelijker.
Leuk om naar te kijken=Het is leuk om naar te kijken	Maak hier liever een volzin van, dat leest gemakkelijker.
Altijd op zoek naar de=Ik ben altijd op zoek naar de|Wij zijn altijd op zoek naar de|Hij is altijd op zoek naar de	Maak hier liever een volzin van, dat leest gemakkelijker.
Ideaal om mee te nemen=Het is ideaal om mee te nemen	Maak hier liever een volzin van, dat leest gemakkelijker.
Goed te horen dat het=Het is goed om te horen dat het	Maak hier liever een volzin van, dat leest gemakkelijker.
Fijn te lezen dat je=Wat fijn te lezen dat je	Maak hier liever een volzin van, dat leest gemakkelijker.
Ben blij dat ik niet=Ik ben blij dat ik niet	Maak hier liever een volzin van, dat leest gemakkelijker.
Goed te horen dat je=Het is goed te horen dat je	Maak hier liever een volzin van, dat leest gemakkelijker.
Kijk nu al uit naar=Ik kijk nu al uit naar	Maak hier liever een volzin van, dat leest gemakkelijker.
Erg leuk om te doen=Het was erg leuk om te doen|Het is erg leuk om te doen	Maak hier liever een volzin van, dat leest gemakkelijker.
Leuk om te zien wat=Het is leuk om te zien wat	Maak hier liever een volzin van, dat leest gemakkelijker.
Vraag me af of het=Ik vraag me af of het	Maak hier liever een volzin van, dat leest gemakkelijker.
Bereikbaar op werkdagen van=Wij zijn bereikbaar op werkdagen van	Maak hier liever een volzin van, dat leest gemakkelijker.
Makkelijk schoon te maken=Hij is makkelijk schoon te maken|Het is makkelijk schoon te maken	Maak hier liever een volzin van, dat leest gemakkelijker.
Binnenkort maar weer eens=Ik zal binnenkort maar weer eens	Maak hier liever een volzin van, dat leest gemakkelijker.
Nieuwsgierig naar wat uw=Bent u nieuwsgierig naar wat uw	Maak hier liever een volzin van, dat leest gemakkelijker.
Iemand ervaring met het=Heeft iemand ervaring met het	Maak hier liever een volzin van, dat leest gemakkelijker.
Zeer goed bestand tegen=Ze zijn zeer goed bestand tegen	Maak hier liever een volzin van, dat leest gemakkelijker.
Ben benieuwd hoe jullie=Ik ben benieuwd hoe jullie	Maak hier liever een volzin van, dat leest gemakkelijker.
Hieronder de foto's van=Hieronder vind je de foto's van|Hieronder staan de foto's van	Maak hier liever een volzin van, dat leest gemakkelijker.
Nooit van gehoord, maar=Ik had er nooit van gehoord, maar|Ik heb er nooit van gehoord, maar	Maak hier liever een volzin van, dat leest gemakkelijker.
Ben benieuwd of jullie=Ik ben benieuwd of jullie	Maak hier liever een volzin van, dat leest gemakkelijker.
Kwaliteit van het eten=De kwaliteit van het eten	Maak hier liever een volzin van, dat leest gemakkelijker.
Zeer tevreden over het=Ik ben zeer tevreden over het|We zijn zeer tevreden over het|Wij zijn zeer tevreden over het|Wij waren zeer tevreden over het	Maak hier liever een volzin van, dat leest gemakkelijker.
Allemaal dingen die ik=Dat zijn allemaal dingen die ik	Maak hier liever een volzin van, dat leest gemakkelijker.
De ideale locatie voor=Het is de ideale locatie voor	Maak hier liever een volzin van, dat leest gemakkelijker.
Benieuwd wat wij voor=We zijn benieuwd wat wij voor||Ik ben benieuwd wat wij voor|Bent u benieuwd wat wij voor|Ben je benieuwd wat wij voor	Maak hier liever een volzin van, dat leest gemakkelijker.
Nergens voor nodig om=Het is nergens voor nodig om|Het was nergens voor nodig om	Maak hier liever een volzin van, dat leest gemakkelijker.
Benieuwd naar wat wij=Bent u benieuwd naar wat wij	Maak hier liever een volzin van, dat leest gemakkelijker.
Alweer de laatste dag=Het is alweer de laatste dag|Vandaag is het alweer de laatste dag	Maak hier liever een volzin van, dat leest gemakkelijker.
Nog nooit van gehoord=Daar heb ik nog nooit van gehoord|Ik heb er nog nooit van gehoord|Ik had er nog nooit van gehoord|Had er nog nooit van gehoord|Daar had ik nog nooit van gehoord|Ik heb hier nog nooit van gehoord|Ik had hier nog nooit van gehoord	Maak hier liever een volzin van, dat leest gemakkelijker.
Ben erg benieuwd naar=Ik ben erg benieuwd naar	Maak hier liever een volzin van, dat leest gemakkelijker.
Waarom kiezen voor de=Waarom zou je kiezen voor de	Maak hier liever een volzin van, dat leest gemakkelijker.
Vandaag weer eens een=Ik heb vandaag weer eens een	Maak hier liever een volzin van, dat leest gemakkelijker.
Nergens een spoor van=Er was nergens een spoor van	Maak hier liever een volzin van, dat leest gemakkelijker.
Ziet er allemaal heel=Het ziet er allemaal heel	Maak hier liever een volzin van, dat leest gemakkelijker.
Ben ook heel benieuwd=Ik ben ook heel benieuwd	Maak hier liever een volzin van, dat leest gemakkelijker.
Altijd nog beter dan=Dat is altijd nog beter dan|Het is altijd nog beter dan	Maak hier liever een volzin van, dat leest gemakkelijker.
Kan me niet schelen,=Het kan me niet schelen,|Dat kan me niet schelen,	Maak hier liever een volzin van, dat leest gemakkelijker.
Precies op tijd voor=Je bent precies op tijd voor|Dat is precies op tijd voor	Maak hier liever een volzin van, dat leest gemakkelijker.
Eerst maar eens naar=Ik ga eerst maar eens naar	Maak hier liever een volzin van, dat leest gemakkelijker.
Hangt een beetje van=Het hangt een beetje van	Maak hier liever een volzin van, dat leest gemakkelijker.
Jammer dat het maar=Alleen jammer dat het maar|Het is jammer dat het maar	Maak hier liever een volzin van, dat leest gemakkelijker.
Hangt een beetje af=Dat hangt een beetje af|Het hangt een beetje af	Maak hier liever een volzin van, dat leest gemakkelijker.
Voor het eerst weer=We hebben voor het eerst weer|Ik heb voor het eerst weer	Maak hier liever een volzin van, dat leest gemakkelijker.
Hoop dat jullie een=Ik hoop dat jullie een	Maak hier liever een volzin van, dat leest gemakkelijker.
Ligt ook een beetje=Het ligt ook een beetje	Maak hier liever een volzin van, dat leest gemakkelijker.
Maakt niet uit, als=Het maakt niet uit, als	Maak hier liever een volzin van, dat leest gemakkelijker.
Jammer dat hij geen=Het is jammer dat hij geen|Het was jammer dat hij geen	Maak hier liever een volzin van, dat leest gemakkelijker.
Zeer aan te bevelen=Het is zeer aan te bevelen	Maak hier liever een volzin van, dat leest gemakkelijker.
Hangt er een beetje=Het hangt er een beetje	Maak hier liever een volzin van, dat leest gemakkelijker.
Lijkt mij een prima=Dat lijkt mij een prima|Het lijkt mij een prima|Dit lijkt mij een prima	Maak hier liever een volzin van, dat leest gemakkelijker.
Ben blij dat jullie=Ik ben blij dat jullie	Maak hier liever een volzin van, dat leest gemakkelijker.
Leuk dat je meedoet=Het is leuk dat je meedoet	Maak hier liever een volzin van, dat leest gemakkelijker.
Jammer dat het geen=Het is jammer dat het geen	Maak hier liever een volzin van, dat leest gemakkelijker.
Een kijkje nemen in=Ook kunt u een kijkje nemen in|U kunt een kijkje nemen in|Ook kun je een kijkje nemen in|Je kunt een kijkje nemen in|Wil je een kijkje nemen in|Wilt u een kijkje nemen in|Je kan een kijkje nemen in|Je kunt ook een kijkje nemen in	Maak hier liever een volzin van, dat leest gemakkelijker.
Maakt niet uit, het=Dat maakt niet uit, het	Maak hier liever een volzin van, dat leest gemakkelijker.
Toch een beetje een=Dat is toch een beetje een|Het is toch een beetje een|Het blijft toch een beetje een	Maak hier liever een volzin van, dat leest gemakkelijker.
Meer te weten komen=Wil je meer te weten komen|Wilt u meer te weten komen|Wil je nog meer te weten komen|Wil u meer te weten komen|Wil jij meer te weten komen	Maak hier liever een volzin van, dat leest gemakkelijker.
Mag toch hopen dat=Ik mag toch hopen dat|Je mag toch hopen dat	Maak hier liever een volzin van, dat leest gemakkelijker.
Een stuk beter dan=Dat is een stuk beter dan|Het is een stuk beter dan|Het was een stuk beter dan|Dat klinkt een stuk beter dan|Het gaat een stuk beter dan|Dat was een stuk beter dan|Het ging een stuk beter dan|Dat werkt een stuk beter dan	Maak hier liever een volzin van, dat leest gemakkelijker.
Erg leuk om jullie=Het is erg leuk om jullie|Ik vind het erg leuk om jullie	Maak hier liever een volzin van, dat leest gemakkelijker.
Geen idee waar dat=Ik heb geen idee waar dat|Ze had geen idee waar dat|Ik had geen idee waar dat	Maak hier liever een volzin van, dat leest gemakkelijker.
Hangt er vanaf wat=Het hangt er vanaf wat	Maak hier liever een volzin van, dat leest gemakkelijker.
Altijd al je eigen=Heb je altijd al je eigen	Maak hier liever een volzin van, dat leest gemakkelijker.
Jammer dat ik mijn=Het is jammer dat ik mijn|Ik vind het jammer dat ik mijn|Wel jammer dat ik mijn	Maak hier liever een volzin van, dat leest gemakkelijker.
Nu alleen nog maar=Het is nu alleen nog maar|Het gaat nu alleen nog maar|Je hoeft nu alleen nog maar|Hij hoefde nu alleen nog maar|Het was nu alleen nog maar|Ik kan nu alleen nog maar|Hij kon nu alleen nog maar|Ik wil nu alleen nog maar|Ik heb nu alleen nog maar	Maak hier liever een volzin van, dat leest gemakkelijker.
Wist niet eens dat=Ik wist niet eens dat|Hij wist niet eens dat	Maak hier liever een volzin van, dat leest gemakkelijker.
Zeker weten dat ik=Ik weet zeker dat ik	Maak hier liever een volzin van, dat leest gemakkelijker.
Klopt, maar dat is=Dat klopt, maar dat is	Maak hier liever een volzin van, dat leest gemakkelijker.
Lijkt me een prima=Dat lijkt me een prima|Het lijkt me een prima|Dit lijkt me een prima	Maak hier liever een volzin van, dat leest gemakkelijker.
Altijd leuk als je=Het is altijd leuk als je|Ik vind het altijd leuk als je	Maak hier liever een volzin van, dat leest gemakkelijker.
Toch nog maar een=Ik heb toch nog maar een	Maak hier liever een volzin van, dat leest gemakkelijker.
Niet aan te raden=Het is niet aan te raden|Dit is niet aan te raden	Maak hier liever een volzin van, dat leest gemakkelijker.
Ziet er goed uit,=Je ziet er goed uit,|Het ziet er goed uit,|Dat ziet er goed uit,|Hij ziet er goed uit,|Ze ziet er goed uit,	Maak hier liever een volzin van, dat leest gemakkelijker.
Leuk om samen met=Het is leuk om samen met|Lijkt het je leuk om samen met|Vind je het leuk om samen met|Ik vind het leuk om samen met|Vind jij het leuk om samen met|Lijkt het jou leuk om samen met|Lijkt het u leuk om samen met|Vindt u het leuk om samen met	Maak hier liever een volzin van, dat leest gemakkelijker.
Een fijne plek om=Het is een fijne plek om|Dit is een fijne plek om	Maak hier liever een volzin van, dat leest gemakkelijker.
Niet genoeg om je=Het is niet genoeg om je	Maak hier liever een volzin van, dat leest gemakkelijker.
Grote kans dat we=Er is een grote kans dat we	Maak hier liever een volzin van, dat leest gemakkelijker.
Geen tijd meer om=Er is geen tijd meer om|Ik heb geen tijd meer om|Ik had geen tijd meer om|Je hebt geen tijd meer om|Er was geen tijd meer om|Hij had geen tijd meer om|Ze had geen tijd meer om	Maak hier liever een volzin van, dat leest gemakkelijker.
Voor die tijd een=Het was voor die tijd een|Dit was voor die tijd een|Dat was voor die tijd een	Maak hier liever een volzin van, dat leest gemakkelijker.
Moet je maar niet=Dan moet je maar niet	Maak hier liever een volzin van, dat leest gemakkelijker.
Wist niet dat het=Ik wist niet dat het|Hij wist niet dat het|Ze wist niet dat het	Maak hier liever een volzin van, dat leest gemakkelijker.
Jammer dat het in=Het is jammer dat het in	Maak hier liever een volzin van, dat leest gemakkelijker.
Lijkt me een goed=Dat lijkt me een goed|Het lijkt me een goed|Dit lijkt me een goed	Maak hier liever een volzin van, dat leest gemakkelijker.
Nog geen idee wat=Ik heb nog geen idee wat|Heb je nog geen idee wat|Ik had nog geen idee wat|Heb jij nog geen idee wat	Maak hier liever een volzin van, dat leest gemakkelijker.
Op zoek naar werk=Ik ben op zoek naar werk|Ben je op zoek naar werk|Bent u op zoek naar werk|Ben jij op zoek naar werk	Maak hier liever een volzin van, dat leest gemakkelijker.
Ben echt blij dat=Ik ben echt blij dat	Maak hier liever een volzin van, dat leest gemakkelijker.
Jammer dat ik dit=Ik vind het jammer dat ik dit	Maak hier liever een volzin van, dat leest gemakkelijker.
Enig idee waar ik=Heb je enig idee waar ik|Heeft iemand enig idee waar ik|Heb jij enig idee waar ik|Hebben jullie enig idee waar ik|Heeft u enig idee waar ik	Maak hier liever een volzin van, dat leest gemakkelijker.
Ben blij voor je=Ik ben blij voor je	Maak hier liever een volzin van, dat leest gemakkelijker.
Altijd al in een=Heb je altijd al in een|Heb jij altijd al in een	Maak hier liever een volzin van, dat leest gemakkelijker.
Heel leuk dat je=Ik vind het heel leuk dat je|Het is heel leuk dat je	Maak hier liever een volzin van, dat leest gemakkelijker.
Wist niet dat ze=Ik wist niet dat ze|Ze wist niet dat ze|Hij wist niet dat ze	Maak hier liever een volzin van, dat leest gemakkelijker.
Lijkt me wel wat=Dat lijkt me wel wat|Het lijkt me wel wat	Maak hier liever een volzin van, dat leest gemakkelijker.
Ooit al eens een=Heb je ooit al eens een|Heeft u ooit al eens een|Ik heb ooit al eens een	Maak hier liever een volzin van, dat leest gemakkelijker.
Leuk dat je onze=Wat is het leuk dat je onze	Maak hier liever een volzin van, dat leest gemakkelijker.
Kijk uit naar je=Ik kijk uit naar je	Maak hier liever een volzin van, dat leest gemakkelijker.
Zal kijken of ik=Ik zal kijken of ik	Maak hier liever een volzin van, dat leest gemakkelijker.
Zin in een leuke=Heb je zin in een leuke|Ik heb zin in een leuke	Maak hier liever een volzin van, dat leest gemakkelijker.
Leuk dat je naar=Wat leuk dat je naar	Maak hier liever een volzin van, dat leest gemakkelijker.
Denk niet dat we=Ik denk niet dat we	Maak hier liever een volzin van, dat leest gemakkelijker.
Leuk om weer wat=Het is leuk om weer wat	Maak hier liever een volzin van, dat leest gemakkelijker.
Wist niet dat er=Ik wist niet dat er|Hij wist niet dat er	Maak hier liever een volzin van, dat leest gemakkelijker.
Ziet er naar uit=Het ziet ernaar uit|Het ziet er naar uit	Maak hier liever een volzin van, dat leest gemakkelijker.
Vind het ook een=Ik vind het ook een	Maak hier liever een volzin van, dat leest gemakkelijker.
Zal wel iets met=Het zal wel iets met	Maak hier liever een volzin van, dat leest gemakkelijker.
Een heel mooi en=Het is een heel mooi en|Het was een heel mooi en	Maak hier liever een volzin van, dat leest gemakkelijker.
Leuk om weer een=Het is leuk om weer een	Maak hier liever een volzin van, dat leest gemakkelijker.
Hoog tijd dat we=Het is hoog tijd dat we|Het werd hoog tijd dat we|Het is dus hoog tijd dat we|Daarom is het hoog tijd dat we|Wordt het niet hoog tijd dat we	Maak hier liever een volzin van, dat leest gemakkelijker.
Geen tijd of zin=IK heb geen tijd of zin|Heb je geen tijd of zin|Heeft u geen tijd of zin	Maak hier liever een volzin van, dat leest gemakkelijker.
In bezit van een=Je bent in bezit van een|Ik ben in bezit van een|Ben je in bezit van een|Bent u in bezit van een|Wij zijn in bezit van een|Ben jij in bezit van een|Hij was in bezit van een	Maak hier liever een volzin van, dat leest gemakkelijker.
Ligt er maar net=Het ligt er maar net	Maak hier liever een volzin van, dat leest gemakkelijker.
Niet iets dat je=Het is niet iets dat je|Dat is niet iets dat je|Dit is niet iets dat je|Het was niet iets dat je	Maak hier liever een volzin van, dat leest gemakkelijker.
wat balen dat je=wat is het balen dat je	Maak hier liever een volzin van, dat leest gemakkelijker.
Maar leuk dat je=Maar het is leuk dat je	Maak hier liever een volzin van, dat leest gemakkelijker.
Fijn dat je toch=Wat is het fijn dat je toch	Maak hier liever een volzin van, dat leest gemakkelijker.
Tijd om te gaan=Het is tijd om te gaan	Maak hier liever een volzin van, dat leest gemakkelijker.
Soms zo erg dat=Het is soms zo erg dat	Maak hier liever een volzin van, dat leest gemakkelijker.
Van plan om een=Ik ben van plan om een|Ik was van plan om een|Bent u van plan om een|Ben je van plan om een|Ik ben niet van plan om een|Wij zijn van plan om een|Hij was van plan om een	Maak hier liever een volzin van, dat leest gemakkelijker.
Leuk als je een=Ik vind het leuk als je een|We vinden het leuk als je een|Het is leuk als je een|Wij vinden het leuk als je een|Het is altijd leuk als je een	Maak hier liever een volzin van, dat leest gemakkelijker.
Ook leuk dat je=Het is ook leuk dat je	Maak hier liever een volzin van, dat leest gemakkelijker.
Hoop dat er nog=Ik hoop dat er nog	Maak hier liever een volzin van, dat leest gemakkelijker.
Denk dat ik dan=Ik denk dat ik dan	Maak hier liever een volzin van, dat leest gemakkelijker.
Zou ik ook niet=Dat zou ik ook niet|Daar zou ik ook niet	Maak hier liever een volzin van, dat leest gemakkelijker.
Hoop dat je nog=Ik hoop dat je nog	Maak hier liever een volzin van, dat leest gemakkelijker.
Leuk om zelf te=Het is leuk om zelf te	Maak hier liever een volzin van, dat leest gemakkelijker.
Zou ik ook doen=Dat zou ik ook doen	Maak hier liever een volzin van, dat leest gemakkelijker.
Tijd om naar de=Het is tijd om naar de|Het was tijd om naar de|Dan is het tijd om naar de|Het werd tijd om naar de|Toen was het tijd om naar de	Maak hier liever een volzin van, dat leest gemakkelijker.
Blij dat ik het=Ik ben blij dat ik het|Ik was blij dat ik het	Maak hier liever een volzin van, dat leest gemakkelijker.
Ben al blij dat=Ik ben al blij dat	Maak hier liever een volzin van, dat leest gemakkelijker.
Lijkt wel of ik=Het lijkt wel of ik	Maak hier liever een volzin van, dat leest gemakkelijker.
Wel eens van de=Heb je wel eens van de|Hebt u wel eens van de|Heeft u wel eens van de|Heb jij wel eens van de|Misschien heb je wel eens van de|Men spreekt wel eens van de	Maak hier liever een volzin van, dat leest gemakkelijker.
Goed dat je een=Het is goed dat je een|Het is maar goed dat je een	Maak hier liever een volzin van, dat leest gemakkelijker.
Iets wat ik in=Dat is iets wat ik in|Dit is iets wat ik in	Maak hier liever een volzin van, dat leest gemakkelijker.
Erg leuk om de=Ik vond het erg leuk om de|Het was erg leuk om de|Het is erg leuk om de|Ik vind het erg leuk om de|Het is ook erg leuk om de|Het was ook erg leuk om de	Maak hier liever een volzin van, dat leest gemakkelijker.
Fijn dat ik je=Het is fijn dat ik je	Maak hier liever een volzin van, dat leest gemakkelijker.
Tijd om aan de=Nu is het tijd om aan de|Het is tijd om aan de|Het was tijd om aan de|Dan is het tijd om aan de|Het werd tijd om aan de	Maak hier liever een volzin van, dat leest gemakkelijker.
Zo blij dat ik=Ik ben zo blij dat ik|Ik was zo blij dat ik	Maak hier liever een volzin van, dat leest gemakkelijker.
Fijn dat je al=Wat fijn dat je al	Maak hier liever een volzin van, dat leest gemakkelijker.
Iets wat je in=Dat is iets wat je in|Het is iets wat je in	Maak hier liever een volzin van, dat leest gemakkelijker.
Leuk dat u een=Het is leuk dat u een	Maak hier liever een volzin van, dat leest gemakkelijker.
Blij dat ik je=Ik ben blij dat ik je|Wat ben ik blij dat ik je	Maak hier liever een volzin van, dat leest gemakkelijker.
Kun je net zo=Dan kun je net zo|Anders kun je net zo|Dat kun je net zo|Dus kun je net zo|Die kun je net zo	Maak hier liever een volzin van, dat leest gemakkelijker.
Ook af en toe=Je moet ook af en toe|Ik heb ook af en toe|Je kunt ook af en toe|Er zijn ook af en toe|Je kan ook af en toe|Het is ook af en toe|Ik kijk ook af en toe|Ik gebruik ook af en toe	Maak hier liever een volzin van, dat leest gemakkelijker.
Zo erg dat ze=Het was zo erg dat ze|Het is zo erg dat ze|Het werd zo erg dat ze	Maak hier liever een volzin van, dat leest gemakkelijker.
Verkrijgbaar in meerdere=Ze zijn verkrijgbaar in meerdere	Maak hier liever een volzin van, dat leest gemakkelijker.
Gemakkelijk in gebruik=Het is gemakkelijk in gebruik	Maak hier liever een volzin van, dat leest gemakkelijker.
Geen enkele aanwijzing=Er is geen enkele aanwijzing|Er was geen enkele aanwijzing|Ik zie geen enkele aanwijzing|Ik heb geen enkele aanwijzing|Er is ook geen enkele aanwijzing|Er bestaat geen enkele aanwijzing|Maar er was geen enkele aanwijzing	Maak hier liever een volzin van, dat leest gemakkelijker.
Een ideale bestemming=Het is een ideale bestemming	Maak hier liever een volzin van, dat leest gemakkelijker.
Zoals gewoonlijk weer=Het was zoals gewoonlijk weer	Maak hier liever een volzin van, dat leest gemakkelijker.
Ongelooflijk hoe snel=Het is ongelooflijk hoe snel	Maak hier liever een volzin van, dat leest gemakkelijker.
Mooie combinatie van=Het is een mooie combinatie van	Maak hier liever een volzin van, dat leest gemakkelijker.
Verkrijgbaar in vele=Ze zijn verkrijgbaar in vele|Het is verkrijgbaar in vele	Maak hier liever een volzin van, dat leest gemakkelijker.
Man aangehouden voor=Er is een man aangehouden voor	Maak hier liever een volzin van, dat leest gemakkelijker.
Iemand hier ervaring=Heeft er iemand hier ervaring	Maak hier liever een volzin van, dat leest gemakkelijker.
Een echte klassieker=Het is een echte klassieker	Maak hier liever een volzin van, dat leest gemakkelijker.
Prijzen beginnen bij=De prijzen beginnen bij	Maak hier liever een volzin van, dat leest gemakkelijker.
Aangenaam kennis met=Het was aangenaam kennis met	Maak hier liever een volzin van, dat leest gemakkelijker.
Afspraak maken voor=Ik wil graag een afspraak maken voor|U kunt een afspraak maken voor|Je kunt een afspraak maken voor|Wilt u een afspraak maken voor|Wil je een afspraak maken voor|U kunt altijd een afspraak maken voor|U kunt ook een afspraak maken voor|Ook kunt u een afspraak maken voor	Maak hier liever een volzin van, dat leest gemakkelijker.
Misschien iets voor=Is dat misschien iets voor|Dan is dit misschien iets voor	Maak hier liever een volzin van, dat leest gemakkelijker.
Eindelijk eens iets=Er is eindelijk eens iets	Maak hier liever een volzin van, dat leest gemakkelijker.
Het perfecte cadeau=Het is het perfecte cadeau	Maak hier liever een volzin van, dat leest gemakkelijker.
Een heel bijzondere=Het is een heel bijzondere	Maak hier liever een volzin van, dat leest gemakkelijker.
Best mogelijk, maar=Dat is best mogelijk, maar	Maak hier liever een volzin van, dat leest gemakkelijker.
Binnenkort weer een=Binnenkort is er weer een|Is er binnenkort weer een|Ik ga binnenkort weer een|Ik zal binnenkort weer een|Er zal binnenkort weer een	Maak hier liever een volzin van, dat leest gemakkelijker.
Lijkt me heerlijk,=Het lijkt me heerlijk,	Maak hier liever een volzin van, dat leest gemakkelijker.
Een heel bijzonder=Het is een heel bijzonder|Is het een heel bijzonder	Maak hier liever een volzin van, dat leest gemakkelijker.
Makkelijk te maken=Om het makkelijk te maken|Om het u makkelijk te maken|Om het je makkelijk te maken|Het is makkelijk te maken|Ze zijn makkelijk te maken|Om het mezelf makkelijk te maken|Om het extra makkelijk te maken	Maak hier liever een volzin van, dat leest gemakkelijker.
Een spannende tijd=Het is een spannende tijd|Het was een spannende tijd|Dit is een spannende tijd|Er breekt een spannende tijd	Maak hier liever een volzin van, dat leest gemakkelijker.
Geschikt voor alle=Het is geschikt voor alle	Maak hier liever een volzin van, dat leest gemakkelijker.
Benieuwd naar jouw=Wij zijn benieuwd naar jouw|Ik ben benieuwd naar jouw|We zijn benieuwd naar jouw	Maak hier liever een volzin van, dat leest gemakkelijker.
Niet echt geschikt=Het is niet echt geschikt	Maak hier liever een volzin van, dat leest gemakkelijker.
Misschien maar een=Het is misschien maar een|Het was misschien maar een|Ik ben misschien maar een	Maak hier liever een volzin van, dat leest gemakkelijker.
Heel benieuwd naar=Ik ben heel benieuwd naar|Ik ben ook heel benieuwd naar|Ik ben echt heel benieuwd naar|Wij zijn heel benieuwd naar|Ik ben wel heel benieuwd naar|Ik was heel benieuwd naar	Maak hier liever een volzin van, dat leest gemakkelijker.
Een stuk goedkoper=Dat is een stuk goedkoper|Het is een stuk goedkoper|Dit is een stuk goedkoper|Die zijn een stuk goedkoper	Maak hier liever een volzin van, dat leest gemakkelijker.
Is afhankelijk van=Dit is afhankelijk van|Dat is afhankelijk van|Het is afhankelijk van|Deze is afhankelijk van	Maak hier liever een volzin van, dat leest gemakkelijker.
Eigenlijk meer een=Het is eigenlijk meer een|Het was eigenlijk meer een	Maak hier liever een volzin van, dat leest gemakkelijker.
Een gezellig dagje=Maak er een gezellig dagje	Maak hier liever een volzin van, dat leest gemakkelijker.
Veel lekkerder dan=Het is veel lekkerder dan	Maak hier liever een volzin van, dat leest gemakkelijker.
Alleen spijtig dat=Het is alleen spijtig dat|Ik vind het alleen spijtig dat	Maak hier liever een volzin van, dat leest gemakkelijker.
Beoordeeld met een=Het is beoordeeld met een|Onze keurmerkhouders worden beoordeeld met een|Wij worden door klanten beoordeeld met een	Maak hier liever een volzin van, dat leest gemakkelijker.
Zeer geschikt voor=Ook zeer geschikt voor|Het is zeer geschikt voor	Maak hier liever een volzin van, dat leest gemakkelijker.
Interessant dat je=Het is interessant dat je|Ik vind het interessant dat je|Wat interessant dat je|Wel interessant dat je	Maak hier liever een volzin van, dat leest gemakkelijker.
Leuk geschreven en=Het is leuk geschreven en	Maak hier liever een volzin van, dat leest gemakkelijker.
Goed bestand tegen=Het is goed bestand tegen|Ze zijn goed bestand tegen|Hij is goed bestand tegen|Is goed bestand tegen|Het materiaal is goed bestand tegen	Maak hier liever een volzin van, dat leest gemakkelijker.
Gemakkelijk mee te=Het is gemakkelijk mee te	Maak hier liever een volzin van, dat leest gemakkelijker.
Heel vervelend en=Dat is heel vervelend en|Dit is heel vervelend en|Het is heel vervelend en|Wij vinden dit heel vervelend en	Maak hier liever een volzin van, dat leest gemakkelijker.
Licht van gewicht=Ze zijn licht van gewicht|Hij is licht van gewicht	Maak hier liever een volzin van, dat leest gemakkelijker.
Mooie omgeving en=Het is een mooie omgeving en	Maak hier liever een volzin van, dat leest gemakkelijker.
Een belevenis die=Het is een belevenis die	Maak hier liever een volzin van, dat leest gemakkelijker.
Enkel spijtig dat=Het is enkel spijtig dat	Maak hier liever een volzin van, dat leest gemakkelijker.
Handige tips voor=Heb jij nog handige tips voor	Maak hier liever een volzin van, dat leest gemakkelijker.
Morgen weer vroeg=Ik moet morgen weer vroeg|Het is morgen weer vroeg	Maak hier liever een volzin van, dat leest gemakkelijker.
Vind ik eigenlijk=Dat vind ik eigenlijk	Maak hier liever een volzin van, dat leest gemakkelijker.
Helemaal blij met=Ik ben helemaal blij met|Wij zijn helemaal blij met	Maak hier liever een volzin van, dat leest gemakkelijker.
Beslist de moeite=Het is beslist de moeite	Maak hier liever een volzin van, dat leest gemakkelijker.
Begint een beetje=Het begint een beetje|Je begint een beetje|Dit begint een beetje|Hij begint een beetje|Ze begint een beetje	Maak hier liever een volzin van, dat leest gemakkelijker.
Volgend jaar toch=Ik wil volgend jaar toch|Volgend jaar moeten we toch	Maak hier liever een volzin van, dat leest gemakkelijker.
Iemand anders nog=Heeft iemand anders nog|Wil iemand anders nog|Misschien heeft iemand anders nog|Misschien dat iemand anders nog|Als iemand anders nog|Of heeft iemand anders nog	Maak hier liever een volzin van, dat leest gemakkelijker.
Een vraag stellen=Ik wil nog een vraag stellen|Mag ik een vraag stellen|Ik wil een vraag stellen|Ik wil graag een vraag stellen|Wilt u een vraag stellen|Wil je een vraag stellen|U kunt een vraag stellen|Ik wilde een vraag stellen	Maak hier liever een volzin van, dat leest gemakkelijker.
Vanavond voor het=Ik heb vanavond voor het	Maak hier liever een volzin van, dat leest gemakkelijker.
Erg vervelend dat=Ik vind het erg vervelend dat|Het is erg vervelend dat|We vinden het erg vervelend dat|Wij vinden het erg vervelend dat	Maak hier liever een volzin van, dat leest gemakkelijker.
Echt een aanrader=Het is echt een aanrader|Dit is echt een aanrader	Maak hier liever een volzin van, dat leest gemakkelijker.
Nergens een spoor=Er is nergens een spoor|Er was nergens een spoor	Maak hier liever een volzin van, dat leest gemakkelijker.
Heeft mijn moeder=Dat heeft mijn moeder|Die heeft mijn moeder|Hij heeft mijn moeder|Ze heeft mijn moeder	Maak hier liever een volzin van, dat leest gemakkelijker.
Niet verwacht dat=Ik had niet verwacht dat|We hadden niet verwacht dat|Ik had ook niet verwacht dat|Ze hadden niet verwacht dat|Hij had niet verwacht dat|Ze had niet verwacht dat	Maak hier liever een volzin van, dat leest gemakkelijker.
Een aanwinst voor=Het is een aanwinst voor|Wat een aanwinst voor	Maak hier liever een volzin van, dat leest gemakkelijker.
Geen respect voor=Ik heb geen respect voor|Ze hebben geen respect voor	Maak hier liever een volzin van, dat leest gemakkelijker.
Echt niet normaal=Dat is echt niet normaal|Dit is echt niet normaal|Het is echt niet normaal|Ik vind het echt niet normaal	Maak hier liever een volzin van, dat leest gemakkelijker.
Erg benieuwd naar=Ik ben erg benieuwd naar|We zijn erg benieuwd naar|Ik ben heel erg benieuwd naar|Wij zijn erg benieuwd naar|Ik ben ook erg benieuwd naar	Maak hier liever een volzin van, dat leest gemakkelijker.
Nog niet helemaal=Het is nog niet helemaal|Ik ben nog niet helemaal	Maak hier liever een volzin van, dat leest gemakkelijker.
Ook heel geschikt=Het is ook heel geschikt|Ze zijn ook heel geschikt	Maak hier liever een volzin van, dat leest gemakkelijker.
Niet voor mezelf,=Het is niet voor mezelf,	Maak hier liever een volzin van, dat leest gemakkelijker.
Oorsprong van het=De oorsprong van het|Over de oorsprong van het	Maak hier liever een volzin van, dat leest gemakkelijker.
Kortom, genoeg te=Kortom, er is genoeg te	Maak hier liever een volzin van, dat leest gemakkelijker.
Heel duidelijk en=Het is heel duidelijk en	Maak hier liever een volzin van, dat leest gemakkelijker.
Gemakkelijk op te=Hij is gemakkelijk op te|Dit is gemakkelijk op te|Ze zijn gemakkelijk op te	Maak hier liever een volzin van, dat leest gemakkelijker.
Mooi verhaal over=Het is een mooi verhaal over	Maak hier liever een volzin van, dat leest gemakkelijker.
Presentatie is in=De presentatie is in	Maak hier liever een volzin van, dat leest gemakkelijker.
Heel benieuwd hoe=Ik ben heel benieuwd hoe|Ik was heel benieuwd hoe|Wij zijn heel benieuwd hoe	Maak hier liever een volzin van, dat leest gemakkelijker.
Helemaal eens met=Ik ben het helemaal eens met|Ben het helemaal eens met|Ik ben het niet helemaal eens met	Maak hier liever een volzin van, dat leest gemakkelijker.
Klinkt mooi, maar=Dat klinkt mooi, maar	Maak hier liever een volzin van, dat leest gemakkelijker.
Hele mooie foto's=Dit zijn hele mooie foto's	Maak hier liever een volzin van, dat leest gemakkelijker.
Benieuwd naar uw=Bent u benieuwd naar|Wij zijn benieuwd naar uw|Ik ben benieuwd naar uw|Wij zijn erg benieuwd naar uw|We zijn benieuwd naar uw|Bent u benieuwd naar uw	Maak hier liever een volzin van, dat leest gemakkelijker.
Benieuwd hoe dat=Ben benieuwd hoe dat|Ik ben benieuwd hoe dat|Ben je benieuwd hoe dat|IK ben benieuwd hoe dat|Ik ben heel benieuwd hoe dat|Ben heel benieuwd hoe dat	Maak hier liever een volzin van, dat leest gemakkelijker.
Niet op voorraad=Dit artikel is niet op voorraad|Artikelen die niet op voorraad|Producten die niet op voorraad|Indien het product niet op voorraad|Het product is niet op voorraad|Als het product niet op voorraad	Maak hier liever een volzin van, dat leest gemakkelijker.
Wel eens gedacht=Ik heb wel eens gedacht|Heb je wel eens gedacht|Heeft u wel eens gedacht|Ik heb ook wel eens gedacht|Maar heb je wel eens gedacht|Hebt u wel eens gedacht|Maar heeft u wel eens gedacht	Maak hier liever een volzin van, dat leest gemakkelijker.
Klinkt gek, maar=Het klinkt gek, maar	Maak hier liever een volzin van, dat leest gemakkelijker.
Meer vragen over=Voor meer vragen over|Hebt u meer vragen over|Heeft u meer vragen over|Heb je nog meer vragen over|Heb je meer vragen over|Heeft u nog meer vragen over	Maak hier liever een volzin van, dat leest gemakkelijker.
Kwestie van niet=Het is een kwestie van niet	Maak hier liever een volzin van, dat leest gemakkelijker.
Eens iets anders=Het is eens iets anders|Het is weer eens iets anders|Dat is nog eens iets anders|Dat is weer eens iets anders|Wilt u eens iets anders|Dat was nog eens iets anders	Maak hier liever een volzin van, dat leest gemakkelijker.
Hierbij even een=Hierbij doe ik even een	Maak hier liever een volzin van, dat leest gemakkelijker.
Genoeg ruimte om=Er is genoeg ruimte om|Er was net genoeg ruimte om|Er was genoeg ruimte om|Er is niet genoeg ruimte om|Ook is er genoeg ruimte om|Er was niet genoeg ruimte om|Er is meer dan genoeg ruimte om|Is er genoeg ruimte om	Maak hier liever een volzin van, dat leest gemakkelijker.
Altijd leuk voor=Dat is altijd leuk voor|Dat is niet altijd leuk voor|Is altijd leuk voor|Ook altijd leuk voor|Niet altijd leuk voor	Maak hier liever een volzin van, dat leest gemakkelijker.
Ook bekend onder=Het is ook bekend onder|Hij is ook bekend onder|Het staat ook bekend onder|Ze is ook bekend onder|Ze zijn ook bekend onder|Hij was ook bekend onder|Hij staat ook bekend onder	Maak hier liever een volzin van, dat leest gemakkelijker.
Niet echt lekker=Het is niet echt lekker|Het gaat niet echt lekker	Maak hier liever een volzin van, dat leest gemakkelijker.
Drie manieren om=Er zijn drie manieren om	Maak hier liever een volzin van, dat leest gemakkelijker.
Ziet er heerlijk=Het ziet er heerlijk|Dat ziet er heerlijk|Dit ziet er heerlijk	Maak hier liever een volzin van, dat leest gemakkelijker.
Benieuwd waar je=Ik ben benieuwd waar je|Ben benieuwd waar je|Ben je benieuwd waar je|Ik ben wel benieuwd waar je	Maak hier liever een volzin van, dat leest Tijd om uw=Het is tijd om uw|Heeft u geen tijd om uw|Dan is het tijd om uw|Is het tijd om uw|Nu is het tijd om uw|Het is weer tijd om uw|Dan is het hoog tijd om uw|Wij nemen de tijd om uw
Ben wel benieuwd=Ik ben wel benieuwd|Maar ik ben wel benieuwd	Maak hier liever een volzin van, dat leest gemakkelijker.
Kan ik tenminste=Dan kan ik tenminste|Nu kan ik tenminste|Hier kan ik tenminste|Daar kan ik tenminste|Zo kan ik tenminste	Maak hier liever een volzin van, dat leest gemakkelijker.
Benieuwd wat hij=Ik ben benieuwd wat hij|Ik was benieuwd wat hij|Ze was benieuwd wat hij|We zijn benieuwd wat hij	Maak hier liever een volzin van, dat leest gemakkelijker.
Moeilijk om daar=Het is moeilijk om daar|Ik vind het moeilijk om daar|Het is heel moeilijk om daar|Het was moeilijk om daar|Het is niet moeilijk om daar|Maar het is moeilijk om daar	Maak hier liever een volzin van, dat leest gemakkelijker.
Alleen maar goed=Dat is alleen maar goed|Het is alleen maar goed|Dit kan alleen maar goed|Dat kan alleen maar goed|Ik vind het alleen maar goed|Ik denk dat het alleen maar goed|Het was alleen maar goed|Het kan alleen maar goed	Maak hier liever een volzin van, dat leest gemakkelijker.
Geschikt voor in=Het is geschikt voor in	Maak hier liever een volzin van, dat leest gemakkelijker.
Interesse in een=Heb je interesse in een|Heeft u interesse in een|Hebt u interesse in een|Ook interesse in een	Maak hier liever een volzin van, dat leest gemakkelijker.
Werkt perfect en=Het werkt perfect en|Dit werkt perfect en	Maak hier liever een volzin van, dat leest gemakkelijker.
Telkens weer een=Het is telkens weer een|Het was telkens weer een	Maak hier liever een volzin van, dat leest gemakkelijker.
Ook te bestellen=Het is ook te bestellen	Maak hier liever een volzin van, dat leest gemakkelijker.
Heb even gekeken=Ik heb even gekeken	Maak hier liever een volzin van, dat leest gemakkelijker.
Niet normaal hoe=Het is niet normaal hoe	Maak hier liever een volzin van, dat leest gemakkelijker.
Benieuwd wat dat=Ik ben benieuwd wat dat|Bent u benieuwd wat dat|We zijn benieuwd wat dat	Maak hier liever een volzin van, dat leest gemakkelijker.
Morgen toch maar=Morgen ga ik toch maar	Maak hier liever een volzin van, dat leest gemakkelijker.
Lekker rustig en=Het was lekker rustig en|Het is er lekker rustig en|Het is lekker rustig en	Maak hier liever een volzin van, dat leest gemakkelijker.
Benieuwd hoe ze=Ik ben benieuwd hoe ze|Ik ben heel benieuwd hoe ze|We zijn benieuwd hoe ze|Ik ben wel benieuwd hoe ze	Maak hier liever een volzin van, dat leest gemakkelijker.
Leuk als cadeau=Dit is leuk als cadeau	Maak hier liever een volzin van, dat leest gemakkelijker.
Zag er allemaal=Het zag er allemaal	Maak hier liever een volzin van, dat leest gemakkelijker.
Lekker zacht en=Het is lekker zacht en	Maak hier liever een volzin van, dat leest gemakkelijker.
Dingen doen die=De dingen doen die|Je moet dingen doen die|Ik wil dingen doen die|Soms moet je dingen doen die|Je gaat dingen doen die	Maak hier liever een volzin van, dat leest gemakkelijker.
Niet bedoeld om=Het is niet bedoeld om	Maak hier liever een volzin van, dat leest gemakkelijker.
Heeft een grote=Hij heeft een grote|Ze heeft een grote|Het heeft een grote|U heeft een grote|Dit heeft een grote|Dat heeft een grote|Het museum heeft een grote	Maak hier liever een volzin van, dat leest gemakkelijker.
Dus niet zomaar=Je kunt dus niet zomaar|Het is dus niet zomaar|Je kan dus niet zomaar|U kunt dus niet zomaar|Je mag dus niet zomaar|Het was dus niet zomaar|Dat is dus niet zomaar|Ik kan dus niet zomaar	Maak hier liever een volzin van, dat leest gemakkelijker.
Zeker nog nooit=Je hebt zeker nog nooit|Je bent zeker nog nooit|Jij hebt zeker nog nooit|Dan heb je zeker nog nooit	Maak hier liever een volzin van, dat leest gemakkelijker.
Perfect voor op=Deze bereidt perfect voor op	Maak hier liever een volzin van, dat leest gemakkelijker.
Een zonnige dag=Het is een zonnige dag|Het was een zonnige dag	Maak hier liever een volzin van, dat leest gemakkelijker.
Leuk verhaal en=Het is een leuk verhaal en	Maak hier liever een volzin van, dat leest gemakkelijker.
Draaide zich om=Hij draaide zich om	Maak hier liever een volzin van, dat leest gemakkelijker.
Niet zeggen dat=Ik kan niet zeggen dat|Dat wil niet zeggen dat|Maar dat wil niet zeggen dat|Ik wil niet zeggen dat|Ik zal niet zeggen dat|Dit wil niet zeggen dat|Dat wil echter niet zeggen dat	Maak hier liever een volzin van, dat leest gemakkelijker.
Weet alleen nog=Ik weet alleen nog|Hij weet alleen nog	Maak hier liever een volzin van, dat leest gemakkelijker.
Heeft dus niets=Het heeft dus niets	Maak hier liever een volzin van, dat leest gemakkelijker.
Wel spijtig dat=Ik vind het wel spijtig dat|Het is wel spijtig dat	Maak hier liever een volzin van, dat leest gemakkelijker.
Mooie manier om=Het is een mooie manier om|Dat is een mooie manier om|Dit is een mooie manier om|Het was een mooie manier om	Maak hier liever een volzin van, dat leest gemakkelijker.
Heerlijk dat we=Het is heerlijk dat we|Ik vind het heerlijk dat we|Wat is het toch heerlijk dat we|Is het niet heerlijk dat we	Maak hier liever een volzin van, dat leest gemakkelijker.
Maakt toch niet=Dat maakt toch niet|Het maakt toch niet|Maar het maakt toch niet	Maak hier liever een volzin van, dat leest gemakkelijker.
Heel erg lekker=Het was heel erg lekker	Maak hier liever een volzin van, dat leest gemakkelijker.
Goed nieuws dat=Het is goed nieuws dat|Heel goed nieuws dat|Ik vind het goed nieuws dat|Het was goed nieuws dat	Maak hier liever een volzin van, dat leest gemakkelijker.
Jammer dat daar=Het is jammer dat daar	Maak hier liever een volzin van, dat leest gemakkelijker.
Ben benieuwd of=Ik ben benieuwd of	Maak hier liever een volzin van, dat leest gemakkelijker.
Toch wel lekker=Het is toch wel lekker	Maak hier liever een volzin van, dat leest gemakkelijker.
Net genoeg voor=Dat is net genoeg voor|Het was net genoeg voor|Dat was net genoeg voor	Maak hier liever een volzin van, dat leest gemakkelijker.
Een aanrader en=Ik vind het een aanrader en|Dit is echt een aanrader en	Maak hier liever een volzin van, dat leest gemakkelijker.
Ook mogelijk om=Het is ook mogelijk om|Is het ook mogelijk om|Uiteraard is het ook mogelijk om|Natuurlijk is het ook mogelijk om|Daarnaast is het ook mogelijk om|Het is natuurlijk ook mogelijk om|Het is echter ook mogelijk om	Maak hier liever een volzin van, dat leest gemakkelijker.
Eerst kijken of=Ik ga eerst kijken of|Ik wil eerst kijken of|Ik zou eerst kijken of|Ik moet eerst kijken of|Wil je eerst kijken of	Maak hier liever een volzin van, dat leest gemakkelijker.
Helemaal met je=Ik ben het helemaal met je	Maak hier liever een volzin van, dat leest gemakkelijker.
Geweldig wat je=Ik vind het geweldig wat je|Het is geweldig wat je	Maak hier liever een volzin van, dat leest gemakkelijker.
Moeilijk om een=Het is moeilijk om een|Is het moeilijk om een|Het is niet zo moeilijk om een|Het is heel moeilijk om een|Het is niet moeilijk om een|Ik vind het moeilijk om een|Het was moeilijk om een|Het is erg moeilijk om een	Maak hier liever een volzin van, dat leest gemakkelijker.
Heerlijk om dat=Het is heerlijk om dat	Maak hier liever een volzin van, dat leest gemakkelijker.
Dus logisch dat=Het is dus logisch dat|Het was dus logisch dat	Maak hier liever een volzin van, dat leest gemakkelijker.
Nog meer reden=En er is nog meer reden	Maak hier liever een volzin van, dat leest gemakkelijker.
Geweldig om zo=Het is geweldig om zo	Maak hier liever een volzin van, dat leest gemakkelijker.
Kan haast niet=Ik kan haast niet|Dat kan haast niet|Het kan haast niet|Ze kan haast niet|Hij kan haast niet	Maak hier liever een volzin van, dat leest gemakkelijker.
Nog nooit iets=Ik heb nog nooit iets|Ik had nog nooit iets|Er is nog nooit iets|Hij had nog nooit iets|Ik heb er nog nooit iets|Ze had nog nooit iets|Hij heeft nog nooit iets	Maak hier liever een volzin van, dat leest gemakkelijker.
Ook zo genoten=Heb jij ook zo genoten|Heeft u ook zo genoten|Heb je ook zo genoten|Ik heb ook zo genoten	Maak hier liever een volzin van, dat leest gemakkelijker.
Goed gedaan en=Ze hebben het goed gedaan en|We hebben het goed gedaan en	Maak hier liever een volzin van, dat leest gemakkelijker.
Hier weer eens=Hier is weer eens	Maak hier liever een volzin van, dat leest gemakkelijker.
Echt heel leuk=Ik vind het echt heel leuk|Het is echt heel leuk|Het was echt heel leuk|Dit is echt heel leuk	Maak hier liever een volzin van, dat leest gemakkelijker.
Te wachten tot=Ik zit te wachten tot|Ik zat te wachten tot|Je hoeft niet te wachten tot|U hoeft niet te wachten tot|Ik besloot te wachten tot|Hij zat te wachten tot|U hoeft dus niet te wachten tot|Hij besloot te wachten tot	Maak hier liever een volzin van, dat leest gemakkelijker.
Wachten tot je=Ik kan niet wachten tot je|Je kunt wachten tot je|We wachten tot je|Je hoeft niet te wachten tot je|Je moet wachten tot je|Niet wachten tot je|Kan niet wachten tot je|Ze wachten tot je|Waarom wachten tot je	Maak hier liever een volzin van, dat leest gemakkelijker.
Zegt meer over=Dat zegt meer over|Het zegt meer over|Dit zegt meer over|Maar dat zegt meer over	Maak hier liever een volzin van, dat leest gemakkelijker.
Een mooi einde=Het is een mooi einde|Het was een mooi einde	Maak hier liever een volzin van, dat leest gemakkelijker.
Had het gevoel=Ik had het gevoel|Hij had het gevoel	Maak hier liever een volzin van, dat leest gemakkelijker.
Geldig bij een=Dit is geldig bij een	Maak hier liever een volzin van, dat leest gemakkelijker.
Eten was prima=Het eten was prima	Maak hier liever een volzin van, dat leest gemakkelijker.
Nog mensen die=We zoeken nog mensen die|Gelukkig zijn er nog mensen die|Gelukkig zijn er ook nog mensen die|Er zijn nog mensen die|Er zijn ook nog mensen die|Toch zijn er nog mensen die|Dan zijn er nog mensen die|Dan zijn er ook nog mensen die	Maak hier liever een volzin van, dat leest gemakkelijker.
Ook leuk, maar=Dat is ook leuk, maar	Maak hier liever een volzin van, dat leest gemakkelijker.
Zeker weten of=Wil je zeker weten of|Wilt u zeker weten of|Ik wil zeker weten of|Ik wilde zeker weten of|Mocht je niet zeker weten of|Hij wilde zeker weten of|Ik wil eerst zeker weten of	Maak hier liever een volzin van, dat leest gemakkelijker.
Echt een mooie=Het is echt een mooie|Het was echt een mooie|Dit is echt een mooie	Maak hier liever een volzin van, dat leest gemakkelijker.
Hoeft niet per=Dat hoeft niet per|Je hoeft niet per|Het hoeft niet per|Er hoeft niet per|Dit hoeft niet per|U hoeft niet per|Maar dat hoeft niet per	Maak hier liever een volzin van, dat leest gemakkelijker.
Weet even niet=Ik weet even niet|Hij weet even niet|Zij weet even niet	Maak hier liever een volzin van, dat leest gemakkelijker.
Kan nog steeds=Ik kan nog steeds|Het kan nog steeds|Je kan nog steeds|Ze kan nog steeds|Hij kan nog steeds|Maar ik kan nog steeds|Er kan nog steeds	Maak hier liever een volzin van, dat leest gemakkelijker.
Lijkt me prima=Het lijkt me prima	Maak hier liever een volzin van, dat leest gemakkelijker.
Dacht het niet=Ik dacht het niet|Ze dacht het niet	Maak hier liever een volzin van, dat leest gemakkelijker.
Maakt het haar=Het maakt het haar	Maak hier liever een volzin van, dat leest gemakkelijker.
Wel wat anders=Ik heb wel wat anders|Dat is wel wat anders|Dit is wel wat anders|Het is wel wat anders|Dat was wel wat anders|Ik had wel wat anders|Hij had wel wat anders|Ze had wel wat anders	Maak hier liever een volzin van, dat leest gemakkelijker.
Weet niet eens=Ik weet niet eens|Je weet niet eens|Ze weet niet eens|Hij weet niet eens	Maak hier liever een volzin van, dat leest gemakkelijker.
Een vraag over=Ik heb een vraag over|Ik heb nog een vraag over|Heb je een vraag over|Heeft u een vraag over|Hebt u een vraag over	Maak hier liever een volzin van, dat leest gemakkelijker.
Kost wat, maar=Het kost wat, maar	Maak hier liever een volzin van, dat leest gemakkelijker.
Verpakt in een=Het is verpakt in een	Maak hier liever een volzin van, dat leest gemakkelijker.
Dus weer terug=Ik ben dus weer terug	Maak hier liever een volzin van, dat leest gemakkelijker.
Heerlijk om er=Het is heerlijk om er|Ik vind het heerlijk om er|Het was heerlijk om er	Maak hier liever een volzin van, dat leest gemakkelijker.
Dacht even dat=Ik dacht even dat|Hij dacht even dat	Maak hier liever een volzin van, dat leest gemakkelijker.
Wel handig als=Het is wel handig als|Dan is het wel handig als|Misschien is het wel handig als|Maar het is wel handig als|Het is dan wel handig als|Dat is wel handig als|Het is natuurlijk wel handig als|Het lijkt me wel handig als	Maak hier liever een volzin van, dat leest gemakkelijker.
Ook lekker als=Het is ook lekker als	Maak hier liever een volzin van, dat leest gemakkelijker.
Scheelt je een=Dat scheelt je een|Het scheelt je een	Maak hier liever een volzin van, dat leest gemakkelijker.
Een pracht van=Wat een pracht van|Dat is een pracht van	Maak hier liever een volzin van, dat leest gemakkelijker.
Heb ik gedaan,=Dat heb ik gedaan,|Wat heb ik gedaan,|Ja, dat heb ik gedaan,|Dit heb ik gedaan,	Maak hier liever een volzin van, dat leest gemakkelijker.
Zonde van mijn=Ik vind het zonde van mijn|Het is zonde van mijn	Maak hier liever een volzin van, dat leest gemakkelijker.
Mag toch hopen=Ik mag toch hopen|Je mag toch hopen	Maak hier liever een volzin van, dat leest gemakkelijker.
Vreemd dat die=Ik vind het vreemd dat die|Het is vreemd dat die|Ik vond het vreemd dat die	Maak hier liever een volzin van, dat leest gemakkelijker.
Ideaal voor in=Dat is ideaal voor in	Maak hier liever een volzin van, dat leest gemakkelijker.
Toch een mooie=Ik heb toch|Het is toch een mooie|Dat is toch een mooie	Maak hier liever een volzin van, dat leest gemakkelijker.
Nog wat foto's=Ik heb nog wat foto's|Ik heb ook nog wat foto's|Ik maak nog wat foto's|Ik ga nog wat foto's|Ik zal nog wat foto's	Maak hier liever een volzin van, dat leest gemakkelijker.
Klinkt goed en=Dat klinkt goed en|Het klinkt goed en	Maak hier liever een volzin van, dat leest gemakkelijker.
Blijft leuk om=Het blijft leuk om	Maak hier liever een volzin van, dat leest gemakkelijker.
Terecht dat je=Het is terecht dat je	Maak hier liever een volzin van, dat leest gemakkelijker.
Heeft iets met=Het heeft iets met|Hij heeft iets met|Ze heeft iets met|Dat heeft iets met	Maak hier liever een volzin van, dat leest gemakkelijker.
Goed hotel met=Het is een goed hotel met	Maak hier liever een volzin van, dat leest gemakkelijker.
Lijkt mij niet=Het lijkt mij niet|Dat lijkt mij niet|Dit lijkt mij niet	Maak hier liever een volzin van, dat leest gemakkelijker.
Veel ruimte om=Er is veel ruimte om|Je krijgt veel ruimte om|Er was veel ruimte om	Maak hier liever een volzin van, dat leest gemakkelijker.
Sinds kort ook=Ik ben sinds kort ook|Ik heb sinds kort ook|Ik gebruik sinds kort ook|Er is sinds kort ook|Het is sinds kort ook|Wij hebben sinds kort ook|Er zijn sinds kort ook|Ik heb er sinds kort ook	Maak hier liever een volzin van, dat leest gemakkelijker.
Weer een leuke=Het was weer een leuke|Het is weer een leuke	Maak hier liever een volzin van, dat leest gemakkelijker.
Dus geen reden=Er is dus geen reden|Ik zie dus geen reden|Er was dus geen reden	Maak hier liever een volzin van, dat leest gemakkelijker.
Tijd om verder=Het is tijd om verder|Het was tijd om verder|Dan is het tijd om verder|Het werd tijd om verder|Het is nu tijd om verder|Er was geen tijd om verder|Ik had geen tijd om verder	Maak hier liever een volzin van, dat leest gemakkelijker.
Lekker met wat=Dat is lekker met wat	Maak hier liever een volzin van, dat leest gemakkelijker.
Leuke tip voor=Het is een leuke tip voor|Ik heb een leuke tip voor	Maak hier liever een volzin van, dat leest gemakkelijker.
Geldt ook voor=Dat geldt ook voor|Dit geldt ook voor|En dat geldt ook voor|Het geldt ook voor	Maak hier liever een volzin van, dat leest gemakkelijker.
Lijkt mij echt=Dat lijkt mij echt|Het lijkt mij echt	Maak hier liever een volzin van, dat leest gemakkelijker.
Lijkt me nogal=Dat lijkt me nogal|Het lijkt me nogal	Maak hier liever een volzin van, dat leest gemakkelijker.
Veel gezien en=Ik heb veel gezien en|Wij hebben veel gezien en|Wat heb je al veel gezien en	Maak hier liever een volzin van, dat leest gemakkelijker.
Iets te vieren=U iets te vieren|Heeft u iets te vieren|Heb je iets te vieren|Als er iets te vieren|Heeft u binnenkort iets te vieren|Als u iets te vieren|Als je iets te vieren|Wanneer u iets te vieren	Maak hier liever een volzin van, dat leest gemakkelijker.
Thema van dit=Het thema van dit	Maak hier liever een volzin van, dat leest gemakkelijker.
Heeft niks te=Dat heeft niks te|Het heeft niks te|Dit heeft niks te|Hij heeft niks te	Maak hier liever een volzin van, dat leest gemakkelijker.
Kan niet meer=Ik kan niet meer|Het kan niet meer|Hij kan niet meer	Maak hier liever een volzin van, dat leest gemakkelijker.
Echt een heel=Het is echt een heel|Dat is echt een heel|Dit is echt een heel|Het was echt een heel	Maak hier liever een volzin van, dat leest gemakkelijker.
Ook goed voor=Het is ook goed voor|Dat is ook goed voor	Maak hier liever een volzin van, dat leest gemakkelijker.
Lijkt mij ook=Dat lijkt mij ook|Het lijkt mij ook|Dit lijkt mij ook	Maak hier liever een volzin van, dat leest gemakkelijker.
Dacht dat dat=Ik dacht dat dat|Hij dacht dat dat|Ze dacht dat dat	Maak hier liever een volzin van, dat leest gemakkelijker.
Een unicum in=Dat is een unicum in|Het is een unicum in	Maak hier liever een volzin van, dat leest gemakkelijker.
Was een leuke=Het was een leuke|Dat was een leuke|Dit was een leuke	Maak hier liever een volzin van, dat leest gemakkelijker.
Beter voor de=Het is beter voor de|Dat is beter voor de	Maak hier liever een volzin van, dat leest gemakkelijker.
Kijken wat ze=Moet je kijken wat ze|Laten we eens kijken wat ze|Eens kijken wat ze|Ga eens kijken wat ze|Laten we maar eens kijken wat ze|Zonder te kijken wat ze	Maak hier liever een volzin van, dat leest gemakkelijker.
Lijkt me veel=Het lijkt me veel|Dat lijkt me veel	Maak hier liever een volzin van, dat leest gemakkelijker.
Niet eens met=Ik ben het niet eens met|Ben je het niet eens met|Bent u het niet eens met	Maak hier liever een volzin van, dat leest gemakkelijker.
Weet dus niet=Ik weet dus niet|Je weet dus niet|U weet dus niet|Maar ik weet dus niet|Hij weet dus niet	Maak hier liever een volzin van, dat leest gemakkelijker.
Bijna te mooi=Het is bijna te mooi|Het was bijna te mooi|Het lijkt bijna te mooi|Het klinkt bijna te mooi|Het leek bijna te mooi	Maak hier liever een volzin van, dat leest gemakkelijker.
Ben echt heel=Ik Ben echt heel	Maak hier liever een volzin van, dat leest gemakkelijker.
Nog niet voor=Dat geldt nog niet voor	Maak hier liever een volzin van, dat leest gemakkelijker.
Heel lief van=Dat is heel lief van|Het is heel lief van|Ik vind het heel lief van|Het was heel lief van|Dat was heel lief van	Maak hier liever een volzin van, dat leest gemakkelijker.
Kan ik lekker=Waar kan ik lekker|Nu kan ik lekker|Daar kan ik lekker|Dan kan ik lekker|Zo kan ik lekker|En dan kan ik lekker	Maak hier liever een volzin van, dat leest gemakkelijker.
Nieuw in onze=Dit is nieuw in onze|Bent u nieuw in onze|Ben je nieuw in onze	Maak hier liever een volzin van, dat leest gemakkelijker.
Ook een mooie=Dat is ook een mooie|Het is ook een mooie	Maak hier liever een volzin van, dat leest gemakkelijker.
Hoop dat mijn=Ik hoop dat mijn	Maak hier liever een volzin van, dat leest gemakkelijker.
Nog beter dan=Dat is altijd nog beter dan|Het is nog beter dan	Maak hier liever een volzin van, dat leest gemakkelijker.
Ook iets waar=Dat is ook iets waar|Dit is ook iets waar|Het is ook iets waar	Maak hier liever een volzin van, dat leest gemakkelijker.
Dacht dat dit=Ik dacht dat dit|Men dacht dat dit|Hij dacht dat dit|Ze dacht dat dit	Maak hier liever een volzin van, dat leest gemakkelijker.
Nog een lange=Er is nog een lange|Ik heb nog een lange|Het is nog een lange|Maar er is nog een lange|Je hebt nog een lange|Er is echter nog een lange|Er is dus nog een lange|Hij had nog een lange	Maak hier liever een volzin van, dat leest gemakkelijker.
Houdt van een=Deze houdt van een	Maak hier liever een volzin van, dat leest gemakkelijker.
Kan wel, maar=Dat kan wel, maar|Het kan wel, maar|Ja, dat kan wel, maar|Dit kan wel, maar	Maak hier liever een volzin van, dat leest gemakkelijker.
Kan ik gelijk=Dan kan ik gelijk	Maak hier liever een volzin van, dat leest gemakkelijker.
Ook heel goed=Het is ook heel goed|Het kan ook heel goed|Je kunt ook heel goed|Het is dan ook heel goed|Ik begrijp ook heel goed|Maar het kan ook heel goed|Maar het is ook heel goed|Dat kan ook heel goed|Het zou ook heel goed	Maak hier liever een volzin van, dat leest gemakkelijker.
Vroeg zich af=Hij vroeg zich af	Maak hier liever een volzin van, dat leest gemakkelijker.
Lijkt me toch=Het lijkt me toch|Dat lijkt me toch|Dit lijkt me toch|Maar het lijkt me toch	Maak hier liever een volzin van, dat leest gemakkelijker.
Komt goed uit=Dat komt goed uit|Het komt goed uit	Maak hier liever een volzin van, dat leest gemakkelijker.
Heel blij met=Ik ben heel blij met|We zijn heel blij met|Wij zijn heel blij met	Maak hier liever een volzin van, dat leest gemakkelijker.
Was niet echt=Het was niet echt|Ik was niet echt|Dat was niet echt|Ze was niet echt|Er was niet echt|Hij was niet echt	Maak hier liever een volzin van, dat leest gemakkelijker.
Heeft iets te=Het heeft iets te|Dat heeft iets te|Hij heeft iets te|U heeft iets te|Dit heeft iets te	Maak hier liever een volzin van, dat leest gemakkelijker.
Iets waar jij=Dat is iets waar jij	Maak hier liever een volzin van, dat leest gemakkelijker.
Gaan we zeker=Dat gaan we zeker|Daar gaan we zeker|Hier gaan we zeker|Dit gaan we zeker|Volgend jaar gaan we zeker	Maak hier liever een volzin van, dat leest gemakkelijker.
Nu nog kijken=Nu moeten we nog kijken|Nu moet ik nog kijken	Maak hier liever een volzin van, dat leest gemakkelijker.
Lijkt mij wel=Dat lijkt mij wel|Het lijkt mij wel|Dit lijkt mij wel	Maak hier liever een volzin van, dat leest gemakkelijker.
Ook weer zo'n=Dat is ook weer zo'n|Dit is ook weer zo'n	Maak hier liever een volzin van, dat leest gemakkelijker.
Geeft de huid=Het geeft de huid	Maak hier liever een volzin van, dat leest gemakkelijker.
Erg leuk voor=Dat is erg leuk voor|Heel erg leuk voor	Maak hier liever een volzin van, dat leest gemakkelijker.
Dus niet voor=Dat is dus niet voor|Het is dus niet voor	Maak hier liever een volzin van, dat leest gemakkelijker.
Echt een leuk=Het is echt een leuk|Dat is echt een leuk|Het was echt een leuk|Dit is echt een leuk	Maak hier liever een volzin van, dat leest gemakkelijker.
Lijkt me iets=Dat lijkt me iets|Dit lijkt me iets	Maak hier liever een volzin van, dat leest gemakkelijker.
Lijkt me leuk=Dat lijkt me leuk|Het lijkt me leuk	Maak hier liever een volzin van, dat leest gemakkelijker.
Heel erg leuk=Ik vind het heel erg leuk|Het is heel erg leuk	Maak hier liever een volzin van, dat leest gemakkelijker.
Niets mis mee=Daar is niets mis mee|Er is niets mis mee	Maak hier liever een volzin van, dat leest gemakkelijker.
Lijkt me heel=Dat lijkt me heel|Het lijkt me heel	Maak hier liever een volzin van, dat leest gemakkelijker.
Bleek het een=Gelukkig bleek het een|Uiteindelijk bleek het een|Achteraf bleek het een|Later bleek het een|Toch bleek het een|Helaas bleek het een|Bovendien bleek het een	Maak hier liever een volzin van, dat leest gemakkelijker.
Echt super om=Het is echt super om|Het was echt super om|Ik vind het echt super om	Maak hier liever een volzin van, dat leest gemakkelijker.
Wel zo veilig=Dat is wel zo veilig	Maak hier liever een volzin van, dat leest gemakkelijker.
Even een foto=Ik heb even een foto|Ik zal even een foto|Ik zal zo even een foto	Maak hier liever een volzin van, dat leest gemakkelijker.
Kan je lekker=Dan kan je lekker|Zo kan je lekker|Hier kan je lekker|Daar kan je lekker|Nu kan je lekker	Maak hier liever een volzin van, dat leest gemakkelijker.
Bijna niet te=Het is bijna niet te|Ik durf het bijna niet te|Het was bijna niet te	Maak hier liever een volzin van, dat leest gemakkelijker.
Wel heel fijn=Het zou wel heel fijn|Ik vind het wel heel fijn|Het is wel heel fijn|Het was wel heel fijn|Dan is het wel heel fijn|Wat ik wel heel fijn|Maar het is wel heel fijn	Maak hier liever een volzin van, dat leest gemakkelijker.
Om je vingers=Het is echt om je vingers	Maak hier liever een volzin van, dat leest gemakkelijker.
Lijkt me best=Het lijkt me best|Dat lijkt me best	Maak hier liever een volzin van, dat leest gemakkelijker.
Kijken hoe de=Ze kijken hoe de|Ik ga kijken hoe de	Maak hier liever een volzin van, dat leest gemakkelijker.
Ook iets voor=Ik heb ook iets voor|Dat betekent ook iets voor|Is dit ook iets voor	Maak hier liever een volzin van, dat leest gemakkelijker.
Gaat weg voor=Deze gaat weg voor|Dit gaat weg voor|Alles gaat weg voor|Hij gaat weg voor	Maak hier liever een volzin van, dat leest gemakkelijker.
Snap niet wat=Ik snap niet wat	Maak hier liever een volzin van, dat leest gemakkelijker.
Kijken wat de=Ik ga eens kijken wat de|Je moet kijken wat de|Ik zal eens kijken wat de|Ik zal kijken wat de|Wij kijken wat de	Maak hier liever een volzin van, dat leest gemakkelijker.
Toch wel iets=Dat is toch wel iets|Er is toch wel iets|Er zal toch wel iets|Er moet toch wel iets|Dat zegt toch wel iets|Je kunt toch wel iets|Het heeft toch wel iets|Je hebt toch wel iets	Maak hier liever een volzin van, dat leest gemakkelijker.
Prijs is voor=Deze prijs is voor|De prijs is voor|De tweede prijs is voor|De genoemde prijs is voor	Maak hier liever een volzin van, dat leest gemakkelijker.
Lijkt me echt=Dat lijkt me echt|Het lijkt me echt|Dit lijkt me echt	Maak hier liever een volzin van, dat leest gemakkelijker.
Ook weer heel=Het is ook weer heel|Dit was ook weer heel|Deze is ook weer heel	Maak hier liever een volzin van, dat leest gemakkelijker.
Reden om eens=Het is de reden om eens	Maak hier liever een volzin van, dat leest gemakkelijker.
Veel te groot=Het is veel te groot|Dat is veel te groot|Het was veel te groot|Hij was veel te groot|Hij is veel te groot|Dat is een veel te groot|Ze zijn veel te groot	Maak hier liever een volzin van, dat leest gemakkelijker.
Dacht dat die=Ik dacht dat die|Maar ik dacht dat die|Hij dacht dat die	Maak hier liever een volzin van, dat leest gemakkelijker.
Heel knap dat=Het is heel knap dat	Maak hier liever een volzin van, dat leest gemakkelijker.
Elke dag open=Wij zijn elke dag open	Maak hier liever een volzin van, dat leest gemakkelijker.
Graag de naam=Ik zou graag de naam	Maak hier liever een volzin van, dat leest gemakkelijker.
Hopen dat dit=We moeten hopen dat dit	Maak hier liever een volzin van, dat leest gemakkelijker.
Kun je gelijk=Daar kun je gelijk|Dan kun je gelijk|Hier kun je gelijk|Zo kun je gelijk|Daarna kun je gelijk|Ook kun je gelijk	Maak hier liever een volzin van, dat leest gemakkelijker.
Meer weten of=Wil je meer weten of|Wilt u meer weten of	Maak hier liever een volzin van, dat leest gemakkelijker.
Echt een plek=Dit is echt een plek|Het is echt een plek	Maak hier liever een volzin van, dat leest gemakkelijker.
Vind het echt=Ik vind het echt	Maak hier liever een volzin van, dat leest gemakkelijker.
Echt een mooi=Dit is echt een mooi|Het is echt een mooi	Maak hier liever een volzin van, dat leest gemakkelijker.
Wist niet wat=Ik wist niet wat|Ze wist niet wat|Hij wist niet wat	Maak hier liever een volzin van, dat leest gemakkelijker.
Zal blij zijn=Ik zal blij zijn|Ze zal blij zijn|Hij zal blij zijn	Maak hier liever een volzin van, dat leest gemakkelijker.
Komt door het=Dat komt door het|Dit komt door het	Maak hier liever een volzin van, dat leest gemakkelijker.
Ben de eerste=Ik ben de eerste|Wees de eerste	Maak hier liever een volzin van, dat leest gemakkelijker.
Een heel fijn=Het is een heel fijn	Maak hier liever een volzin van, dat leest gemakkelijker.
Zo lekker dat=Het was zo lekker dat|Het is zo lekker dat|Het ging zo lekker dat|Ik vond het zo lekker dat|Ze waren zo lekker dat|Ze zijn zo lekker dat	Maak hier liever een volzin van, dat leest gemakkelijker.
Goed dat deze=Het is goed dat deze|Het is maar goed dat deze|Daarom is het goed dat deze|Ik vind het goed dat deze|Het is ook goed dat deze|Ik begrijp heel goed dat deze	Maak hier liever een volzin van, dat leest gemakkelijker.
Ziet er prima=Je ziet er prima|Het ziet er prima|Dat ziet er prima|Alles ziet er prima|Ze ziet er prima|Hij ziet er prima|Dit ziet er prima	Maak hier liever een volzin van, dat leest gemakkelijker.
Trots op onze=We zijn trots op onze|Wij zijn trots op onze|Ik ben trots op onze	Maak hier liever een volzin van, dat leest gemakkelijker.
Hopen dat die=Laten we hopen dat die|We hopen dat die|Het is te hopen dat die|Ik mag hopen dat die|Nu maar hopen dat die|Wij hopen dat die	Maak hier liever een volzin van, dat leest gemakkelijker.
Geeft wel een=Het geeft wel een|Dat geeft wel een|Dit geeft wel een	Maak hier liever een volzin van, dat leest gemakkelijker.
Wel een leuke=Het is wel een leuke	Maak hier liever een volzin van, dat leest gemakkelijker.
Komt omdat ik=Dat komt omdat ik|Dit komt omdat ik	Maak hier liever een volzin van, dat leest gemakkelijker.
Tijd om alles=Ik heb nu geen tijd om alles|Ik heb geen tijd om alles|Nu is het tijd om alles|Het is tijd om alles|Het werd tijd om alles|Het was tijd om alles|Er was geen tijd om alles|Dan is het tijd om alles|Het kost veel tijd om alles	Maak hier liever een volzin van, dat leest gemakkelijker.
Een spel waar=Het is een spel waar|Dit is een spel waar	Maak hier liever een volzin van, dat leest gemakkelijker.
Prima plek om=Het is een prima plek om|Dit is een prima plek om	Maak hier liever een volzin van, dat leest gemakkelijker.
Een erg leuk=Het is een erg leuk|Ik vind het een erg leuk|Het was een erg leuk	Maak hier liever een volzin van, dat leest gemakkelijker.
Goed om weer=Het is goed om weer|Het voelt goed om weer|Het was goed om weer	Maak hier liever een volzin van, dat leest gemakkelijker.
Vind ik leuk=Dat vind ik leuk|Dit vind ik leuk	Maak hier liever een volzin van, dat leest gemakkelijker.
Ligt aan het=Het ligt aan het|Dat ligt aan het|Dit ligt aan het	Maak hier liever een volzin van, dat leest gemakkelijker.
Ook wel eens=Ik heb ook wel eens|Dat is ook wel eens	Maak hier liever een volzin van, dat leest gemakkelijker.
Ben trots op=Ik ben trots op	Maak hier liever een volzin van, dat leest gemakkelijker.
Moet ik toch=Misschien moet ik toch|Dan moet ik toch|Dat moet ik toch|Daar moet ik toch	Maak hier liever een volzin van, dat leest gemakkelijker.
Doet het ook=Dat doet het ook|Hij doet het ook|Je doet het ook|Ze doet het ook|Die doet het ook	Maak hier liever een volzin van, dat leest gemakkelijker.
Tien tips om=Hier zijn tien tips om	Maak hier liever een volzin van, dat leest gemakkelijker.
Nog iets van=Heb je nog iets van|Is er nog iets van|Heb jij nog iets van|Hebt u nog iets van|Ik heb nog iets van|Herinner je je nog iets van|Weet je nog iets van	Maak hier liever een volzin van, dat leest gemakkelijker.
Tijd om hier=Het is tijd om hier|Het was tijd om hier|Het werd tijd om hier	Maak hier liever een volzin van, dat leest gemakkelijker.
Ziet er heel=Je ziet er heel|Het ziet er heel|Hij ziet er heel|Dat ziet er heel|Ze ziet er heel	Maak hier liever een volzin van, dat leest gemakkelijker.
Wel even wat=Dit is wel even wat|Dat is wel even wat|Dat was wel even wat|Het is wel even wat|Dit was wel even wat|Ik kijk wel even wat|Het kost wel even wat|Dat is toch wel even wat	Maak hier liever een volzin van, dat leest gemakkelijker.
Ben blij als=Ik ben blij als	Maak hier liever een volzin van, dat leest gemakkelijker.
Lijkt op een=Het lijkt op een|Hij lijkt op een	Maak hier liever een volzin van, dat leest gemakkelijker.
Stom dat hij=Het is stom dat hij	Maak hier liever een volzin van, dat leest gemakkelijker.
Wel een hele=Het is wel een hele|Dat is wel een hele	Maak hier liever een volzin van, dat leest gemakkelijker.
Een heel erg=Het was een heel erg|Het is een heel erg|Dit is een heel erg	Maak hier liever een volzin van, dat leest gemakkelijker.
Vond het een=Ik vond het een|Hij vond het een|Ze vond het een	Maak hier liever een volzin van, dat leest gemakkelijker.
Geen weer om=Het is geen weer om|Het was geen weer om|Dit is geen weer om	Maak hier liever een volzin van, dat leest gemakkelijker.
Denk dat het=Ik denk dat het|Maar ik denk dat het	Maak hier liever een volzin van, dat leest gemakkelijker.
Echt een dag=Het was echt een dag|Het is echt een dag	Maak hier liever een volzin van, dat leest gemakkelijker.
Lijkt net of=Het lijkt net of	Maak hier liever een volzin van, dat leest gemakkelijker.
Iets dat nog=Er is iets dat nog	Maak hier liever een volzin van, dat leest gemakkelijker.
Had ik nooit=Dat had ik nooit|Dit had ik nooit|Anders had ik nooit|Daar had ik nooit|Vroeger had ik nooit|Eerlijk gezegd had ik nooit|Zelf had ik nooit|Toch had ik nooit	Maak hier liever een volzin van, dat leest gemakkelijker.
Van alles te=Er is van alles te|Er was van alles te|Er valt van alles te|Er viel van alles te	Maak hier liever een volzin van, dat leest gemakkelijker.
Leuk dat het=Wat leuk dat het|Ik vind het leuk dat het|Het is leuk dat het|Wel leuk dat het	Maak hier liever een volzin van, dat leest gemakkelijker.
Toch nog wat=Er is toch nog wat|Ik heb toch nog wat|Wil je toch nog wat	Maak hier liever een volzin van, dat leest gemakkelijker.
Echt leuk om=Ik vind het echt leuk om|Het is echt leuk om|Het was echt leuk om|Dat is echt leuk om	Maak hier liever een volzin van, dat leest gemakkelijker.
Toch niet te=Het is toch niet te|Dat is toch niet te	Maak hier liever een volzin van, dat leest gemakkelijker.
Voer voor de=Dat is voer voor de|Het voer voor de|Dit is voer voor de|Als voer voor de	Maak hier liever een volzin van, dat leest gemakkelijker.
Super dat je=Het is geweldig dat je|Het is super dat je	Maak hier liever een volzin van, dat leest gemakkelijker.
Ook een mooi=Er is ook een mooi|Dat is ook een mooi|Het is ook een mooi	Maak hier liever een volzin van, dat leest gemakkelijker.
Trots dat ik=Ik ben trots dat ik|Ik was trots dat ik	Maak hier liever een volzin van, dat leest gemakkelijker.
Dus nog geen=Er is dus nog geen|Ik heb dus nog geen	Maak hier liever een volzin van, dat leest gemakkelijker.
Ziet er weer=Je ziet er weer|Het ziet er weer|Dat ziet er weer|Hij ziet er weer	Maak hier liever een volzin van, dat leest gemakkelijker.
Veel te kort=Dat is veel te kort|Het leven is veel te kort|Het is veel te kort|Dit is veel te kort|Je gaat veel te kort|Is dat niet veel te kort	Maak hier liever een volzin van, dat leest gemakkelijker.
Ligt ook een=Er ligt ook een|Het ligt ook een	Maak hier liever een volzin van, dat leest gemakkelijker.
Ziet er zeer=Dat ziet er zeer|Het ziet er zeer|Alles ziet er zeer	Maak hier liever een volzin van, dat leest gemakkelijker.
Vond het wel=Ik vond het wel|Maar ik vond het wel|Ze vond het wel|Hij vond het wel	Maak hier liever een volzin van, dat leest gemakkelijker.
Kan zowel in=Je kan zowel in|Dit kan zowel in|Dat kan zowel in|Het kan zowel in|Er kan zowel in|Hij kan zowel in	Maak hier liever een volzin van, dat leest gemakkelijker.
Ziet er leuk=Je ziet er leuk|Dat ziet er leuk|Het ziet er leuk|Hij ziet er leuk|Ze ziet er leuk	Maak hier liever een volzin van, dat leest gemakkelijker.
Klaar om het=Ben je klaar om het|We zijn klaar om het|Ik ben klaar om het|Ben jij klaar om het|Bent u klaar om het|Nu ben je klaar om het|Ze staan klaar om het|Wij staan voor u klaar om het|Nu bent u klaar om het	Maak hier liever een volzin van, dat leest gemakkelijker.
Nog net geen=Het is nog net geen	Maak hier liever een volzin van, dat leest gemakkelijker.
Hoop dat dat=Ik hoop dat dat	Maak hier liever een volzin van, dat leest gemakkelijker.
Fijn dat dat=Het is fijn dat dat	Maak hier liever een volzin van, dat leest gemakkelijker.
Nog niet aan=Ik ben er nog niet aan	Maak hier liever een volzin van, dat leest gemakkelijker.
Tijd om zelf=Nu is het tijd om zelf|Heeft u geen tijd om zelf|Heb je geen tijd om zelf|Het werd tijd om zelf|Dan is het tijd om zelf|Daarna was het tijd om zelf	Maak hier liever een volzin van, dat leest gemakkelijker.
Hoef je geen=Daar hoef je geen|Dan hoef je geen|Zo hoef je geen|Daarvoor hoef je geen|Hiervoor hoef je geen|Hier hoef je geen	Maak hier liever een volzin van, dat leest gemakkelijker.
Heb hem zelf=Ik heb hem zelf	Maak hier liever een volzin van, dat leest gemakkelijker.
Net alsof we=Het is net alsof we|Het was net alsof we|Het lijkt net alsof we|Het leek net alsof we	Maak hier liever een volzin van, dat leest gemakkelijker.
Vind ik niet=Dat vind ik niet	Maak hier liever een volzin van, dat leest gemakkelijker.
Goed om hier=Het is goed om hier|Het was goed om hier|Het voelt goed om hier|Het is dus goed om hier	Maak hier liever een volzin van, dat leest gemakkelijker.
Dacht ik ook=Dat dacht ik ook|Daar dacht ik ook	Maak hier liever een volzin van, dat leest gemakkelijker.
Leuk voor op=Dat is leuk voor op	Maak hier liever een volzin van, dat leest gemakkelijker.
Is toch niet=Het is toch niet|Dat is toch niet|Dit is toch niet	Maak hier liever een volzin van, dat leest gemakkelijker.
Ziet er toch=Het ziet er toch|Je ziet er toch|Dat ziet er toch|Dit ziet er toch	Maak hier liever een volzin van, dat leest gemakkelijker.
Staat ook op=Dat staat ook op|Het staat ook op|Hij staat ook op	Maak hier liever een volzin van, dat leest gemakkelijker.
Een feest om=Het is een feest om|Wat een feest om|Het was een feest om	Maak hier liever een volzin van, dat leest gemakkelijker.
Ook een hele=Het is ook een hele|Dat is ook een hele|Ik heb ook een hele|Het is dan ook een hele|Er is ook een hele|Het was dan ook een hele	Maak hier liever een volzin van, dat leest gemakkelijker.
Had ook niet=Ik had ook niet|Ze had ook niet|Het had ook niet|Hij had ook niet	Maak hier liever een volzin van, dat leest gemakkelijker.
Dan toch een=Als je dan toch een|Dat is dan toch een|Als er dan toch een|Als ik dan toch een|Zou het dan toch een|En als je dan toch een|Zou er dan toch een|En als er dan toch een	Maak hier liever een volzin van, dat leest gemakkelijker.
Dacht dat we=Ik dacht dat we|Hij dacht dat we	Maak hier liever een volzin van, dat leest gemakkelijker.
Was bang dat=Ik was bang dat|Ze was bang dat|Hij was bang dat|Men was bang dat	Maak hier liever een volzin van, dat leest gemakkelijker.
Leuk om daar=Het is leuk om daar|Ik vind het leuk om daar|Het was leuk om daar|Het leek me leuk om daar|Het lijkt me leuk om daar|Ik vond het leuk om daar	Maak hier liever een volzin van, dat leest gemakkelijker.
Niet half zo=Ik ben niet half zo|Je bent niet half zo|Hij was niet half zo|Het is niet half zo|Ze was niet half zo|Ze is niet half zo|Ze zijn niet half zo	Maak hier liever een volzin van, dat leest gemakkelijker.
Wist ik niet=Dat wist ik niet	Maak hier liever een volzin van, dat leest gemakkelijker.
Zal het eens=Ik zal het eens	Maak hier liever een volzin van, dat leest gemakkelijker.
Was een mooi=Het was een mooi|Dat was een mooi|Dit was een mooi|Er was een mooi	Maak hier liever een volzin van, dat leest gemakkelijker.
Iets met het=Ik heb iets met het|Er is iets met het|Is er iets met het|Het zal wel iets met het|Er was iets met het|Het heeft iets met het|Heeft het iets met het|Als er iets met het	Maak hier liever een volzin van, dat leest gemakkelijker.
Tijd om zich=Het is tijd om zich	Maak hier liever een volzin van, dat leest gemakkelijker.
Nooit te oud=Je bent nooit te oud|Men is nooit te oud|U bent nooit te oud|Dat je nooit te oud|Ik ben nooit te oud	Maak hier liever een volzin van, dat leest gemakkelijker.
Veel te mooi=Het is veel te mooi	Maak hier liever een volzin van, dat leest gemakkelijker.
Zal wel even=Ik zal wel even|Het zal wel even|Dat zal wel even|Maar het zal wel even|Hij zal wel even	Maak hier liever een volzin van, dat leest gemakkelijker.
Nog in goede=Deze zijn nog in goede	Maak hier liever een volzin van, dat leest gemakkelijker.
Ben blij met=Ik ben blij met	Maak hier liever een volzin van, dat leest gemakkelijker.
Lijkt mij de=Het lijkt mij de|Dat lijkt mij de	Maak hier liever een volzin van, dat leest gemakkelijker.
Voel me niet=Ik voel me niet|Maar ik voel me niet	Maak hier liever een volzin van, dat leest gemakkelijker.
Ziet er echt=Je ziet er echt|Het ziet er echt|Hij ziet er echt|Dat ziet er echt|Dit ziet er echt	Maak hier liever een volzin van, dat leest gemakkelijker.
Lijkt me wat=Dat lijkt me wat|Het lijkt me wat	Maak hier liever een volzin van, dat leest gemakkelijker.
Maar wel een=Nee, maar wel een|Jammer, maar wel een	Maak hier liever een volzin van, dat leest gemakkelijker.
Dacht al dat=Ik dacht al dat|Ja, ik dacht al dat|Ze dacht al dat	Maak hier liever een volzin van, dat leest gemakkelijker.
Lijkt me erg=Dat lijkt me erg|Het lijkt me erg	Maak hier liever een volzin van, dat leest gemakkelijker.
Goed voor uw=Dat is goed voor uw|Het is goed voor uw|Dit is goed voor uw	Maak hier liever een volzin van, dat leest gemakkelijker.
Toch iets om=Dat is toch iets om|Je moet toch iets om	Maak hier liever een volzin van, dat leest gemakkelijker.
Ooit van een=Heb je ooit van een|Ik heb ooit van een	Maak hier liever een volzin van, dat leest gemakkelijker.
Fijn dat die=Het is fijn dat die	Maak hier liever een volzin van, dat leest gemakkelijker.
Op zoek naar=Ik ben op zoek naar|Bent u op zoek naar|Wij zijn op zoek naar|Ben je op zoek naar|Ben jij op zoek naar|U bent op zoek naar	Maak hier liever een volzin van, dat leest gemakkelijker.
Genoeg om je=Ik ben oud genoeg om je|Reden genoeg om je|Redenen genoeg om je|Het is al moeilijk genoeg om je|Net genoeg om je|Er is genoeg om je|Het is genoeg om je	Maak hier liever een volzin van, dat leest gemakkelijker.
Ben het eens=Ik ben het eens	Maak hier liever een volzin van, dat leest gemakkelijker.
Leek wel een=Het leek wel een|Ik leek wel een|Ze leek wel een|Hij leek wel een	Maak hier liever een volzin van, dat leest gemakkelijker.
Wat super om=Wat is het super om	Maak hier liever een volzin van, dat leest gemakkelijker.
Dus echt een=Het is dus echt een|Dit is dus echt een|Er is dus echt een|Dat is dus echt een|Het was dus echt een|Dat was dus echt een|Dit was dus echt een	Maak hier liever een volzin van, dat leest gemakkelijker.
Spijt dat ik=Ik heb spijt dat ik	Maak hier liever een volzin van, dat leest gemakkelijker.
Iets wat zij=Dat is iets wat zij|Dat was iets wat zij	Maak hier liever een volzin van, dat leest gemakkelijker.
Vind het een=Ik vind het een	Maak hier liever een volzin van, dat leest gemakkelijker.
Valt wel mee=Dat valt wel mee|Het valt wel mee	Maak hier liever een volzin van, dat leest gemakkelijker.
Leuk voor in=Dat is leuk voor in|Ook leuk voor in|Erg leuk voor in	Maak hier liever een volzin van, dat leest gemakkelijker.
Prijs is per=De prijs is per|De getoonde prijs is per|Genoemde prijs is per|Deze prijs is per|De genoemde prijs is per	Maak hier liever een volzin van, dat leest gemakkelijker.
Niet meer of=Ik weet niet meer of|Ik wist niet meer of|Het is niet meer of|Hij wist niet meer of|Ze wist niet meer of|Ik herinner me niet meer of	Maak hier liever een volzin van, dat leest gemakkelijker.
Ziet er mooi=Je ziet er mooi|Het ziet er mooi|Dat ziet er mooi|Hij ziet er mooi	Maak hier liever een volzin van, dat leest gemakkelijker.
Best wel een=Het is best wel een|Ik ben best wel een|Dat is best wel een|Het was best wel een	Maak hier liever een volzin van, dat leest gemakkelijker.
Kan wel eens=Het kan wel eens|Dat kan wel eens|Dit kan wel eens|Ik kan wel eens|Er kan wel eens|Je kan wel eens	Maak hier liever een volzin van, dat leest gemakkelijker.
Niet zo maar=Dat is niet zo maar	Maak hier liever een volzin van, dat leest gemakkelijker.
Vind ik heel=Dat vind ik heel|Dit vind ik heel	Maak hier liever een volzin van, dat leest gemakkelijker.
Hangt ook af=Dat hangt ook af	Maak hier liever een volzin van, dat leest gemakkelijker.
Ben ook zeer=Ik ben ook zeer	Maak hier liever een volzin van, dat leest gemakkelijker.
Vragen of ze=Ik zal vragen of ze|Zal ik vragen of ze|Ik zal haar vragen of ze|We vragen of ze|Ze vragen of ze|Ik wilde haar vragen of ze|Ik zal eens vragen of ze|Hij wilde vragen of ze	Maak hier liever een volzin van, dat leest gemakkelijker.
Tijd om over=Het werd tijd om over|Er was geen tijd om over|Dan is het tijd om over|Ze had geen tijd om over|Ik had geen tijd om over|Hij had geen tijd om over|Het is tijd om over|Het was tijd om over	Maak hier liever een volzin van, dat leest gemakkelijker.
Heel leuk om=Het is heel leuk om|Ik vind het heel leuk om|Het was heel leuk om|Ik vond het heel leuk om	Maak hier liever een volzin van, dat leest gemakkelijker.
Maar leuk om=Maar het is leuk om	Maak hier liever een volzin van, dat leest gemakkelijker.
Leuk te zien=Het is leuk te zien|Het was leuk te zien	Maak hier liever een volzin van, dat leest gemakkelijker.
Wens je nog=Ik wens je nog	Maak hier liever een volzin van, dat leest gemakkelijker.
Iets dat me=Er is iets dat me|Er was iets dat me|Nog iets dat me|Het is iets dat me|Maar er is iets dat me|Dat is iets dat me|Het was iets dat me	Maak hier liever een volzin van, dat leest gemakkelijker.
Zin in meer=Heb je zin in meer	Maak hier liever een volzin van, dat leest gemakkelijker.
Ziet er wel=Het ziet er wel|Hij ziet er wel|Dat ziet er wel|Maar het ziet er wel	Maak hier liever een volzin van, dat leest gemakkelijker.
Zin om iets=Heb je zin om iets|Ik heb zin om iets|Het heeft geen zin om iets|Ik heb geen zin om iets|Ik had zin om iets|Het had geen zin om iets|Hij had zin om iets|Ze had zin om iets	Maak hier liever een volzin van, dat leest gemakkelijker.
Vind ik erg=Dat vind ik erg|Dit vind ik erg	Maak hier liever een volzin van, dat leest gemakkelijker.
Was niet zo=Het was niet zo|Dat was niet zo|Ik was niet zo|Hij was niet zo|Ze was niet zo|Dit was niet zo	Maak hier liever een volzin van, dat leest gemakkelijker.
Raar dat ik=Is het raar dat ik|Het is raar dat ik|Ik vind het raar dat ik	Maak hier liever een volzin van, dat leest gemakkelijker.
Vond ik ook=Dat vond ik ook	Maak hier liever een volzin van, dat leest gemakkelijker.
Zal ook wel=Dat zal ook wel|Het zal ook wel|Hij zal ook wel	Maak hier liever een volzin van, dat leest gemakkelijker.
Kan je weer=Nu kan je weer|Ik kan je weer|Dan kan je weer|Daarna kan je weer|Zo kan je weer|Ook hier kan je weer|Je kan je weer|Ook dit jaar kan je weer|Hier kan je weer	Maak hier liever een volzin van, dat leest gemakkelijker.
Stom van me=Het was stom van me|Het is stom van me	Maak hier liever een volzin van, dat leest gemakkelijker.
Kan ook met=Het kan ook met|Dat kan ook met|Je kan ook met|Dit kan ook met	Maak hier liever een volzin van, dat leest gemakkelijker.
Te vroeg om=Het is nog te vroeg om|Het is te vroeg om|Maar het is nog te vroeg om|Het is echter nog te vroeg om|Het is nu nog te vroeg om|Het was te vroeg om|Het was nog te vroeg om	Maak hier liever een volzin van, dat leest gemakkelijker.
Hoef ik ook=Dat hoef ik ook|Dan hoef ik ook|Daar hoef ik ook|Nu hoef ik ook|Meer hoef ik ook|Daarom hoef ik ook|Zo hoef ik ook	Maak hier liever een volzin van, dat leest gemakkelijker.
Ook al eens=Heb ik ook al eens|Heb je ook al eens|Ik ben ook al eens|Ik heb ook al eens|Ik heb het ook al eens|Ik had ook al eens|Ik heb er ook al eens|Heb jij ook al eens	Maak hier liever een volzin van, dat leest gemakkelijker.
Hoop dat ik=Ik hoop dat ik	Maak hier liever een volzin van, dat leest gemakkelijker.
Ook iets om=Dat is ook iets om	Maak hier liever een volzin van, dat leest gemakkelijker.
Ga ik zeker=Dat ga ik zeker|Daar ga ik zeker|Dit ga ik zeker|Die ga ik zeker|Deze ga ik zeker|Hier ga ik zeker	Maak hier liever een volzin van, dat leest gemakkelijker.
Is voor mij=Het is voor mij|Dat is voor mij|Dit is voor mij	Maak hier liever een volzin van, dat leest gemakkelijker.
Vond ik wel=Dat vond ik wel|Dit vond ik wel	Maak hier liever een volzin van, dat leest gemakkelijker.
Vind ik wel=Dat vind ik wel|Dit vind ik wel	Maak hier liever een volzin van, dat leest gemakkelijker.
Vond ik een=Dat vond ik een|Dit vond ik een	Maak hier liever een volzin van, dat leest gemakkelijker.
Tijd dat ik=In de tijd dat ik|Tegen de tijd dat ik|Er was een tijd dat ik|De tijd dat ik|Het werd tijd dat ik|Al die tijd dat ik	Maak hier liever een volzin van, dat leest gemakkelijker.
Blij dat we=Ik ben blij dat we|We zijn blij dat we	Maak hier liever een volzin van, dat leest gemakkelijker.
Kan ik weer=Nu kan ik weer|Dan kan ik weer	Maak hier liever een volzin van, dat leest gemakkelijker.
Ziet er erg=Het ziet er erg|Hij ziet er erg|Dat ziet er erg	Maak hier liever een volzin van, dat leest gemakkelijker.
Kom ik toch=Dan kom ik toch|Hoe kom ik toch|Maar dan kom ik toch|Zo kom ik toch|Nu kom ik toch|Uiteindelijk kom ik toch|En zo kom ik toch	Maak hier liever een volzin van, dat leest gemakkelijker.
Ook al geen=Dat is ook al geen	Maak hier liever een volzin van, dat leest gemakkelijker.
Ben er niet=Ik ben er niet|Maar ik ben er niet	Maak hier liever een volzin van, dat leest gemakkelijker.
Te groot om=Hij is te groot om|Het is te groot om|Hij was te groot om|Ze zijn te groot om|Het was te groot om|Ze waren te groot om	Maak hier liever een volzin van, dat leest gemakkelijker.
Vind ik ook=Dat vind ik ook	Maak hier liever een volzin van, dat leest gemakkelijker.
Is maar net=Het is maar net|Dat is maar net	Maak hier liever een volzin van, dat leest gemakkelijker.
Leuk om wat=Het is leuk om wat|Ik vind het leuk om wat|Het is altijd leuk om wat|Het lijkt me leuk om wat|Vind je het leuk om wat	Maak hier liever een volzin van, dat leest gemakkelijker.
Voor als de=Dit komt voor als de|Hij stelt zich voor als de|Hij stelde zich voor als de|Dat doet zich voor als de|Hij doet zich voor als de|Hij deed zich voor als de|Dit doet zich bijvoorbeeld voor als de|Dit is voor als de	Maak hier liever een volzin van, dat leest gemakkelijker.
Zie dat het=Ik zie dat het	Maak hier liever een volzin van, dat leest gemakkelijker.
Ben er zelf=Ik ben er zelf	Maak hier liever een volzin van, dat leest gemakkelijker.
Lijkt me zo=Het lijkt me zo|Dat lijkt me zo	Maak hier liever een volzin van, dat leest gemakkelijker.
Mooi om het=Het was mooi om het|Het is mooi om het|Ik vind het mooi om het|Wat mooi om het|Te mooi om het	Maak hier liever een volzin van, dat leest gemakkelijker.
Vind ik nog=Dat vind ik nog|Het ergste vind ik nog	Maak hier liever een volzin van, dat leest gemakkelijker.
Kan ook wel=Ik kan ook wel|Dat kan ook wel|Het kan ook wel|Hij kan ook wel|Maar het kan ook wel|Dit kan ook wel|Je kan ook wel|Maar ik kan ook wel	Maak hier liever een volzin van, dat leest gemakkelijker.
Niet weg te=Je hoeft niet weg te|Ze zijn niet weg te|Ze waren niet weg te|Hij is niet weg te|Het is niet weg te|Ze is niet weg te|Ik durfde niet weg te|Hij was niet weg te|Hij probeerde niet weg te	Maak hier liever een volzin van, dat leest gemakkelijker.
Al een idee=Heb je al een idee|Hebt u al een idee|Ik heb al een idee|Heeft u al een idee|Heb jij al een idee|Ik had al een idee|Heb je zelf al een idee	Maak hier liever een volzin van, dat leest gemakkelijker.
Moet ik dus=Dan moet ik dus|Daar moet ik dus|Nu moet ik dus|Dat moet ik dus|Die moet ik dus|Hier moet ik dus	Maak hier liever een volzin van, dat leest gemakkelijker.
Heb het ook=Ik heb het ook|En ik heb het ook	Maak hier liever een volzin van, dat leest gemakkelijker.
Te druk met=Ik had het te druk met|Ik ben te druk met|Hij is te druk met|Zij is te druk met|Hij had het te druk met	Maak hier liever een volzin van, dat leest gemakkelijker.
Zo weer een=Zo, weer een|Ik heb zo weer een|Hebt u zo weer een|Ik kan zo weer een|Ik zou zo weer een	Maak hier liever een volzin van, dat leest gemakkelijker.
Ben het met=Ik ben het met|Maar ik ben het met|En ik ben het met	Maak hier liever een volzin van, dat leest gemakkelijker.
Was wel een=Het was wel een|Dat was wel een|Er was wel een|Dit was wel een|Maar het was wel een	Maak hier liever een volzin van, dat leest gemakkelijker.
Thuis of in=Of je nu thuis of in	Maak hier liever een volzin van, dat leest gemakkelijker.
Ligt aan de=Het ligt aan de	Maak hier liever een volzin van, dat leest gemakkelijker.
Mooi om dit=Het is mooi om dit|Ik vind het mooi om dit	Maak hier liever een volzin van, dat leest gemakkelijker.
Ziet er ook=Je ziet er ook|Het ziet er ook|Hij ziet er ook|En het ziet er ook	Maak hier liever een volzin van, dat leest gemakkelijker.
Ziet er nog=Je ziet er nog|Het ziet er nog|Hij ziet er nog|Ze ziet er nog	Maak hier liever een volzin van, dat leest gemakkelijker.
Kun jij ook=Dan kun jij|Dat kun jij ook|Misschien kun jij ook|Dan kun jij ook|Zo kun jij ook|Daar kun jij ook	Maak hier liever een volzin van, dat leest gemakkelijker.
Vind het zo=Ik vind het zo|Maar ik vind het zo	Maak hier liever een volzin van, dat leest gemakkelijker.
Is toch ook=Dat is toch ook|Het is toch ook|Er is toch ook	Maak hier liever een volzin van, dat leest gemakkelijker.
Heb nog een=Ik heb nog een|En ik heb nog een	Maak hier liever een volzin van, dat leest gemakkelijker.
Leuk om nog=Het was leuk om nog|Vind je het leuk om nog|Het is leuk om nog	Maak hier liever een volzin van, dat leest gemakkelijker.
Te klein om=Ze zijn te klein om|Het is te klein om|Hij was te klein om|Hij is te klein om|Ik was te klein om|Ze waren te klein om|Hij is nog te klein om|Het was te klein om|Ze was te klein om	Maak hier liever een volzin van, dat leest gemakkelijker.
Goed om het=Het is goed om het|Het was goed om het|Daarom is het goed om het	Maak hier liever een volzin van, dat leest gemakkelijker.
Dus ook een=Dat is dus ook een|Het is dus ook een|Er is dus ook een|En dus ook een|Dit is dus ook een	Maak hier liever een volzin van, dat leest gemakkelijker.
Geen zin of=Heeft u geen zin of|Heb je geen zin of	Maak hier liever een volzin van, dat leest gemakkelijker.
En hier dan=En hier is dan|En hier zijn dan	Maak hier liever een volzin van, dat leest gemakkelijker.
Is nog niet=Het is nog niet	Maak hier liever een volzin van, dat leest gemakkelijker.
Goed in het=Je bent goed in het|Ik ben goed in het|Ik ben niet zo goed in het|Ik ben niet goed in het|Ben jij goed in het|We zijn goed in het|Hij is goed in het|Wij zijn goed in het|Ze zijn goed in het	Maak hier liever een volzin van, dat leest gemakkelijker.
Wel leuk om=Het is wel leuk om|Ik vind het wel leuk om|Dat is wel leuk om	Maak hier liever een volzin van, dat leest gemakkelijker.
Op zich wel=Het is op zich wel|Dat is op zich wel	Maak hier liever een volzin van, dat leest gemakkelijker.
Soms zo erg=Het is soms zo erg	Maak hier liever een volzin van, dat leest gemakkelijker.
Ook leuk om=Het is ook leuk om|Ik vind het ook leuk om	Maak hier liever een volzin van, dat leest gemakkelijker.
Leuk om ze=Het is leuk om ze|Ik vind het leuk om ze|Het was leuk om ze|Erg leuk om ze|Het was erg leuk om ze|Wat leuk om ze|Zo leuk om ze|Ik vond het leuk om ze	Maak hier liever een volzin van, dat leest gemakkelijker.
Nu te koop=Dit is nu te koop|Het is nu te koop	Maak hier liever een volzin van, dat leest gemakkelijker.
Een dag om=Het is een dag om|Het was een dag om	Maak hier liever een volzin van, dat leest gemakkelijker.
Kop in het=De kop in het|Met de kop in het|Je kop in het|Dat is je kop in het|Je kunt je kop in het|Een kop in het|Niet je kop in het|Niet de kop in het	Maak hier liever een volzin van, dat leest gemakkelijker.
Iets om de=Het is iets om de	Maak hier liever een volzin van, dat leest gemakkelijker.
Tijd om uw=Het is tijd om uw|Heeft u geen tijd om uw|Dan is het tijd om uw|Is het tijd om uw|Nu is het tijd om uw|Het is weer tijd om uw|Dan is het hoog tijd om uw|Wij nemen de tijd om uw	Maak hier liever een volzin van, dat leest gemakkelijker.
En ziet er=En het ziet er	Maak hier liever een volzin van, dat leest gemakkelijker.
Ben er ook=Ik ben er ook|En ik ben er ook|Maar ik ben er ook	Maak hier liever een volzin van, dat leest gemakkelijker.
Ga ik toch=Dan ga ik toch|Misschien ga ik toch|Dat ga ik toch|Nu ga ik toch|Daar ga ik toch|Maar nu ga ik toch|Volgende keer ga ik toch|Die ga ik toch	Maak hier liever een volzin van, dat leest gemakkelijker.
Is wel een=Het is wel een|Dat is wel een|Er is wel een|Dit is wel een|Maar het is wel een	Maak hier liever een volzin van, dat leest gemakkelijker.
Is ook een=Er is ook een|Het is ook een|Dat is ook een|Dit is ook een	Maak hier liever een volzin van, dat leest gemakkelijker.
Zal wel in=Het zal wel in|Ze zal wel in|Hij zal wel in|Ik zal wel in|Die zal wel in|Dat zal wel in|Dit zal wel in	Maak hier liever een volzin van, dat leest gemakkelijker.
Ziet er zo=Je ziet er zo|Het ziet er zo|Hij ziet er zo|Ze ziet er zo	Maak hier liever een volzin van, dat leest gemakkelijker.
Of ik wist=Hij vroeg of ik wist|Ze vroeg of ik wist|Hij vroeg me of ik wist	Maak hier liever een volzin van, dat leest gemakkelijker.
Zin om ook=Heb je zin om ook|Ik heb zin om ook|Ik krijg spontaan zin om ook	Maak hier liever een volzin van, dat leest gemakkelijker.
Kan er ook=Ik kan er ook|Je kan er ook|Dat kan er ook	Maak hier liever een volzin van, dat leest gemakkelijker.
Mooi om zo=Het is mooi om zo|Het was mooi om zo|Ik vind het mooi om zo	Maak hier liever een volzin van, dat leest gemakkelijker.
Is niet zo=Het is niet zo|Dat is niet zo	Maak hier liever een volzin van, dat leest gemakkelijker.
Zie dat er=Ik zie dat er	Maak hier liever een volzin van, dat leest gemakkelijker.
Te ver weg=Het is te ver weg|Hij was te ver weg|Ik was te ver weg|Het was te ver weg|Ze waren te ver weg|Ze was te ver weg|Hij was nog te ver weg|Ze zijn te ver weg	Maak hier liever een volzin van, dat leest gemakkelijker.
Ben er erg=Ik ben er erg	Maak hier liever een volzin van, dat leest gemakkelijker.
Ben ik met=Dat ben ik met	Maak hier liever een volzin van, dat leest gemakkelijker.
Zin om het=Het heeft geen zin om het|Ik heb geen zin om het|Heb je zin om het|Ik heb zin om het|Het had geen zin om het|Ik had zin om het	Maak hier liever een volzin van, dat leest gemakkelijker.
Net of dat=Het is net of dat|Het was net of dat|Het lijkt net of dat|Het leek net of dat	Maak hier liever een volzin van, dat leest gemakkelijker.
Te gek dat=Het is toch te gek dat|Ik vind het te gek dat|Het is te gek dat|Echt te gek dat|Het was toch te gek dat|Het is natuurlijk te gek dat|Wat te gek dat	Maak hier liever een volzin van, dat leest gemakkelijker.
Nu weer in=Ik ben nu weer|Ik ben nu weer in|Hij is nu weer in|Het is nu weer in|Ook nu weer in|We zijn nu weer in|Ik zit nu weer in|Als ik nu weer in	Maak hier liever een volzin van, dat leest gemakkelijker.
Fijn om de=Het is fijn om de|Het was fijn om de|Ik vind het fijn om de|Ik vond het fijn om de|Het is altijd fijn om de|Ze vond het fijn om de|Het was heel fijn om de	Maak hier liever een volzin van, dat leest gemakkelijker.
Wil ik ook=Dat wil ik ook|Daarom wil ik ook	Maak hier liever een volzin van, dat leest gemakkelijker.
Ziet er nu=Het ziet er nu|Je ziet er nu|Ze ziet er nu|Hij ziet er nu|Maar het ziet er nu|Alles ziet er nu	Maak hier liever een volzin van, dat leest gemakkelijker.
Nu ook met=En nu ook met|Het is er nu ook met|Zo is het nu ook met|Dat gebeurt nu ook met|Ik ben nu ook met	Maak hier liever een volzin van, dat leest gemakkelijker.
Had er ook=Ik had er ook|Je had er ook|Hij had er ook|Ze had er ook|Het had er ook	Maak hier liever een volzin van, dat leest gemakkelijker.
Was ook de=Dat was ook de|Het was ook de|Dit was ook de|Hij was ook de|Ze was ook de	Maak hier liever een volzin van, dat leest gemakkelijker.
Ziet er in=Het ziet er in|Je ziet er in|Ze ziet er in|Dat ziet er in|Dit ziet er in|Hij ziet er in	Maak hier liever een volzin van, dat leest gemakkelijker.
Ben er nog=Ik ben er nog|Maar ik ben er nog	Maak hier liever een volzin van, dat leest gemakkelijker.
Heb ik dus=Dat heb ik dus|Daar heb ik dus|Nu heb ik dus|Die heb ik dus	Maak hier liever een volzin van, dat leest gemakkelijker.
Doen ze in=Dat doen ze in|Wat doen ze in|Dit doen ze in|En dat doen ze in|Overwinteren doen ze in|En wat doen ze in	Maak hier liever een volzin van, dat leest gemakkelijker.
Is ook wel=Dat is ook wel|Het is ook wel|Dit is ook wel|Er is ook wel	Maak hier liever een volzin van, dat leest gemakkelijker.
Kan je dus=Dat kan je dus	Maak hier liever een volzin van, dat leest gemakkelijker.
Zou ik wel=Dat zou ik wel|Daar zou ik wel|Dan zou ik wel	Maak hier liever een volzin van, dat leest gemakkelijker.
Een man om=Hij was een man om|Ik zoek een man om|Het is moeilijk voor een man om	Maak hier liever een volzin van, dat leest gemakkelijker.
Kom ik ook=Dan kom ik ook|Daar kom ik ook|Daarom kom ik ook|Zo kom ik ook|Zelf kom ik ook|Daarmee kom ik ook|Misschien kom ik ook|Natuurlijk kom ik ook	Maak hier liever een volzin van, dat leest gemakkelijker.
Boek is in=Het boek is in	Maak hier liever een volzin van, dat leest gemakkelijker.
Ook aan te=Het is ook aan te|Daar zat ik ook aan te|Het is dan ook aan te|Ik zit er ook aan te|Het is daarom ook aan te|Daarom is het ook aan te	Maak hier liever een volzin van, dat leest gemakkelijker.
Snel op de=Wil je snel op de|Wilt u snel op de|Hij liep snel op de|Zo bent u snel op de|Ze keek snel op de	Maak hier liever een volzin van, dat leest gemakkelijker.
Voel me er=Ik voel me er|Maar ik voel me er|En ik voel me er	Maak hier liever een volzin van, dat leest gemakkelijker.
Zal ik wel=Dat zal ik wel|Daar zal ik wel|Dan zal ik wel|Die zal ik wel|Morgen zal ik wel|Nu zal ik wel|Natuurlijk zal ik wel|Maar dat zal ik wel	Maak hier liever een volzin van, dat leest gemakkelijker.
Zin om er=Het heeft zin om er|Ik heb zin om er|Het had zin om er|Heb je zin om er	Maak hier liever een volzin van, dat leest gemakkelijker.
Ben er al=Ik ben er al|Maar ik ben er al	Maak hier liever een volzin van, dat leest gemakkelijker.
Tof om te=Het is tof om te|Ik vond het tof om te|Ik vind het tof om te	Maak hier liever een volzin van, dat leest gemakkelijker.
Is ook al=Dat is ook al|Het is ook al|Er is ook al|Hij is ook al|Die is ook al|Dit is ook al|Ze is ook al	Maak hier liever een volzin van, dat leest gemakkelijker.
Net of we=Het is net of we|Het lijkt net of we|Het was net of we	Maak hier liever een volzin van, dat leest gemakkelijker.
Te gek om=Het is te gek om|Het was te gek om|Het lijkt me te gek om|Ik vind het te gek om|Eigenlijk is het te gek om	Maak hier liever een volzin van, dat leest gemakkelijker.
Nu al de=Dit is nu al de|Dat is nu al de|Het is nu al de|Dit was nu al de|Ik heb nu al de|Het was nu al de|Dat was nu al de	Maak hier liever een volzin van, dat leest gemakkelijker.
Verzendkosten zijn=De verzendkosten zijn|Eventuele verzendkosten zijn|Onze verzendkosten zijn	Maak hier liever een volzin van, dat leest gemakkelijker.
Misschien vanavond=Komt misschien vanavond	Maak hier liever een volzin van, dat leest gemakkelijker.
Genteresseerd in=Bent u genteresseerd in|Ben je genteresseerd in	Maak hier liever een volzin van, dat leest gemakkelijker.
Even controleren=Ik wilde even controleren|Ik wil even controleren|Wil je even controleren	Maak hier liever een volzin van, dat leest gemakkelijker.
Prima restaurant=Het is een prima restaurant	Maak hier liever een volzin van, dat leest gemakkelijker.
Verkrijgbaar van=Ze zijn verkrijgbaar van	Maak hier liever een volzin van, dat leest gemakkelijker.
Verkrijgbaar bij=Het is verkrijgbaar bij|Deze zijn verkrijgbaar bij|Ze zijn verkrijgbaar bij|Deze is verkrijgbaar bij	Maak hier liever een volzin van, dat leest gemakkelijker.
Heerlijk gegeten=We hebben heerlijk gegeten|Ik heb heerlijk gegeten|Wij hebben heerlijk gegeten	Maak hier liever een volzin van, dat leest gemakkelijker.
Een inspirerende=Het was een inspirerende|Wat een inspirerende|Het is een inspirerende|Na een inspirerende|In een inspirerende	Maak hier liever een volzin van, dat leest gemakkelijker.
Gemakkelijk mee=Het is gemakkelijk mee	Maak hier liever een volzin van, dat leest gemakkelijker.
Nooit gebruikt,=Ik heb het nog nooit gebruikt,	Maak hier liever een volzin van, dat leest gemakkelijker.
Binnenkort toch=Ik ga binnenkort toch	Maak hier liever een volzin van, dat leest gemakkelijker.
Niks bijzonders=Het is niets bijzonders|Ik heb niks bijzonders|Het is niks bijzonders|Verder niks bijzonders|Dat is niks bijzonders|Er was niks bijzonders|Er is niks bijzonder|Er is niets bijzonder|Op zich niks bijzonders|Er is niks bijzonders	Maak hier liever een volzin van, dat leest gemakkelijker.
Helemaal gelijk=Je hebt helemaal gelijk|Daar heb je helemaal gelijk	Maak hier liever een volzin van, dat leest gemakkelijker.
Niets veranderd=Er is niets veranderd|Er was niets veranderd	Maak hier liever een volzin van, dat leest gemakkelijker.
Een veelzijdige=Het is een veelzijdige	Maak hier liever een volzin van, dat leest gemakkelijker.
Goede kwaliteit=Een goede kwaliteit|Zeer goede kwaliteit|De goede kwaliteit|Het is een goede kwaliteit|Het was van goede kwaliteit|Ze zijn van goede kwaliteit	Maak hier liever een volzin van, dat leest gemakkelijker.
Klinkt heerlijk=Dat klinkt heerlijk|Het klinkt heerlijk|Dit klinkt heerlijk	Maak hier liever een volzin van, dat leest gemakkelijker.
Altijd heerlijk=Ik vond het altijd heerlijk|Ik vind het altijd heerlijk|Het is altijd heerlijk|Ik heb het altijd heerlijk|Ze vond het altijd heerlijk|Het was altijd heerlijk|Ze had het altijd heerlijk	Maak hier liever een volzin van, dat leest gemakkelijker.
Wordt verzonden=Dit wordt verzonden|Deze wordt verzonden	Maak hier liever een volzin van, dat leest gemakkelijker.
Iemand ervaring=Heeft iemand ervaring|Heeft er iemand ervaring	Maak hier liever een volzin van, dat leest gemakkelijker.
Klinkt allemaal=Het klinkt allemaal|Dat klinkt allemaal|Dit klinkt allemaal	Maak hier liever een volzin van, dat leest gemakkelijker.
Rustige camping=Het is een rustige camping	Maak hier liever een volzin van, dat leest gemakkelijker.
Duidelijk geen=Het was duidelijk geen|Het is duidelijk geen|Hij had duidelijk geen|Dit is duidelijk geen	Maak hier liever een volzin van, dat leest gemakkelijker.
Beetje vreemde=Een beetje vreemde|Dat is een beetje vreemde|Het is een beetje vreemde	Maak hier liever een volzin van, dat leest gemakkelijker.
Prachtige plek=Het is een prachtige plek|Dit is een prachtige plek	Maak hier liever een volzin van, dat leest gemakkelijker.
Misschien zelf=Je hebt misschien zelf|Je hebt het misschien zelf|Heb je misschien zelf|Of heb je misschien zelf|Mag ik misschien zelf|Of ben je misschien zelf|Zoals je misschien zelf|U heeft misschien zelf|Wilt u misschien zelf	Maak hier liever een volzin van, dat leest gemakkelijker.
Eigenlijk geen=Ik heb eigenlijk geen|Het is eigenlijk geen|Er is eigenlijk geen	Maak hier liever een volzin van, dat leest gemakkelijker.
Klopt helemaal=Dat klopt helemaal|Het klopt helemaal|Er klopt helemaal|Dit klopt helemaal	Maak hier liever een volzin van, dat leest gemakkelijker.
Goed voornemen=Het is een goed voornemen	Maak hier liever een volzin van, dat leest gemakkelijker.
Nieuwprijs was=De nieuwprijs was	Maak hier liever een volzin van, dat leest gemakkelijker.
Inderdaad heel=Het is inderdaad heel|Dat is inderdaad heel	Maak hier liever een volzin van, dat leest gemakkelijker.
Medelijden met=Ik heb medelijden met|Ik had medelijden met|Heb je medelijden met	Maak hier liever een volzin van, dat leest gemakkelijker.
Voor herhaling=Dat is voor herhaling	Maak hier liever een volzin van, dat leest gemakkelijker.
Direct inzicht=U heeft direct inzicht|U krijgt direct inzicht|Je krijgt direct inzicht|Je hebt direct inzicht|Zo heeft u direct inzicht|Hiermee heeft u direct inzicht|Het geeft direct inzicht|U hebt direct inzicht	Maak hier liever een volzin van, dat leest gemakkelijker.
Dagelijks open=Wij zijn dagelijks open	Maak hier liever een volzin van, dat leest gemakkelijker.
Heerlijk weer=Het is heerlijk weer|Wat een heerlijk weer|Het was heerlijk weer	Maak hier liever een volzin van, dat leest gemakkelijker.
Knap staaltje=Een knap staaltje|Dat is een knap staaltje	Maak hier liever een volzin van, dat leest gemakkelijker.
Is natuurlijk=Het is natuurlijk|Dat is natuurlijk|Dit is natuurlijk	Maak hier liever een volzin van, dat leest gemakkelijker.
Gaat allemaal=Het gaat allemaal|Dat gaat allemaal|Dit gaat allemaal	Maak hier liever een volzin van, dat leest gemakkelijker.
Plaats genoeg=Er is plaats genoeg|Er was plaats genoeg	Maak hier liever een volzin van, dat leest gemakkelijker.
Dringend tijd=Het is dringend tijd|Dan is het dringend tijd|Het werd dringend tijd|Het is dus dringend tijd|Het was dringend tijd	Maak hier liever een volzin van, dat leest gemakkelijker.
Gevoelig voor=Ik ben gevoelig voor|Ben je gevoelig voor|Ik ben erg gevoelig voor|Ze zijn gevoelig voor|Het is gevoelig voor|IK ben gevoelig voor	Maak hier liever een volzin van, dat leest gemakkelijker.
Zal inderdaad=Het zal inderdaad|Dat zal inderdaad|Ik zal inderdaad|Er zal inderdaad|Je zal inderdaad|Hij zal inderdaad	Maak hier liever een volzin van, dat leest gemakkelijker.
Ook bruikbaar=Het is ook bruikbaar	Maak hier liever een volzin van, dat leest gemakkelijker.
Foto's volgen=De foto's volgen|Meer foto's volgen	Maak hier liever een volzin van, dat leest gemakkelijker.
Kunnen andere=Er kunnen andere|Wij kunnen andere|Dat kunnen andere|Ze kunnen andere|Dit kunnen andere|Op deze manier kunnen andere|Op die manier kunnen andere	Maak hier liever een volzin van, dat leest gemakkelijker.
Beetje zielig=Ik vind het een beetje zielig	Maak hier liever een volzin van, dat leest gemakkelijker.
Was inderdaad=Het was inderdaad|Dat was inderdaad|Ik was inderdaad|Er was inderdaad|Hij was inderdaad	Maak hier liever een volzin van, dat leest gemakkelijker.
Gewonnen door=Het toernooi werd gewonnen door|Deze editie werd gewonnen door|Deze werd gewonnen door|Het dubbelspel werd gewonnen door|Deze wedstrijd werd gewonnen door|Het enkelspel werd gewonnen door|Het werd gewonnen door|Hij werd gewonnen door	Maak hier liever een volzin van, dat leest gemakkelijker.
Komt allemaal=Het komt allemaal|Dat komt allemaal|Dit komt allemaal|En dat komt allemaal	Maak hier liever een volzin van, dat leest gemakkelijker.
Prachtig mooi=Het is prachtig mooi|Wat een prachtig mooi	Maak hier liever een volzin van, dat leest gemakkelijker.
Prima service=Dat is een prima service|Een prima service	Maak hier liever een volzin van, dat leest gemakkelijker.
Mooie website=Je hebt een mooie website|Het is een mooie website	Maak hier liever een volzin van, dat leest gemakkelijker.
Beetje vreemd=Het is een beetje vreemd	Maak hier liever een volzin van, dat leest gemakkelijker.
Heerlijk voor=Wat heerlijk voor|Het is heerlijk voor	Maak hier liever een volzin van, dat leest gemakkelijker.
Gemiste kans,=Dat is een gemiste kans,	Maak hier liever een volzin van, dat leest gemakkelijker.
Inderdaad erg=Het is inderdaad erg	Maak hier liever een volzin van, dat leest gemakkelijker.
Prachtig stuk=Het is een prachtig stuk|Het was een prachtig stuk|Dit is een prachtig stuk|Je hebt een prachtig stuk	Maak hier liever een volzin van, dat leest gemakkelijker.
Bestand tegen=Het is bestand tegen|Ze zijn bestand tegen	Maak hier liever een volzin van, dat leest gemakkelijker.
Te downloaden=Het is te downloaden|Deze is te downloaden|Deze zijn te downloaden|Dit formulier is te downloaden	Maak hier liever een volzin van, dat leest gemakkelijker.
Mooi staaltje=Het is een mooi staaltje|Het was een mooi staaltje|Dit is een mooi staaltje|Dat is een mooi staaltje	Maak hier liever een volzin van, dat leest gemakkelijker.
Gewoon lekker=Ik ga gewoon|Het is gewoon lekker|Ik wil gewoon lekker|Ga gewoon lekker|Ik ga gewoon lekker|Ik zou gewoon lekker	Maak hier liever een volzin van, dat leest gemakkelijker.
Helemaal waar=Dat is helemaal waar|Ik begrijp niet helemaal waar	Maak hier liever een volzin van, dat leest gemakkelijker.
Valt allemaal=Het valt allemaal|Dat valt allemaal|Dit valt allemaal	Maak hier liever een volzin van, dat leest gemakkelijker.
Harde werkers=Het zijn harde werkers	Maak hier liever een volzin van, dat leest gemakkelijker.
Bediening was=De bediening was|Ook de bediening was	Maak hier liever een volzin van, dat leest gemakkelijker.
Dodelijk voor=Dat is dodelijk voor|Is dat dodelijk voor	Maak hier liever een volzin van, dat leest gemakkelijker.
Mooie scherpe=Het is een mooie scherpe|Wat een mooie scherpe	Maak hier liever een volzin van, dat leest gemakkelijker.
Een sportieve=Het was een sportieve|In een sportieve|Het is een sportieve|Na een sportieve|Voor een sportieve	Maak hier liever een volzin van, dat leest gemakkelijker.
Afgewerkt met=Het is afgewerkt met|Het geheel is afgewerkt met	Maak hier liever een volzin van, dat leest gemakkelijker.
Heerlijk warm=Het is een heerlijk warm|Een heerlijk warm|Het was heerlijk warm|Het is heerlijk warm|Het water is heerlijk warm	Maak hier liever een volzin van, dat leest gemakkelijker.
Personeel erg=Het personeel is erg	Maak hier liever een volzin van, dat leest gemakkelijker.
Geen prettige=Het is geen prettige|Het was geen prettige	Maak hier liever een volzin van, dat leest gemakkelijker.
Spannend voor=Wat spannend voor|Dat is spannend voor|Het is spannend voor|Het was spannend voor	Maak hier liever een volzin van, dat leest gemakkelijker.
Eigenlijk ook=Dat is eigenlijk ook|Ik ben eigenlijk ook|Het is eigenlijk ook	Maak hier liever een volzin van, dat leest gemakkelijker.
Voorwaar geen=Het is voorwaar geen|Ik ben voorwaar geen|Dat is voorwaar geen	Maak hier liever een volzin van, dat leest gemakkelijker.
Leuk gedaan,=Het is leuk gedaan,	Maak hier liever een volzin van, dat leest gemakkelijker.
Dik tevreden=Ik ben dik tevreden	Maak hier liever een volzin van, dat leest gemakkelijker.
Wel gezellig=Ik vind het wel gezellig|Het was wel gezellig|Dat is wel gezellig|Was wel gezellig|Het is wel gezellig|Maar wel gezellig	Maak hier liever een volzin van, dat leest gemakkelijker.
Aangepast op=Dit werd aangepast op|Dit is aangepast op	Maak hier liever een volzin van, dat leest gemakkelijker.
Gemiste kans=Een gemiste kans|Het is een gemiste kans|Dat is een gemiste kans	Maak hier liever een volzin van, dat leest gemakkelijker.
Zeer slechte=Dit is een zeer slechte|Dat is een zeer slechte|Dat zijn zeer slechte|Het is een zeer slechte|Ondanks het zeer slechte|Ik heb zeer slechte	Maak hier liever een volzin van, dat leest gemakkelijker.
Veel geleerd=Ik heb veel geleerd|We hebben veel geleerd	Maak hier liever een volzin van, dat leest gemakkelijker.
Was heerlijk=Het was heerlijk	Maak hier liever een volzin van, dat leest gemakkelijker.
Hier gegeten=Wij hebben hier gegeten|Ik heb hier gegeten	Maak hier liever een volzin van, dat leest gemakkelijker.
Wel benieuwd=Ik ben wel benieuwd|Ik ben ook wel benieuwd|Ik ben eigenlijk wel benieuwd|Ik was wel benieuwd	Maak hier liever een volzin van, dat leest gemakkelijker.
Beetje zoals=Het is een beetje zoals	Maak hier liever een volzin van, dat leest gemakkelijker.
Goed gegeten=Je hebt goed gegeten|Er werd goed gegeten	Maak hier liever een volzin van, dat leest gemakkelijker.
Foto's komen=De foto's komen|Deze foto's komen|Alle foto's komen	Maak hier liever een volzin van, dat leest gemakkelijker.
Geen geringe=Dat is geen geringe|Het is geen geringe|Dat was geen geringe	Maak hier liever een volzin van, dat leest gemakkelijker.
Materiaal is=Het materiaal is|Dit materiaal is	Maak hier liever een volzin van, dat leest gemakkelijker.
Ook heerlijk=Ik vind het ook heerlijk|Het is ook heerlijk|Het was ook heerlijk|Dat is ook heerlijk|Maar ook heerlijk	Maak hier liever een volzin van, dat leest gemakkelijker.
Altijd klaar=Ik sta altijd klaar|Ze staat altijd klaar|Wij staan altijd klaar|Hij staat altijd klaar|Ze staan altijd klaar|Hij stond altijd klaar|Ze stond altijd klaar	Maak hier liever een volzin van, dat leest gemakkelijker.
Een streling=Het is een streling|Als een streling	Maak hier liever een volzin van, dat leest gemakkelijker.
Gesloten van=Wij zijn gesloten van|Wegens vakantie zijn wij gesloten van	Maak hier liever een volzin van, dat leest gemakkelijker.
Kan gebeuren=Het kan gebeuren|Dat kan gebeuren|Dit kan gebeuren	Maak hier liever een volzin van, dat leest gemakkelijker.
Bijna jammer=Ik vind het bijna jammer|Het is bijna jammer|Ik vond het bijna jammer|Het was bijna jammer|Ze vond het bijna jammer	Maak hier liever een volzin van, dat leest gemakkelijker.
Geen vrouwen=Er zijn geen vrouwen|Er waren geen vrouwen|Als er geen vrouwen	Maak hier liever een volzin van, dat leest gemakkelijker.
Geen reactie=Ik heb nog geen reactie|Er kwam geen reactie|Er is geen reactie|Ik heb geen reactie	Maak hier liever een volzin van, dat leest gemakkelijker.
Allemaal net=Het is allemaal net|Het was allemaal net|Ze zijn allemaal net|Het ging allemaal net|Het leek allemaal net|Het gaat allemaal net|Het is het allemaal net|Het was het allemaal net	Maak hier liever een volzin van, dat leest gemakkelijker.
Mooie kamer,=Het was een mooie kamer,	Maak hier liever een volzin van, dat leest gemakkelijker.
Heerlijk bij=Dat is heerlijk bij|Dit smaakt heerlijk bij|Deze is heerlijk bij|Het is heerlijk bij|Ze zijn heerlijk bij|Ik vind het heerlijk bij|Het was heerlijk bij	Maak hier liever een volzin van, dat leest gemakkelijker.
Eenvoudig te=Het is eenvoudig te|Dit is eenvoudig te|Ze zijn eenvoudig te	Maak hier liever een volzin van, dat leest gemakkelijker.
Mooi portret=Het is een mooi portret	Maak hier liever een volzin van, dat leest gemakkelijker.
Heel normaal=Het is heel normaal|Dat is heel normaal|Dat was heel normaal	Maak hier liever een volzin van, dat leest gemakkelijker.
Past precies=Het past precies|Hij past precies|Dat past precies|Dit past precies	Maak hier liever een volzin van, dat leest gemakkelijker.
Scheelt toch=Dat scheelt toch|Het scheelt toch|Dit scheelt toch|En dat scheelt toch	Maak hier liever een volzin van, dat leest gemakkelijker.
Makkelijk in=Heel makkelijk in|Het is makkelijk in|Hij is makkelijk in	Maak hier liever een volzin van, dat leest gemakkelijker.
Versterkt de=Het versterkt de|Dit versterkt de|Dat versterkt de	Maak hier liever een volzin van, dat leest gemakkelijker.
Ben helemaal=Ik ben helemaal	Maak hier liever een volzin van, dat leest gemakkelijker.
Mooi project=Een mooi project|Het is een mooi project	Maak hier liever een volzin van, dat leest gemakkelijker.
Erg tevreden=Ik ben erg tevreden|We zijn erg tevreden|Wij zijn erg tevreden	Maak hier liever een volzin van, dat leest gemakkelijker.
Spannend dat=Ik vind het zo spannend dat	Maak hier liever een volzin van, dat leest gemakkelijker.
Hopelijk een=Het is dan hopelijk een|Er is dan hopelijk een|Het is hopelijk een|Dit is hopelijk een	Maak hier liever een volzin van, dat leest gemakkelijker.
Mooie tijden=Het zijn mooie tijden|Het waren mooie tijden|De mooie tijden	Maak hier liever een volzin van, dat leest gemakkelijker.
Volledig met=Ik ben het volledig met	Maak hier liever een volzin van, dat leest gemakkelijker.
Een leerzame=Het was een leerzame|Het is een leerzame	Maak hier liever een volzin van, dat leest gemakkelijker.
Volledig mee=Ik ben het er volledig mee	Maak hier liever een volzin van, dat leest gemakkelijker.
Is inderdaad=Het is inderdaad|Dat is inderdaad|Er is inderdaad|Dit is inderdaad	Maak hier liever een volzin van, dat leest gemakkelijker.
Grotere kans=Er bestaat een grotere kans|Er is een grotere kans|Je hebt een grotere kans|Ook is er een grotere kans|Dan heb je een grotere kans|Hierdoor is er een grotere kans|Ze hebben een grotere kans|Hierdoor heb je een grotere kans	Maak hier liever een volzin van, dat leest gemakkelijker.
Mooie schone=Het is een mooie schone	Maak hier liever een volzin van, dat leest gemakkelijker.
Erg aardige=Het is een erg aardige	Maak hier liever een volzin van, dat leest gemakkelijker.
Beetje rare=Het is een beetje rare	Maak hier liever een volzin van, dat leest gemakkelijker.
Plaats voor=Er is plaats voor	Maak hier liever een volzin van, dat leest gemakkelijker.
Zelf kiezen=Je mag zelf kiezen|U kunt zelf kiezen|Je kan zelf kiezen|Je kunt zelf kiezen|U mag zelf kiezen|Ze mogen zelf kiezen|Zo kunt u zelf kiezen	Maak hier liever een volzin van, dat leest gemakkelijker.
Toch liever=Ik heb toch liever|Heb je toch liever	Maak hier liever een volzin van, dat leest gemakkelijker.
Gebeurt ook=Dat gebeurt ook|Het gebeurt ook|Dit gebeurt ook|Maar het gebeurt ook	Maak hier liever een volzin van, dat leest gemakkelijker.
Voldoet aan=U voldoet aan|Je voldoet aan|Het voldoet aan|Hij voldoet aan|Als je voldoet aan	Maak hier liever een volzin van, dat leest gemakkelijker.
Niet anders=Ik kan niet anders|Het kan niet anders|Het is niet anders	Maak hier liever een volzin van, dat leest gemakkelijker.
Extra reden=Dat is een extra reden|Dit is een extra reden|Dat zou een extra reden|Het is een extra reden	Maak hier liever een volzin van, dat leest gemakkelijker.
Alleen veel=Het is alleen veel|Er is niet alleen veel|Er zijn niet alleen veel|Dat is niet alleen veel|Het is niet alleen veel|Ik heb alleen veel|Er zijn alleen veel|Dat kost niet alleen veel|Het kost alleen veel|Er is alleen veel|Dat is alleen veel	Maak hier liever een volzin van, dat leest gemakkelijker.
Blijft toch=Het blijft toch|Je blijft toch|Dat blijft toch	Maak hier liever een volzin van, dat leest gemakkelijker.
Zeer fraaie=Het is een zeer fraaie	Maak hier liever een volzin van, dat leest gemakkelijker.
Hoogtijd om=Hoog tijd om|Het is hoog tijd om	Maak hier liever een volzin van, dat leest gemakkelijker.
Muziek waar=Het is muziek waar	Maak hier liever een volzin van, dat leest gemakkelijker.
Spijtig dat=Het is spijtig dat|Ik vind het spijtig dat|Het is wel spijtig dat	Maak hier liever een volzin van, dat leest gemakkelijker.
Altijd mooi=Het is altijd mooi|Dat is altijd mooi	Maak hier liever een volzin van, dat leest gemakkelijker.
Weer lekker=Je bent weer lekker|Vandaag weer lekker|Het is weer lekker|Daarna weer lekker|Het was weer lekker|Ik ben weer lekker|Ik ga weer lekker	Maak hier liever een volzin van, dat leest gemakkelijker.
Omgeving is=De omgeving is|In de omgeving is	Maak hier liever een volzin van, dat leest gemakkelijker.
Klinkt best=Dat klinkt best|Het klinkt best|Dit klinkt best	Maak hier liever een volzin van, dat leest gemakkelijker.
Smaakt naar=Dit smaakt naar|Het smaakt naar|Dat smaakt naar	Maak hier liever een volzin van, dat leest gemakkelijker.
Klinkt echt=Dat klinkt echt|Het klinkt echt|Dit klinkt echt|Hij klinkt echt	Maak hier liever een volzin van, dat leest gemakkelijker.
Allemaal zo=Het is allemaal zo|Het was allemaal zo	Maak hier liever een volzin van, dat leest gemakkelijker.
Altijd snel=Wij zijn altijd snel|U kunt altijd snel|Je krijgt altijd snel|Ik kan altijd snel|Hij was altijd snel|Zo kunt u altijd snel	Maak hier liever een volzin van, dat leest gemakkelijker.
Helemaal te=Dat is helemaal te|Het is helemaal te|Het was helemaal te|En helemaal te|Om helemaal te|Niet helemaal te|Ik zit helemaal te|Ik sta helemaal te|Het is niet helemaal te	Maak hier liever een volzin van, dat leest gemakkelijker.
Gewoon geen=Ik heb gewoon geen|Er is gewoon geen|Ik ben gewoon geen	Maak hier liever een volzin van, dat leest gemakkelijker.
Gaat lekker=Het gaat lekker|Dat gaat lekker|Je gaat lekker|Hij gaat lekker	Maak hier liever een volzin van, dat leest gemakkelijker.
Helaas weer=Ik moet helaas weer|Het is helaas weer|Ik ben helaas weer|Het was helaas weer|Het zit er helaas weer	Maak hier liever een volzin van, dat leest gemakkelijker.
Geen oorlog=Er is geen oorlog|Het is geen oorlog|Als er geen oorlog	Maak hier liever een volzin van, dat leest gemakkelijker.
Geleverd in=Het wordt geleverd in	Maak hier liever een volzin van, dat leest gemakkelijker.
Laatste dag=De laatste dag|Op de laatste dag|Het is de laatste dag	Maak hier liever een volzin van, dat leest gemakkelijker.
Zicht vanaf=Het zicht vanaf	Maak hier liever een volzin van, dat leest gemakkelijker.
Kosten zijn=De kosten zijn|Deze kosten zijn	Maak hier liever een volzin van, dat leest gemakkelijker.
Overleed op=Zij overleed op|Hij overleed op	Maak hier liever een volzin van, dat leest gemakkelijker.
Schijnt wel=Het schijnt wel|Dat schijnt wel|Er schijnt wel|Hij schijnt wel|Je schijnt wel|Maar het schijnt wel|Dit schijnt wel	Maak hier liever een volzin van, dat leest gemakkelijker.
Eerder iets=Het is eerder iets|Ik heb nooit eerder iets|Ik had nooit eerder iets|Ik heb al eerder iets|Ik heb al eens eerder iets|Ik had nog nooit eerder iets|Ik had al eerder iets|Ik heb eerder iets|Ik had eerder iets	Maak hier liever een volzin van, dat leest gemakkelijker.
Geen genade=Er is geen genade|Er was geen genade|Hij heeft geen genade|Ze hebben geen genade|Ik heb geen genade|Hij kende geen genade	Maak hier liever een volzin van, dat leest gemakkelijker.
Zwembad was=Het zwembad was|In het zwembad was	Maak hier liever een volzin van, dat leest gemakkelijker.
Klinkt toch=Dat klinkt toch|Het klinkt toch|Dit klinkt toch	Maak hier liever een volzin van, dat leest gemakkelijker.
Heb genoten=Ik heb genoten	Maak hier liever een volzin van, dat leest gemakkelijker.
Is allemaal=Het is allemaal|Dat is allemaal|Dit is allemaal	Maak hier liever een volzin van, dat leest gemakkelijker.
Prachtig zo=Prachtig, zo|Het is prachtig zo	Maak hier liever een volzin van, dat leest gemakkelijker.
Kamers zijn=De kamers zijn|Alle kamers zijn|Deze kamers zijn	Maak hier liever een volzin van, dat leest gemakkelijker.
Heerlijk op=Het is heerlijk op|Ik vind het heerlijk op|Het was heerlijk op|We hebben heerlijk op	Maak hier liever een volzin van, dat leest gemakkelijker.
Geheel eens=Ik ben het geheel eens	Maak hier liever een volzin van, dat leest gemakkelijker.
Bestaat uit=Het bestaat uit	Maak hier liever een volzin van, dat leest gemakkelijker.
Mooie warme=De mooie warme|Een mooie warme|Het was een mooie warme|Op een mooie warme	Maak hier liever een volzin van, dat leest gemakkelijker.
Zwaar werk,=Het is zwaar werk,|Het was zwaar werk,|Dat was zwaar werk,	Maak hier liever een volzin van, dat leest gemakkelijker.
Bedden zijn=De bedden zijn|Alle bedden zijn	Maak hier liever een volzin van, dat leest gemakkelijker.
Is helemaal=Het is helemaal|Dat is helemaal|Er is helemaal|Hij is helemaal	Maak hier liever een volzin van, dat leest gemakkelijker.
Antwoord is=Het antwoord is|Mijn antwoord is	Maak hier liever een volzin van, dat leest gemakkelijker.
Service was=De service was	Maak hier liever een volzin van, dat leest gemakkelijker.
Onrust over=Er is veel onrust over	Maak hier liever een volzin van, dat leest gemakkelijker.
Ideale plek=Het is een ideale plek|Dit is een ideale plek|Het is de ideale plek|Dit is de ideale plek|Het was een ideale plek|Het was de ideale plek	Maak hier liever een volzin van, dat leest gemakkelijker.
Grootte van=De grootte van	Maak hier liever een volzin van, dat leest gemakkelijker.
Iemand tips=Heeft iemand tips|Heeft er iemand tips|Als iemand tips	Maak hier liever een volzin van, dat leest gemakkelijker.
Geen school=Er is geen school|Er was geen school|Als er geen school|Omdat er geen school	Maak hier liever een volzin van, dat leest gemakkelijker.
Heeft niets=Het heeft niets|Dit heeft niets|Dat heeft niets|Hij heeft niets|Ze heeft niets	Maak hier liever een volzin van, dat leest gemakkelijker.
Verder heel=Het is verder heel|Hij is verder heel|Zij is verder heel|Ik ben verder heel|Wat ik verder heel	Maak hier liever een volzin van, dat leest gemakkelijker.
Twijfel nog=Ik twijfel nog	Maak hier liever een volzin van, dat leest gemakkelijker.
Niet netjes=Het is niet netjes|Dat is niet netjes	Maak hier liever een volzin van, dat leest gemakkelijker.
Gegeten met=Ik heb gegeten met	Maak hier liever een volzin van, dat leest gemakkelijker.
Kost alleen=Dat kost alleen|Het kost alleen|Dit kost alleen	Maak hier liever een volzin van, dat leest gemakkelijker.
Werkt prima=Dit werkt prima|Het werkt prima|Dat werkt prima	Maak hier liever een volzin van, dat leest gemakkelijker.
Betreft een=Het betreft een|Dit betreft een	Maak hier liever een volzin van, dat leest gemakkelijker.
Ontbijt was=Het ontbijt was	Maak hier liever een volzin van, dat leest gemakkelijker.
Gevoerd met=Ik heb gesprekken gevoerd met|Er zijn gesprekken gevoerd met|Het is gevoerd met|De binnenkant is gevoerd met|De binnenzijde is gevoerd met	Maak hier liever een volzin van, dat leest gemakkelijker.
Werkt zowel=Je werkt zowel|Dit werkt zowel|Het werkt zowel|Hij werkt zowel|Ze werkt zowel	Maak hier liever een volzin van, dat leest gemakkelijker.
Klinkt weer=Het klinkt weer|Dat klinkt weer|Er klinkt weer	Maak hier liever een volzin van, dat leest gemakkelijker.
Mooi helder=Het was mooi helder|Het is mooi helder	Maak hier liever een volzin van, dat leest gemakkelijker.
Heeft toch=Dat heeft toch|Hij heeft toch|Het heeft toch|Ze heeft toch	Maak hier liever een volzin van, dat leest gemakkelijker.
Begint met=Het begint met|Je begint met|Hij begint met|Zij begint met	Maak hier liever een volzin van, dat leest gemakkelijker.
Geldt voor=Hetzelfde geldt voor|Dat geldt voor|Dit geldt voor|Datzelfde geldt voor	Maak hier liever een volzin van, dat leest gemakkelijker.
Ben gewoon=Ik ben gewoon	Maak hier liever een volzin van, dat leest gemakkelijker.
Staat toch=Er staat toch|Dat staat toch|Het staat toch	Maak hier liever een volzin van, dat leest gemakkelijker.
Ligging is=De ligging is	Maak hier liever een volzin van, dat leest gemakkelijker.
Stond niet=Ik stond niet|Hij stond niet|Er stond niet|Het stond niet|Ze stond niet	Maak hier liever een volzin van, dat leest gemakkelijker.
Beetje een=Het is een beetje een|Een beetje een	Maak hier liever een volzin van, dat leest gemakkelijker.
Geen mooie=Is dat geen mooie|Het is geen mooie|Dat is geen mooie|Ik heb geen mooie|Het was geen mooie|Als dat geen mooie	Maak hier liever een volzin van, dat leest gemakkelijker.
Zit altijd=Er zit altijd|Ik zit altijd|Hij zit altijd|Je zit altijd|Die zit altijd|Het zit altijd|Ze zit altijd	Maak hier liever een volzin van, dat leest gemakkelijker.
Perfect om=Het is perfect om|Ze zijn perfect om|Dit is perfect om|Hij is perfect om	Maak hier liever een volzin van, dat leest gemakkelijker.
Moest toch=Ik moest toch|Er moest toch|Hij moest toch|Ze moest toch	Maak hier liever een volzin van, dat leest gemakkelijker.
Liggen ook=Er liggen ook|Die liggen ook|Ze liggen ook	Maak hier liever een volzin van, dat leest gemakkelijker.
Weten niet=We weten niet	Maak hier liever een volzin van, dat leest gemakkelijker.
Mazzel dat=Je hebt mazzel dat|Ik heb de mazzel dat|Ik had mazzel dat|Ik had de mazzel dat|Ik heb mazzel dat	Maak hier liever een volzin van, dat leest gemakkelijker.
Zeker iets=Er is zeker iets|Het is zeker iets|Dat is zeker iets|Dit is zeker iets	Maak hier liever een volzin van, dat leest gemakkelijker.
Geloof ook=Ik geloof ook	Als dit geen aansporing is, dan is het beter om er een volzin van te maken.
Klinkt erg=Dat klinkt erg|Het klinkt erg|Je klinkt erg|Dit klinkt erg	Maak hier liever een volzin van, dat leest gemakkelijker.
Ook alweer=Hoe zat het ook alweer|Hoe zit het ook alweer|Wat was ook alweer|Dat is ook alweer|Wie zei ook alweer	Maak hier liever een volzin van, dat leest gemakkelijker.
Camping is=De camping is|Deze camping is|Onze camping is	Maak hier liever een volzin van, dat leest gemakkelijker.
Wordt niet=Er wordt niet|Word niet|Het wordt niet	Maak hier liever een volzin van, dat leest gemakkelijker.
Gelijk een=Net als een|Dat is gelijk een|Wilt u gelijk een|Ik heb gelijk een|En gelijk een|Ik kreeg gelijk een	Maak hier liever een volzin van, dat leest gemakkelijker.
Beide niet=Ze zijn beide niet|Als beide niet|Als n van beide niet|Het is beide niet	Maak hier liever een volzin van, dat leest gemakkelijker.
Lijken wel=Het lijken wel|We lijken wel|Jullie lijken wel|Ze lijken wel	Maak hier liever een volzin van, dat leest gemakkelijker.
Zou kunnen=Dat zou kunnen|Je zou kunnen	Maak hier liever een volzin van, dat leest gemakkelijker.
Klinkt ook=Dat klinkt ook|Het klinkt ook	Maak hier liever een volzin van, dat leest gemakkelijker.
Service is=De service is|Deze service is|Onze service is	Maak hier liever een volzin van, dat leest gemakkelijker.
Kan gewoon=Ik kan gewoon|Het kan gewoon|Je kan gewoon|Dit kan gewoon|Dat kan gewoon	Maak hier liever een volzin van, dat leest gemakkelijker.
Lekker met=Het gaat lekker met|Het is lekker met|Ik ga lekker met|Laat ze lekker met|Ik heb lekker met	Maak hier liever een volzin van, dat leest gemakkelijker.
Zorgt voor=Dit zorgt voor|Het zorgt voor|Dat zorgt voor	Maak hier liever een volzin van, dat leest gemakkelijker.
Gaat nooit=Dat gaat nooit|Het gaat nooit|Hij gaat nooit|Je gaat nooit	Maak hier liever een volzin van, dat leest gemakkelijker.
Fijn hotel=Het is een fijn hotel	Maak hier liever een volzin van, dat leest gemakkelijker.
Wordt toch=Het wordt toch|Je wordt toch|Dat wordt toch|Er wordt toch	Maak hier liever een volzin van, dat leest gemakkelijker.
Altijd wat=Er is altijd wat|Het is altijd wat|Ik heb altijd wat	Maak hier liever een volzin van, dat leest gemakkelijker.
Spijker op=Je slaat de spijker op	Maak hier liever een volzin van, dat leest gemakkelijker.
Wordt vast=Het wordt vast|Dat wordt vast|Dit wordt vast	Maak hier liever een volzin van, dat leest gemakkelijker.
Gekocht in=Het is gekocht in|Ik heb hem gekocht in|Ik heb ze gekocht in|Ik heb het gekocht in	Maak hier liever een volzin van, dat leest gemakkelijker.
Staat vast=Het staat vast|Dat staat vast|Er staat vast|Hij staat vast	Maak hier liever een volzin van, dat leest gemakkelijker.
Genoeg dus=Er is dus genoeg|Het is dus genoeg	Maak hier liever een volzin van, dat leest gemakkelijker.
Helaas een=Het is helaas een|Dat is helaas een	Maak hier liever een volzin van, dat leest gemakkelijker.
Erg slecht=Ik ben erg slecht|Dat is erg slecht|Ik heb erg slecht|Het is erg slecht|Het gaat erg slecht	Maak hier liever een volzin van, dat leest gemakkelijker.
Staat mooi=Het staat mooi|Dat staat mooi|Hij staat mooi	Maak hier liever een volzin van, dat leest gemakkelijker.
Snijdt het=Zo snijdt het|Dan snijdt het|Bovendien snijdt het|Hij snijdt het|Daarbij snijdt het|Ze snijdt het|Op deze manier snijdt het|Op die manier snijdt het	Maak hier liever een volzin van, dat leest gemakkelijker.
Werkt snel=Het werkt snel|Dat werkt snel|Hij werkt snel|Dit werkt snel	Maak hier liever een volzin van, dat leest gemakkelijker.
Mooie foto=Wat een mooie foto	Maak hier liever een volzin van, dat leest gemakkelijker.
Ook zoiets=Dat is ook zoiets|Er bestaat ook zoiets	Maak hier liever een volzin van, dat leest gemakkelijker.
Zeer klein=Het is een zeer klein|Er is een zeer klein|Dit was een zeer klein|Dit is een zeer klein|Ze zijn zeer klein|Het was een zeer klein	Maak hier liever een volzin van, dat leest gemakkelijker.
Geeft toch=Dat geeft toch|Het geeft toch|Dit geeft toch	Maak hier liever een volzin van, dat leest gemakkelijker.
Ruimte zat=Er is ruimte zat|Er is nog ruimte zat|In die ruimte zat	Maak hier liever een volzin van, dat leest gemakkelijker.
Werkt goed=Het werkt goed|Dat werkt goed|Dit werkt goed	Maak hier liever een volzin van, dat leest gemakkelijker.
Alles zeer=Alles is zeer|Je moet alles zeer|Het is alles zeer|Het was alles zeer	Maak hier liever een volzin van, dat leest gemakkelijker.
Klopt niet=Dat klopt niet|Het klopt niet|Dit klopt niet	Maak hier liever een volzin van, dat leest gemakkelijker.
Zwembad is=Het zwembad is|Bij het zwembad is	Maak hier liever een volzin van, dat leest gemakkelijker.
Veel leuke=Dat zijn veel|Ik heb veel leuke|We hebben veel leuke|Er zijn veel leuke|Er zijn heel veel leuke	Maak hier liever een volzin van, dat leest gemakkelijker.
Weg wegens=Het moet weg wegens	Maak hier liever een volzin van, dat leest gemakkelijker.
Was altijd=Ik was altijd|Het was altijd|Hij was altijd|Ze was altijd|Er was altijd|Dat was altijd|Zij was altijd	Maak hier liever een volzin van, dat leest gemakkelijker.
Zie jullie=Ik zie jullie	Maak hier liever een volzin van, dat leest gemakkelijker.
Wel lekker=Het is wel lekker|Ik vind het wel lekker|Het was wel lekker	Maak hier liever een volzin van, dat leest gemakkelijker.
Allebei op=Ze keken allebei op|Ze stonden allebei op|Ze waren allebei op	Maak hier liever een volzin van, dat leest gemakkelijker.
Hoor graag=Ik hoor graag	Maak hier liever een volzin van, dat leest gemakkelijker.
Dochter is=Mijn dochter is|Onze dochter is|Zijn dochter is	Maak hier liever een volzin van, dat leest gemakkelijker.
Lekker van=Geniet lekker van|Geniet maar lekker van|Je kunt er lekker van	Maak hier liever een volzin van, dat leest gemakkelijker.
Zeker meer=Er is zeker meer|Ik weet niet zeker meer|Er zijn zeker meer|Ik ga zeker meer	Maak hier liever een volzin van, dat leest gemakkelijker.
Ook altijd=Het is ook altijd|Ik heb ook altijd|U kunt ook altijd|Ik ben ook altijd|Dat is ook altijd	Maak hier liever een volzin van, dat leest gemakkelijker.
Voelt toch=Het voelt toch|Dat voelt toch|Je voelt toch|Dit voelt toch|U voelt toch|Maar het voelt toch|En dat voelt toch	Maak hier liever een volzin van, dat leest gemakkelijker.
Locatie is=De locatie is|Deze locatie is	Maak hier liever een volzin van, dat leest gemakkelijker.
Dacht echt=Ik dacht echt|Hij dacht echt	Maak hier liever een volzin van, dat leest gemakkelijker.
Vraagt die=Waarom vraagt die|Wat vraagt die|Hij vraagt die|Dat vraagt die|U vraagt die|Dan vraagt die	Maak hier liever een volzin van, dat leest gemakkelijker.
Altijd wel=Er is altijd wel|Het is altijd wel	Maak hier liever een volzin van, dat leest gemakkelijker.
Gezegd van=Dat kan niet worden gezegd van|Dat kon niet worden gezegd van|Ik heb gezegd van|Ik denk eerlijk gezegd van|Dit wordt gezegd van|Dit kan niet worden gezegd van|Ik ben eerlijk gezegd van|Ik was eerlijk gezegd van|Hij had gezegd van	Maak hier liever een volzin van, dat leest gemakkelijker.
Komt vaker=Het komt vaker|Dat komt vaker|Dit komt vaker|Deze aandoening komt vaker	Maak hier liever een volzin van, dat leest gemakkelijker.
Levert ook=Het levert ook|Dat levert ook|Dit levert ook|Hij levert ook|Het bedrijf levert ook	Maak hier liever een volzin van, dat leest gemakkelijker.
Komt ervan=Dat komt ervan	Maak hier liever een volzin van, dat leest gemakkelijker.
Gevoel dat=Ik heb het gevoel dat|Ik had het gevoel dat|Heb je het gevoel dat|Ze had het gevoel dat|Hij had het gevoel dat	Maak hier liever een volzin van, dat leest gemakkelijker.
Altijd bij=Ik ben altijd bij|Je kunt altijd bij|Zoals altijd bij|U kunt altijd bij|Het is altijd bij	Maak hier liever een volzin van, dat leest gemakkelijker.
Eerste dag=De eerste dag|Op de eerste dag|Vanaf de eerste dag|Het is de eerste dag	Maak hier liever een volzin van, dat leest gemakkelijker.
Ook gewoon=Je kunt ook gewoon|Het is ook gewoon|Je kan ook gewoon|Maar ook gewoon|Dat is ook gewoon	Maak hier liever een volzin van, dat leest gemakkelijker.
Geeft veel=Het geeft veel|Dat geeft veel|Dit geeft veel	Maak hier liever een volzin van, dat leest gemakkelijker.
Scheelt in=Dat scheelt in|Dit scheelt in	Maak hier liever een volzin van, dat leest gemakkelijker.
Werkt voor=Hij werkt voor|Het werkt voor|Zij werkt voor	Maak hier liever een volzin van, dat leest gemakkelijker.
Huis kopen=Een huis kopen|Wilt u een huis kopen|Ga je een huis kopen	Maak hier liever een volzin van, dat leest gemakkelijker.
Hebben een=We hebben een|Wij hebben een|Ze hebben een	Maak hier liever een volzin van, dat leest gemakkelijker.
Verheug me=Ik verheug me|En ik verheug me	Maak hier liever een volzin van, dat leest gemakkelijker.
Kan altijd=Het kan altijd|Ik kan altijd|Je kan altijd|Dat kan altijd|Er kan altijd	Maak hier liever een volzin van, dat leest gemakkelijker.
Beetje dom=Dat is een beetje dom	Maak hier liever een volzin van, dat leest gemakkelijker.
Geeft geen=Geef geen|Het geeft geen|Hij geeft geen	Maak hier liever een volzin van, dat leest gemakkelijker.
Goede zaak=Een goede zaak|Het is een goede zaak	Maak hier liever een volzin van, dat leest gemakkelijker.
Altijd tot=Dat leidt altijd tot|Dit leidt altijd tot	Maak hier liever een volzin van, dat leest gemakkelijker.
Maakt niks=Dat maakt niets|Het maakt niets|Dat maakt niks|Het maakt niks	Maak hier liever een volzin van, dat leest gemakkelijker.
Nooit echt=Er is nooit|Ik heb nooit echt|Ik ben nooit echt|Het is nooit echt	Maak hier liever een volzin van, dat leest gemakkelijker.
Schuld van=Dat is de schuld van|Is dat de schuld van	Maak hier liever een volzin van, dat leest gemakkelijker.
Nog vragen=Heeft u nog vragen|Heb je nog vragen|Als u nog vragen|Mocht u nog vragen|Als je nog vragen|Hebt u nog vragen|Mocht je nog vragen|Indien u nog vragen	Maak hier liever een volzin van, dat leest gemakkelijker.
Gaat zeker=Het gaat zeker|Dat gaat zeker|Je gaat zeker|Dit gaat zeker	Maak hier liever een volzin van, dat leest gemakkelijker.
Zeer fraai=Het is een zeer fraai	Maak hier liever een volzin van, dat leest gemakkelijker.
Ook ideaal=Het is ook ideaal|Dit is ook ideaal|Ze zijn ook ideaal|Het is dan ook ideaal	Maak hier liever een volzin van, dat leest gemakkelijker.
Hoort ook=Dat hoort ook|Je hoort ook|Daarbij hoort ook|Daar hoort ook	Maak hier liever een volzin van, dat leest gemakkelijker.
Doet mijn=Dat doet mijn|Het doet mijn|Je doet mijn|Ze doet mijn|Dit doet mijn|Hij doet mijn	Maak hier liever een volzin van, dat leest gemakkelijker.
Werkt nog=Het werkt nog|Hij werkt nog	Maak hier liever een volzin van, dat leest gemakkelijker.
Helpt bij=Het helpt bij	Maak hier liever een volzin van, dat leest gemakkelijker.
Bleek een=Het bleek een|Er bleek een|Dit bleek een|Dat bleek een|Hij bleek een	Maak hier liever een volzin van, dat leest gemakkelijker.
Toch best=Dat is toch best|Het is toch best	Maak hier liever een volzin van, dat leest gemakkelijker.
Echt weer=Het is echt weer|Ik moet echt weer|Het was echt weer|Dit is echt weer	Maak hier liever een volzin van, dat leest gemakkelijker.
Dag later=Toen ik een dag later|Hij werd een dag later|Hij overleed een dag later|Als je een dag later|Als ik een dag later|Toen ze een dag later|Ik heb een dag later|Het was een dag later|Als ze een dag later	Maak hier liever een volzin van, dat leest gemakkelijker.
Bevat ook=Het bevat ook|Het boek bevat ook	Maak hier liever een volzin van, dat leest gemakkelijker.
Hoefde ik=Dat hoefde ik|Dan hoefde ik|Gelukkig hoefde ik|Toen hoefde ik|Daar hoefde ik|Nu hoefde ik|Zo hoefde ik|Lang hoefde ik	Maak hier liever een volzin van, dat leest gemakkelijker.
Heeft mij=heeft mij|Hij heeft mij|Het heeft mij	Maak hier liever een volzin van, dat leest gemakkelijker.
Lengte is=De lengte is|De totale lengte is|De maximale lengte is	Maak hier liever een volzin van, dat leest gemakkelijker.
Weet echt=Ik weet echt|Je weet echt|Jij weet echt|Maar ik weet echt|Hij weet echt|Ze weet echt	Maak hier liever een volzin van, dat leest gemakkelijker.
Vraag is:=De vraag is:|Mijn vraag is:|De grote vraag is:|Maar de vraag is:	Maak hier liever een volzin van, dat leest gemakkelijker.
Best leuk=Het is best leuk|Dit is best leuk	Maak hier liever een volzin van, dat leest gemakkelijker.
Werkt bij=Je werkt bij|Hij werkt bij|Ze werkt bij|Het werkt bij	Maak hier liever een volzin van, dat leest gemakkelijker.
Trok zijn=Hij trok zijn	Maak hier liever een volzin van, dat leest gemakkelijker.
Gaat over=Het gaat over	Maak hier liever een volzin van, dat leest gemakkelijker.
Is alleen=Het is alleen|Dat is alleen|Er is alleen|Dit is alleen	Maak hier liever een volzin van, dat leest gemakkelijker.
Handig om=Het is handig om|Dit is handig om|Dat is handig om	Maak hier liever een volzin van, dat leest gemakkelijker.
Auteur is=De auteur is	Maak hier liever een volzin van, dat leest gemakkelijker.
Zegt veel=Het zegt veel|Dat zegt veel|Dit zegt veel|Hij zegt veel	Maak hier liever een volzin van, dat leest gemakkelijker.
Wordt dus=Dat wordt dus|Er wordt dus|Het wordt dus|Hete wordt dus	Maak hier liever een volzin van, dat leest gemakkelijker.
Lekker om=Het is lekker om	Maak hier liever een volzin van, dat leest gemakkelijker.
Schrok me=Ik schrok me	Maak hier liever een volzin van, dat leest gemakkelijker.
Uw ideale=Wij zijn uw ideale	Maak hier liever een volzin van, dat leest gemakkelijker.
Gaat toch=Ga toch|Je gaat toch|Het gaat toch|Dat gaat toch	Maak hier liever een volzin van, dat leest gemakkelijker.
Komt heel=Er komt heel|Het komt heel|Dat komt heel|Dit komt heel|Hij komt heel|Je komt heel|U komt heel	Maak hier liever een volzin van, dat leest gemakkelijker.
Net terug=Ik ben net terug|Ik kom net terug|We zijn net terug|Wij zijn net terug|Ben net terug|Hij is net terug|Zij is net terug	Maak hier liever een volzin van, dat leest gemakkelijker.
Tijd gaat=De tijd gaat|De laatste tijd gaat|De komende tijd gaat	Maak hier liever een volzin van, dat leest gemakkelijker.
Klopt ook=Dat klopt ook|En dat klopt ook|Het klopt ook|Dit klopt ook|En het klopt ook	Maak hier liever een volzin van, dat leest gemakkelijker.
Ging weer=Ik ging weer|Het ging weer|Ze ging weer|Hij ging weer	Maak hier liever een volzin van, dat leest gemakkelijker.
Alleen te=Het is alleen te|Dat heeft niet alleen te	Maak hier liever een volzin van, dat leest gemakkelijker.
Erg mooi,=Dat is erg mooi,	Maak hier liever een volzin van, dat leest gemakkelijker.
Zelden zo=Ik ben zelden zo|Ik heb zelden zo|Ik heb me zelden zo	Maak hier liever een volzin van, dat leest gemakkelijker.
Lijken me=Ze lijken me|Het lijken me|Dat lijken me|Deze lijken me	Maak hier liever een volzin van, dat leest gemakkelijker.
Kan niet,=Dat kan niet,|Het kan niet,|Nee, dat kan niet,|Dit kan niet,|Maar dat kan niet,	Maak hier liever een volzin van, dat leest gemakkelijker.
Kost wat,=Het kost wat,	Maak hier liever een volzin van, dat leest gemakkelijker.
Hangt van=Dat hangt van|Het hangt van|Dit hangt van	Maak hier liever een volzin van, dat leest gemakkelijker.
Kan zeker=Ik kan zeker|Dat kan zeker|Het kan zeker|Dit kan zeker	Maak hier liever een volzin van, dat leest gemakkelijker.
Erg goed,=Hij is erg goed,|Het gaat erg goed,|Het eten was erg goed,|Het eten is erg goed,|Het ging erg goed,|Dit werkt erg goed,|Hij was erg goed,|Hij doet het erg goed,|Het was erg goed,	Maak hier liever een volzin van, dat leest gemakkelijker.
Ja, klopt=Ja, dat klopt	Maak hier liever een volzin van, dat leest gemakkelijker.
Iemand al=Heeft iemand al|Is iemand al	Maak hier liever een volzin van, dat leest gemakkelijker.
Past goed=Dat past goed|Het past goed|Dit past goed	Maak hier liever een volzin van, dat leest gemakkelijker.
Komt mooi=Dat komt mooi|Het komt mooi|Dit komt mooi	Maak hier liever een volzin van, dat leest gemakkelijker.
Fijn weer=Het was fijn weer	Maak hier liever een volzin van, dat leest gemakkelijker.
Ook beter=Het is ook beter|Dat is ook beter|Het is dan ook beter|Je kunt ook beter|Daarom is het ook beter|Het zou dan ook beter|Het zou ook beter|Je kunt dan ook beter	Maak hier liever een volzin van, dat leest gemakkelijker.
Een genot=Wat een genot|Het is een genot|Het was een genot	Maak hier liever een volzin van, dat leest gemakkelijker.
Voer voor=Dat is voer voor|Dit is voer voor|Het is voer voor|Het voer voor	Maak hier liever een volzin van, dat leest gemakkelijker.
Is altijd=Het is altijd|Er is altijd|Dat is altijd	Maak hier liever een volzin van, dat leest gemakkelijker.
Paar keer=Ik ben een paar keer|Het is een paar keer	Maak hier liever een volzin van, dat leest gemakkelijker.
Gaat naar=Ga naar|Je gaat naar|Hij gaat naar|Het gaat naar|Zij gaat naar	Maak hier liever een volzin van, dat leest gemakkelijker.
Toch voor=Wat is dat toch voor|Het is toch voor	Maak hier liever een volzin van, dat leest gemakkelijker.
Toch mooi=Het is toch mooi|Dat is toch mooi|Het zou toch mooi|Wat zou het toch mooi	Maak hier liever een volzin van, dat leest gemakkelijker.
Staat wel=Er staat wel|Het staat wel|Daar staat wel	Maak hier liever een volzin van, dat leest gemakkelijker.
Komt neer=Dat komt neer|Dit komt neer|Het komt neer	Maak hier liever een volzin van, dat leest gemakkelijker.
Toch heel=Het is toch|Dat is toch heel|Het is toch heel|Ik heb toch heel	Maak hier liever een volzin van, dat leest gemakkelijker.
Zeer leuk=Een zeer leuk|Het was zeer leuk|Dat is zeer leuk	Maak hier liever een volzin van, dat leest gemakkelijker.
Gaan voor=Ga voor|We gaan voor|Wij gaan voor	Maak hier liever een volzin van, dat leest gemakkelijker.
Gaan naar=Wij gaan naar|Ze gaan naar|Die gaan naar|Deze gaan naar	Maak hier liever een volzin van, dat leest gemakkelijker.
Stamt uit=Het stamt uit	Maak hier liever een volzin van, dat leest gemakkelijker.
Voelde me=Ik voelde me	Maak hier liever een volzin van, dat leest gemakkelijker.
Komt niet=Het komt niet|Hij komt niet|Dat komt niet|Dit komt niet	Maak hier liever een volzin van, dat leest gemakkelijker.
Zoveel te=Er is zoveel te	Maak hier liever een volzin van, dat leest gemakkelijker.
Hoeft dus=Je hoeft dus|U hoeft dus|Het hoeft dus|Dat hoeft dus|Er hoeft dus|Men hoeft dus	Maak hier liever een volzin van, dat leest gemakkelijker.
Werkt dus=Dat werkt dus|Het werkt dus|Je werkt dus|Dit werkt dus	Maak hier liever een volzin van, dat leest gemakkelijker.
Niet duur=Dat is niet duur|Het is niet duur|Het hoeft niet duur|Ze zijn niet duur	Maak hier liever een volzin van, dat leest gemakkelijker.
Moest van=Ik moest van|Dat moest van|Hij moest van|Ze moest van	Maak hier liever een volzin van, dat leest gemakkelijker.
Kan nooit=Dat kan nooit|Het kan nooit|Ik kan nooit|Je kan nooit	Maak hier liever een volzin van, dat leest gemakkelijker.
Iets niet=Is er iets niet|Als je iets niet|Als iets niet|Als er iets niet	Maak hier liever een volzin van, dat leest gemakkelijker.
Dacht aan=Ik dacht aan|Ze dacht aan|Hij dacht aan	Maak hier liever een volzin van, dat leest gemakkelijker.
Kan best,=Dat kan best,|Het kan best,	Maak hier liever een volzin van, dat leest gemakkelijker.
Moet naar=Ik moet naar|Je moet naar|Hij moet naar|Het moet naar	Maak hier liever een volzin van, dat leest gemakkelijker.
Weer heel=Het was weer heel|We hebben weer heel|Er is weer heel|Het is weer heel|Er zijn weer heel|Ik heb weer heel	Maak hier liever een volzin van, dat leest gemakkelijker.
Heeft hem=Ze heeft hem|Hij heeft hem	Maak hier liever een volzin van, dat leest gemakkelijker.
Geen leuk=Het is geen leuk|Het was geen leuk	Maak hier liever een volzin van, dat leest gemakkelijker.
Staat nog=Er staat nog|Dat staat nog	Maak hier liever een volzin van, dat leest gemakkelijker.
Gaat weer=Het gaat weer|Ze gaat weer|Hij gaat weer	Maak hier liever een volzin van, dat leest gemakkelijker.
Zo netjes=Het is wel zo netjes	Maak hier liever een volzin van, dat leest gemakkelijker.
Zal zeker=Ik zal zeker|Het zal zeker|Dat zal zeker|Dit zal zeker	Maak hier liever een volzin van, dat leest gemakkelijker.
Ook leuke=Dat is ook een|Er zijn ook leuke|Dat zijn ook leuke	Maak hier liever een volzin van, dat leest gemakkelijker.
Werkt ook=Het werkt ook|Dit werkt ook|Hij werkt ook	Maak hier liever een volzin van, dat leest gemakkelijker.
Bleek hij=Later bleek hij|Al snel bleek hij|Ook bleek hij|Uiteindelijk bleek hij|Daar bleek hij|Bovendien bleek hij|Gelukkig bleek hij|Achteraf bleek hij|Toen bleek hij	Maak hier liever een volzin van, dat leest gemakkelijker.
Hangt ook=Dat hangt ook|Het hangt ook|Er hangt ook|Dit hangt ook	Maak hier liever een volzin van, dat leest gemakkelijker.
Heeft ook=Hij heeft ook|Het heeft ook|Dat heeft ook	Maak hier liever een volzin van, dat leest gemakkelijker.
Liep naar=Ik liep naar|Ze liep naar|Hij liep naar	Maak hier liever een volzin van, dat leest gemakkelijker.
Volle bak=Het was volle bak|Het is volle bak|Het was een volle bak	Maak hier liever een volzin van, dat leest gemakkelijker.
Beetje te=Het is een beetje te|Ik zit een beetje te	Maak hier liever een volzin van, dat leest gemakkelijker.
Klopt dus=Dat klopt dus|Het klopt dus|Dit klopt dus	Maak hier liever een volzin van, dat leest gemakkelijker.
Echt hele=Het is echt hele|Het zijn echt hele	Maak hier liever een volzin van, dat leest gemakkelijker.
Sfeer was=De sfeer was	Maak hier liever een volzin van, dat leest gemakkelijker.
Geen boom=Er was geen boom|Er is geen boom|Ik heb geen boom	Maak hier liever een volzin van, dat leest gemakkelijker.
Was zeker=Het was zeker|Dat was zeker|Hij was zeker|Dit was zeker	Maak hier liever een volzin van, dat leest gemakkelijker.
Komt vast=Het komt vast|Dat komt vast|Er komt vast|Hij komt vast	Maak hier liever een volzin van, dat leest gemakkelijker.
Lijkt ons=Het lijkt ons|Dat lijkt ons|Dit lijkt ons	Maak hier liever een volzin van, dat leest gemakkelijker.
Hoogte is=De hoogte is	Maak hier liever een volzin van, dat leest gemakkelijker.
Past niet=Het past niet|Dat past niet|Dit past niet	Maak hier liever een volzin van, dat leest gemakkelijker.
Laat zich=Hij laat zich|Het laat zich|Ze laat zich|Zij laat zich	Maak hier liever een volzin van, dat leest gemakkelijker.
Handig in=Het is handig in|Dit is vooral handig in|Dit is handig in|Dat is handig in	Maak hier liever een volzin van, dat leest gemakkelijker.
Ging naar=Ik ging naar|Hij ging naar|Ze ging naar	Maak hier liever een volzin van, dat leest gemakkelijker.
Kost geen=Het kost geen|Dat kost geen	Maak hier liever een volzin van, dat leest gemakkelijker.
Weinig te=Er valt weinig te|Er is weinig te|Er was weinig te|Dat heeft weinig te	Maak hier liever een volzin van, dat leest gemakkelijker.
Heb alles=Ik heb alles	Maak hier liever een volzin van, dat leest gemakkelijker.
Prijs was=De prijs was	Maak hier liever een volzin van, dat leest gemakkelijker.
Heb mijn=Ik heb mijn	Maak hier liever een volzin van, dat leest gemakkelijker.
Was weer=Het was weer|Ik was weer|Hij was weer|Ze was weer	Maak hier liever een volzin van, dat leest gemakkelijker.
Had niet=Ik had niet|Het had niet|Hij had niet|Ze had niet|Dat had niet	Maak hier liever een volzin van, dat leest gemakkelijker.
Wel vrij=Dat is wel vrij|Ze zijn wel vrij|Ik ben wel vrij|Het is wel vrij|Hij is wel vrij|Ik heb wel vrij|Het was wel vrij|Het zal wel vrij	Maak hier liever een volzin van, dat leest gemakkelijker.
Zegt wel=Men zegt wel|Je zegt wel|Dat zegt wel|Hij zegt wel|U zegt wel|Ze zegt wel|Het zegt wel	Maak hier liever een volzin van, dat leest gemakkelijker.
Kan goed=Ik kan goed|Je kan goed|Het kan goed|Hij kan goed|Dat kan goed|Ze kan goed|Zij kan goed	Maak hier liever een volzin van, dat leest gemakkelijker.
Ging ook=Het ging ook|Ik ging ook|Hij ging ook	Maak hier liever een volzin van, dat leest gemakkelijker.
Deed een=Ik deed een|Ze deed een|Hij deed een	Maak hier liever een volzin van, dat leest gemakkelijker.
Soms het=Ik heb soms het|Ik krijg soms het|Heb je soms het|Ik had soms het|Heb soms het|Is dat soms het|Heb jij soms het|Dat is soms het	Maak hier liever een volzin van, dat leest gemakkelijker.
Komt dus=Er komt dus|Het komt dus|Dat komt dus|Je komt dus|Hij komt dus|Dit komt dus|Zij komt dus	Maak hier liever een volzin van, dat leest gemakkelijker.
Komt met=Kom met|Hij komt met|Je komt met|Dat komt met|Het komt met|Dit komt met|Zij komt met	Maak hier liever een volzin van, dat leest gemakkelijker.
Zal wel,=Dat zal wel,|Ja, dat zal wel,|Het zal wel,	Maak hier liever een volzin van, dat leest gemakkelijker.
Was zeer=Het was zeer|Ik was zeer|Hij was zeer	Maak hier liever een volzin van, dat leest gemakkelijker.
Te laten=Nederland te laten|Om te laten	Maak hier liever een volzin van, dat leest gemakkelijker.
Storm in=Een storm in|Het is een storm in|Er is storm in	Maak hier liever een volzin van, dat leest gemakkelijker.
Erg blij=Ik ben erg blij|We zijn erg blij|Wij zijn erg blij|Ik ben er erg blij	Maak hier liever een volzin van, dat leest gemakkelijker.
Dus best=Het is dus best|Het kan dus best|Het zou dus best|Dat is dus best	Maak hier liever een volzin van, dat leest gemakkelijker.
Ook vaak=Ik heb ook|Het is ook vaak|Ik heb ook vaak|Wat ook vaak|Heb je ook vaak|Er is ook vaak	Maak hier liever een volzin van, dat leest gemakkelijker.
Was echt=Het was echt|Dat was echt|Ik was echt|Dit was echt|Hij was echt	Maak hier liever een volzin van, dat leest gemakkelijker.
Is nooit=Het is nooit|Er is nooit|Hij is nooit	Maak hier liever een volzin van, dat leest gemakkelijker.
Ben daar=Ik ben daar	Maak hier liever een volzin van, dat leest gemakkelijker.
Moet weg=Ik moet weg|Je moet weg|Hij moet weg|Het moet weg|Deze moet weg	Maak hier liever een volzin van, dat leest gemakkelijker.
Smaak is=De smaak is	Maak hier liever een volzin van, dat leest gemakkelijker.
Gaat weg=Je gaat weg|Hij gaat weg|Ze gaat weg|Het gaat weg|Deze gaat weg	Maak hier liever een volzin van, dat leest gemakkelijker.
Werd ook=Er werd ook|Het werd ook|Hij werd ook	Maak hier liever een volzin van, dat leest gemakkelijker.
Wij geen=Als wij geen|Omdat wij geen|Helaas hebben wij geen	Maak hier liever een volzin van, dat leest gemakkelijker.
Staan nu=Er staan nu|Ze staan nu|Wij staan nu|Die staan nu	Maak hier liever een volzin van, dat leest gemakkelijker.
Waard om=Het is de moeite waard om|Is het de moeite waard om|Het is zeker de moeite waard om|Het is echt de moeite waard om|Toch is het de moeite waard om|Het was de moeite waard om|Het is zeer de moeite waard om|Het is ook de moeite waard om	Maak hier liever een volzin van, dat leest gemakkelijker.
Kan toch=Dat kan toch|Ik kan toch|Het kan toch|Dit kan toch|Je kan toch|Hij kan toch	Maak hier liever een volzin van, dat leest gemakkelijker.
Zal geen=Ik zal geen|Er zal geen|Het zal geen	Maak hier liever een volzin van, dat leest gemakkelijker.
Heb veel=Ik heb veel	Maak hier liever een volzin van, dat leest gemakkelijker.
Zal vast=Het zal vast|Dat zal vast|Er zal vast|Hij zal vast|Ik zal vast	Maak hier liever een volzin van, dat leest gemakkelijker.
Gaat ook=Het gaat ook|Dat gaat ook	Maak hier liever een volzin van, dat leest gemakkelijker.
Heb echt=Ik heb echt	Maak hier liever een volzin van, dat leest gemakkelijker.
Vind dit=Ik vind dit	Maak hier liever een volzin van, dat leest gemakkelijker.
Zou echt=Ik zou echt|Dat zou echt|Het zou echt|Je zou echt|Dit zou echt	Maak hier liever een volzin van, dat leest gemakkelijker.
Raar hoe=Het is raar hoe|Het was raar hoe|Het is toch raar hoe	Maak hier liever een volzin van, dat leest gemakkelijker.
Werd een=Er werd een|Het werd een	Maak hier liever een volzin van, dat leest gemakkelijker.
Past bij=Dat past bij|Het past bij|Dit past bij	Maak hier liever een volzin van, dat leest gemakkelijker.
Wil geen=Ik wil geen|Hij wil geen	Maak hier liever een volzin van, dat leest gemakkelijker.
Hoor het=Ik hoor het	Maak hier liever een volzin van, dat leest gemakkelijker.
Was leuk=Het was leuk|Dat was leuk	Maak hier liever een volzin van, dat leest gemakkelijker.
Kon geen=Ik kon geen|Ze kon geen|Er kon geen|Het kon geen|Hij kon geen	Maak hier liever een volzin van, dat leest gemakkelijker.
Ben geen=Ik ben geen|Maar ik ben geen	Maak hier liever een volzin van, dat leest gemakkelijker.
Heb daar=Ik heb daar	Maak hier liever een volzin van, dat leest gemakkelijker.
Kan even=Het kan even|Ik kan even|Dit kan even|Dat kan even|Je kan even|Hij kan even	Maak hier liever een volzin van, dat leest gemakkelijker.
Rest van=De rest van	Maak hier liever een volzin van, dat leest gemakkelijker.
Motor is=De motor is|Deze motor is	Maak hier liever een volzin van, dat leest gemakkelijker.
Past ook=Dat past ook|Het past ook|Dit past ook|Deze past ook	Maak hier liever een volzin van, dat leest gemakkelijker.
Een daad=Het was een daad|Het is een daad	Maak hier liever een volzin van, dat leest gemakkelijker.
Leek mij=Het leek mij|Dat leek mij|Dit leek mij	Maak hier liever een volzin van, dat leest gemakkelijker.
Had geen=Ik had geen|Hij had geen|Ze had geen|Het had geen|Zij had geen	Maak hier liever een volzin van, dat leest gemakkelijker.
Zijn wel=Er zijn wel|We zijn wel|Ze zijn wel|Het zijn wel	Maak hier liever een volzin van, dat leest gemakkelijker.
Zal eens=Ik zal eens	Maak hier liever een volzin van, dat leest gemakkelijker.
Gaat nog=Het gaat nog|Dat gaat nog	Maak hier liever een volzin van, dat leest gemakkelijker.
Thema is=Het thema is|Dit thema is|Het centrale thema is	Maak hier liever een volzin van, dat leest gemakkelijker.
Idee van=Het idee van|Het is een idee van	Maak hier liever een volzin van, dat leest gemakkelijker.
Zal weer=Het zal weer|Ik zal weer|Hij zal weer|Er zal weer|Dat zal weer|Dit zal weer	Maak hier liever een volzin van, dat leest gemakkelijker.
Zou leuk=Het zou leuk|Dat zou leuk	Maak hier liever een volzin van, dat leest gemakkelijker.
Hoop het=Ik hoop het	Maak hier liever een volzin van, dat leest gemakkelijker.
Was goed=Het was goed|Dat was goed|Hij was goed	Maak hier liever een volzin van, dat leest gemakkelijker.
Vond dat=Ik vond dat|Hij vond dat|Ze vond dat	Maak hier liever een volzin van, dat leest gemakkelijker.
Was heel=Het was heel|Dat was heel|Ik was heel|Hij was heel|Ze was heel	Maak hier liever een volzin van, dat leest gemakkelijker.
Gaat wel=Het gaat wel|Dat gaat wel|Maar het gaat wel	Maak hier liever een volzin van, dat leest gemakkelijker.
Doet wat=Doe wat|Je doet wat|Hij doet wat|Het doet wat|Zij doet wat	Maak hier liever een volzin van, dat leest gemakkelijker.
Ligt wel=Er ligt wel|Dat ligt wel|Het ligt wel|Hij ligt wel|Dit ligt wel	Maak hier liever een volzin van, dat leest gemakkelijker.
Heb weer=Ik heb weer|En ik heb weer	Maak hier liever een volzin van, dat leest gemakkelijker.
Kan niks=Ik kan niks|Je kan niks|Het kan niks	Maak hier liever een volzin van, dat leest gemakkelijker.
Gaat dus=Het gaat dus|Je gaat dus|Dat gaat dus|Dit gaat dus	Maak hier liever een volzin van, dat leest gemakkelijker.
Ligt dus=Het ligt dus|Er ligt dus|Dat ligt dus|Dit ligt dus	Maak hier liever een volzin van, dat leest gemakkelijker.
Was toch=Het was toch|Dat was toch|Ik was toch|Hij was toch	Maak hier liever een volzin van, dat leest gemakkelijker.
Kreeg er=Ik kreeg er|Ze kreeg er|Hij kreeg er	Maak hier liever een volzin van, dat leest gemakkelijker.
Stond op=Ik stond op|Ze stond op|Hij stond op|Zij stond op|Er stond op	Maak hier liever een volzin van, dat leest gemakkelijker.
Wist ook=Ik wist ook	Maak hier liever een volzin van, dat leest gemakkelijker.
Kan echt=Ik kan echt|Het kan echt|Dit kan echt|Dat kan echt|Je kan echt	Maak hier liever een volzin van, dat leest gemakkelijker.
Hangt af=Dat hangt af|Het hangt af|Veel hangt af|Dit hangt af	Maak hier liever een volzin van, dat leest gemakkelijker.
Kost wel=Het kost wel|Dat kost wel|Maar het kost wel|Dit kost wel	Maak hier liever een volzin van, dat leest gemakkelijker.
Vind dat=Ik vind dat	Maak hier liever een volzin van, dat leest gemakkelijker.
Mijne is=De mijne is|Het mijne is	Maak hier liever een volzin van, dat leest gemakkelijker.
Was best=Het was best|Dat was best|Ik was best|Hij was best	Maak hier liever een volzin van, dat leest gemakkelijker.
Hoop dat=Ik hoop dat	Maak hier liever een volzin van, dat leest gemakkelijker.
Sneu dat=Het is sneu dat|Ik vind het sneu dat|Ik vond het sneu dat	Maak hier liever een volzin van, dat leest gemakkelijker.
Geeft me=Geef me|Het geeft me|Je geeft me|Dat geeft me|Ze geeft me|Hij geeft me	Maak hier liever een volzin van, dat leest gemakkelijker.
Zal blij=Ik zal blij|Ze zal blij|Hij zal blij	Maak hier liever een volzin van, dat leest gemakkelijker.
Moet wel=Je moet wel|Ik moet wel|Het moet wel|Dat moet wel|Er moet wel	Maak hier liever een volzin van, dat leest gemakkelijker.
Best wel=Het is best wel|Ik ben best wel|Ik heb best wel|Het was best wel|Dat is best wel	Maak hier liever een volzin van, dat leest gemakkelijker.
Lijkt er=Het lijkt er	Maak hier liever een volzin van, dat leest gemakkelijker.
Prima op=Dat kan prima op|Kinderen vermaken zich prima op|Ik kan prima op	Maak hier liever een volzin van, dat leest gemakkelijker.
Heb hier=Ik heb hier	Maak hier liever een volzin van, dat leest gemakkelijker.
Zeker te=Het is zeker te|Je bent zeker te	Maak hier liever een volzin van, dat leest gemakkelijker.
Vond hem=Ik vond hem|Ze vond hem|Hij vond hem	Maak hier liever een volzin van, dat leest gemakkelijker.
Moet dus=Je moet dus|Er moet dus|Ik moet dus|Het moet dus|Dat moet dus|U moet dus|Hij moet dus	Maak hier liever een volzin van, dat leest gemakkelijker.
Lijkt of=Het lijkt of	Maak hier liever een volzin van, dat leest gemakkelijker.
Weet het=Ik weet het|Je weet het	Maak hier liever een volzin van, dat leest gemakkelijker.
Beeld is=Het beeld is|Dit beeld is|Dat beeld is	Maak hier liever een volzin van, dat leest gemakkelijker.
Heb maar=Ik heb maar	Maak hier liever een volzin van, dat leest gemakkelijker.
Keuze is=De keuze is|Die keuze is|Deze keuze is	Maak hier liever een volzin van, dat leest gemakkelijker.
Hoop dus=Ik hoop dus	Als dit geen aansporing is, dan kunt u er beter een volzin van maken.
Was even=Ik was even|Het was even|Dat was even|Ze was even|Hij was even	Maak hier liever een volzin van, dat leest gemakkelijker.
Lijkt zo=Het lijkt zo|Je lijkt zo|Dat lijkt zo|Hij lijkt zo|Ze lijkt zo	Maak hier liever een volzin van, dat leest gemakkelijker.
Zette de=Ik zette de|Ze zette de|Hij zette de	Maak hier liever een volzin van, dat leest gemakkelijker.
Krijg er=Ik krijg er	Maak hier liever een volzin van, dat leest gemakkelijker.
Zal toch=Het zal toch|Hij zal toch|Ik zal toch|Dat zal toch|Er zal toch|Je zal toch	Maak hier liever een volzin van, dat leest gemakkelijker.
Ook echt=Het is ook echt|Ik ben ook echt|Maar dan ook echt|Dat is ook echt|Ik heb ook echt|Het was ook echt	Maak hier liever een volzin van, dat leest gemakkelijker.
Een dijk=Wat een dijk|Dat is een dijk|Het is een dijk|Op een dijk|Met een dijk|Dit is een dijk	Maak hier liever een volzin van, dat leest gemakkelijker.
Net weer=Ik ben net weer|Ik heb net weer	Maak hier liever een volzin van, dat leest gemakkelijker.
Gaat met=Ga met|Het gaat met|Hij gaat met|Zij gaat met	Maak hier liever een volzin van, dat leest gemakkelijker.
Hele dag=De hele dag	Maak hier liever een volzin van, dat leest gemakkelijker.
Zou best=Ik zou best|Dat zou best|Het zou best|Hij zou best	Maak hier liever een volzin van, dat leest gemakkelijker.
Kan heel=Ik kan heel|Het kan heel|Dat kan heel|Dit kan heel	Maak hier liever een volzin van, dat leest gemakkelijker.
Zou heel=Dat zou heel|Het zou heel|Ik zou heel	Maak hier liever een volzin van, dat leest gemakkelijker.
Toch erg=Het is toch erg|Dat is toch erg|Ik ben toch erg|Het zou toch erg	Maak hier liever een volzin van, dat leest gemakkelijker.
Zeker om=Het gaat zeker om|Dat was zeker om|Dat is zeker om|En zeker om|Het loont dus zeker om|Het loont zeker om	Maak hier liever een volzin van, dat leest gemakkelijker.
Erg duur=Het is erg duur|Ze zijn erg duur	Maak hier liever een volzin van, dat leest gemakkelijker.
Was toen=Ik was toen|Dat was toen|Het was toen|Er was toen|Hij was toen	Maak hier liever een volzin van, dat leest gemakkelijker.
Heb dit=Ik heb dit	Maak hier liever een volzin van, dat leest gemakkelijker.
Is snel=Dat is snel|Het is snel|Hij is snel|Er is snel|Ze is snel|Dit is snel	Maak hier liever een volzin van, dat leest gemakkelijker.
Jij een=Ben jij een|Heb jij een|Als jij een|Wil jij een	Maak hier liever een volzin van, dat leest gemakkelijker.
Ligt nu=Er ligt nu|Het ligt nu|Hij ligt nu|Ze ligt nu|Dat ligt nu|Die ligt nu	Maak hier liever een volzin van, dat leest gemakkelijker.
Gaat nu=Het gaat nu|Je gaat nu|Dat gaat nu|Hij gaat nu	Maak hier liever een volzin van, dat leest gemakkelijker.
Gaat me=Je gaat me|Het gaat me|Dat gaat me|Er gaat me|Hij gaat me	Maak hier liever een volzin van, dat leest gemakkelijker.
Ben gek=Ik ben gek	Maak hier liever een volzin van, dat leest gemakkelijker.
Kon wel=Ik kon wel|Dat kon wel|Het kon wel|Je kon wel|Dit kon wel|Hij kon wel|Ze kon wel	Maak hier liever een volzin van, dat leest gemakkelijker.
Zag dat=Ik zag dat|Ze zag dat|Hij zag dat	Maak hier liever een volzin van, dat leest gemakkelijker.
Zoon is=Mijn zoon is|Uw zoon is|Onze zoon is|Zijn zoon is|De zoon is	Maak hier liever een volzin van, dat leest gemakkelijker.
Zie uit=Ik zie uit	Maak hier liever een volzin van, dat leest gemakkelijker.
Snap er=Ik snap er	Maak hier liever een volzin van, dat leest gemakkelijker.
Doet ie=Dat doet ie	Maak hier liever een volzin van, dat leest gemakkelijker.
Zou hem=Ik zou hem|Je zou hem|Dat zou hem|Het zou hem|Ze zou hem|Hij zou hem	Maak hier liever een volzin van, dat leest gemakkelijker.
Viel me=Het viel me|Dat viel me	Maak hier liever een volzin van, dat leest gemakkelijker.
Zal wat=Ik zal wat|Het zal wat|Dat zal wat|Er zal wat|Hij zal wat	Maak hier liever een volzin van, dat leest gemakkelijker.
Ik naar=Als ik naar|Ik ging naar|Ga ik naar	Maak hier liever een volzin van, dat leest gemakkelijker.
Mag wel=Je mag wel|Ik mag wel|U mag wel|Het mag wel|Dat mag wel	Maak hier liever een volzin van, dat leest gemakkelijker.
Is heel=Het is heel|Dat is heel|Er is heel	Maak hier liever een volzin van, dat leest gemakkelijker.
Zei een=Dat zei een|Hij zei een|Toen zei een	Maak hier liever een volzin van, dat leest gemakkelijker.
Weet zo=Ik weet zo|Je weet zo|U weet zo|Maar ik weet zo|Hij weet zo	Maak hier liever een volzin van, dat leest gemakkelijker.
Zal hem=Ik zal hem|Dat zal hem|Het zal hem	Maak hier liever een volzin van, dat leest gemakkelijker.
Wel een=Het lijkt wel een|Het is wel een|Ik heb wel een|Er is wel een	Maak hier liever een volzin van, dat leest gemakkelijker.
Gaat op=Ga op|Je gaat op|Het gaat op|Hij gaat op|Ze gaat op|Zij gaat op	Maak hier liever een volzin van, dat leest gemakkelijker.
Heb ook=Ik heb ook|En ik heb ook|Maar ik heb ook	Maak hier liever een volzin van, dat leest gemakkelijker.
Kan bij=Je kan bij|Dat kan bij|U kan bij|Dit kan bij	Maak hier liever een volzin van, dat leest gemakkelijker.
Ben dus=Ik ben dus	Maak hier liever een volzin van, dat leest gemakkelijker.
Stom om=Het is stom om|Het was stom om|Ik was zo stom om	Maak hier liever een volzin van, dat leest gemakkelijker.
Tips of=Heb je zelf tips of|Heb je tips of|Heeft u tips of|Heb jij nog tips of|Heb je nog tips of|Heb jij tips of	Maak hier liever een volzin van, dat leest gemakkelijker.
Woon in=Ik woon in	Maak hier liever een volzin van, dat leest gemakkelijker.
Kost je=Het kost je|Dat kost je|Dit kost je	Maak hier liever een volzin van, dat leest gemakkelijker.
Ben wel=Ik ben wel	Maak hier liever een volzin van, dat leest gemakkelijker.
Te zwak=Ik ben te zwak|Hij is te zwak|Ik was te zwak|Ze waren te zwak|Hij was te zwak|Ze was te zwak|Je bent te zwak|Ze zijn te zwak	Maak hier liever een volzin van, dat leest gemakkelijker.
Kost me=Het kost me|Dat kost me	Maak hier liever een volzin van, dat leest gemakkelijker.
Foto is=De foto is|Deze foto is|Op de foto is|Op deze foto is	Maak hier liever een volzin van, dat leest gemakkelijker.
Toch te=Het is toch te|Is het toch te	Maak hier liever een volzin van, dat leest gemakkelijker.
Zien er=Ze zien er|We zien er	Maak hier liever een volzin van, dat leest gemakkelijker.
Zijn nu=We zijn nu|Er zijn nu|Wij zijn nu|Ze zijn nu	Maak hier liever een volzin van, dat leest gemakkelijker.
Ben dan=Ik ben dan|Maar ik ben dan	Maak hier liever een volzin van, dat leest gemakkelijker.
Al enig=Heb je al enig|Hebt u al enig|Heeft u al enig|Is er al enig	Maak hier liever een volzin van, dat leest gemakkelijker.
Echt al=Ik heb echt al	Maak hier liever een volzin van, dat leest gemakkelijker.
Had nog=Ik had nog|Ze had nog|Hij had nog	Maak hier liever een volzin van, dat leest gemakkelijker.
Ben dol=Ik ben dol	Maak hier liever een volzin van, dat leest gemakkelijker.
Zou wel=Ik zou wel|Het zou wel|Dat zou wel|Dit zou wel|Hij zou wel	Maak hier liever een volzin van, dat leest gemakkelijker.
Word er=Ik word er	Maak hier liever een volzin van, dat leest gemakkelijker.
Ging op=Ik ging op|Ze ging op|Hij ging op|Het ging op|Zij ging op	Maak hier liever een volzin van, dat leest gemakkelijker.
Heb wel=Ik heb wel|Maar ik heb wel	Maak hier liever een volzin van, dat leest gemakkelijker.
Kan hem=Ik kan hem|Je kan hem|Het kan hem	Maak hier liever een volzin van, dat leest gemakkelijker.
Heb dat=Ik heb dat	Maak hier liever een volzin van, dat leest gemakkelijker.
Vond er=Ik vond er|Hij vond er|Ze vond er|Je vond er|Men vond er|Zo vond er	Maak hier liever een volzin van, dat leest gemakkelijker.
Gaat om=Het gaat om|Als het gaat om|Of het nu gaat om	Maak hier liever een volzin van, dat leest gemakkelijker.
Past op=Hij past op|Het past op|Deze past op|Ze past op	Maak hier liever een volzin van, dat leest gemakkelijker.
Was dus=Het was dus|Dat was dus|Er was dus|Ik was dus|Dit was dus|Hij was dus	Maak hier liever een volzin van, dat leest gemakkelijker.
Mag ook=Je mag ook|Dat mag ook|U mag ook|Het mag ook	Maak hier liever een volzin van, dat leest gemakkelijker.
Wil dan=Ik wil dan|Dat wil dan|Hij wil dan|Ze wil dan|Men wil dan|Dit wil dan	Maak hier liever een volzin van, dat leest gemakkelijker.
Ook net=Het is ook net|Ik ben ook net|Ik heb ook net|En ook net	Maak hier liever een volzin van, dat leest gemakkelijker.
Had hem=Ik had hem|Ze had hem|Hij had hem	Maak hier liever een volzin van, dat leest gemakkelijker.
Gaaf om=Het is gaaf om|Wat gaaf om|Heel gaaf om	Maak hier liever een volzin van, dat leest gemakkelijker.
Auto is=De auto is|Een auto is|Deze auto is	Maak hier liever een volzin van, dat leest gemakkelijker.
Kan dus=Het kan dus|Dat kan dus|Ik kan dus|Je kan dus|Er kan dus|Men kan dus|Dit kan dus	Maak hier liever een volzin van, dat leest gemakkelijker.
Dus ook=Het is dus ook|Dat geldt dus ook|Dat is dus ook	Maak hier liever een volzin van, dat leest gemakkelijker.
Ben net=Ik ben net	Maak hier liever een volzin van, dat leest gemakkelijker.
Wil nog=Ik wil nog|Dat wil nog|Maar dat wil nog|Hij wil nog	Maak hier liever een volzin van, dat leest gemakkelijker.
Is veel=Er is veel|Het is veel|Dat is veel	Maak hier liever een volzin van, dat leest gemakkelijker.
Zit wel=Er zit wel|Daar zit wel|Het zit wel|Ik zit wel|Maar er zit wel	Maak hier liever een volzin van, dat leest gemakkelijker.
Is vaak=Het is vaak|Dat is vaak|Dit is vaak|Hij is vaak|Zij is vaak	Maak hier liever een volzin van, dat leest gemakkelijker.
Ook per=Je kunt ook per|U kunt ook per|Dit is ook per|Het kan ook per|Het verschilt ook per	Maak hier liever een volzin van, dat leest gemakkelijker.
Wil hem=Ik wil hem|Ze wil hem|Hij wil hem	Maak hier liever een volzin van, dat leest gemakkelijker.
Zit bij=Ik zit bij|Hij zit bij|Het zit bij	Maak hier liever een volzin van, dat leest gemakkelijker.
Past in=Het past in|Dit past in|Dat past in	Maak hier liever een volzin van, dat leest gemakkelijker.
Te warm=Het is te warm|Het is veel te warm|Niet te warm|Het was te warm|Als het te warm|Is het te warm	Maak hier liever een volzin van, dat leest gemakkelijker.
Ken het=Ik ken het	Maak hier liever een volzin van, dat leest gemakkelijker.
Gaat zo=Het gaat zo|Dat gaat zo|Dit gaat zo|Hij gaat zo	Maak hier liever een volzin van, dat leest gemakkelijker.
Dus erg=Het is dus erg|Ik ben dus erg	Maak hier liever een volzin van, dat leest gemakkelijker.
Heb er=Ik heb er	Maak hier liever een volzin van, dat leest gemakkelijker.
Was zo=Ik was zo|Het was zo|Hij was zo|Ze was zo	Maak hier liever een volzin van, dat leest gemakkelijker.
Was op=Ik was op|Dat was op|Het was op|Hij was op|Zij was op	Maak hier liever een volzin van, dat leest gemakkelijker.
Zie er=Ik zie er|Maar ik zie er	Maak hier liever een volzin van, dat leest gemakkelijker.
Is erg=Het is erg|Dat is erg|Hij is erg|Dit is erg	Maak hier liever een volzin van, dat leest gemakkelijker.
Is mij=Het is mij|Dat is mij|Er is mij	Maak hier liever een volzin van, dat leest gemakkelijker.
Zit nu=Ik zit nu|Er zit nu|Hij zit nu|Ze zit nu|Het zit nu	Maak hier liever een volzin van, dat leest gemakkelijker.
Zou zo=Ik zou zo|Het zou zo|Dat zou zo|Je zou zo|Hij zou zo|Ze zou zo	Maak hier liever een volzin van, dat leest gemakkelijker.
Zat in=Ik zat in|Hij zat in|Het zat in|Ze zat in|Zij zat in	Maak hier liever een volzin van, dat leest gemakkelijker.
Zal me=Ik zal me|Het zal me|Dat zal me|Hij zal me	Maak hier liever een volzin van, dat leest gemakkelijker.
Nu net=Dat is nu net|Het is nu net|Ik ben nu net|En dat is nu net|Het was nu net	Maak hier liever een volzin van, dat leest gemakkelijker.
Was 't=Dat was 't|Ik was 't|Het was 't|Hij was 't	Maak hier liever een volzin van, dat leest gemakkelijker.
Is dus=Het is dus|Dat is dus|Er is dus|Dit is dus	Maak hier liever een volzin van, dat leest gemakkelijker.
Is te=Het is te	Maak hier liever een volzin van, dat leest gemakkelijker.
Heb 2=Ik heb 2	Maak hier liever een volzin van, dat leest gemakkelijker.
Altijd nog beter dan=Dat is altijd nog beter dan|Het is altijd nog beter dan
Toch wel lekker=Het is toch wel lekker
Bestand tegen=Het is bestand tegen|Ze zijn bestand tegen
Plaats voor=Er is plaats voor
Perfect om=Het is perfect om|Ze zijn perfect om|Dit is perfect om|Hij is perfect om
Altijd wat=Er is altijd wat|Het is altijd wat|Ik heb altijd wat
Wel lekker=Het is wel lekker|Ik vind het wel lekker|Het was wel lekker
Toch best=Dat is toch best|Het is toch best
Super spannend=Superspannend
Super lekker en=Superlekker en
Verkrijgbaar van=Ze zijn verkrijgbaar van
Mooie tijden=Het zijn mooie tijden|Het waren mooie tijden|De mooie tijden
Was heerlijk=Het was heerlijk
Beetje zielig=Ik vind het een beetje zielig
Nergens een spoor=Er was nergens een spoor|Er is nergens een spoor
Moest toch=Ik moest toch|Er moest toch|Hij moest toch|Ze moest toch
Ooit van een=Heb je ooit van een|Ik heb ooit van een
Geen oorlog=Er is geen oorlog|Als er geen oorlog|Het is geen oorlog
Verder echt=Ik weet verder echt|Het is verder echt|Er is verder echt
Stond niet=Hij stond niet|Er stond niet|Ik stond niet|Het stond niet|Ze stond niet
Thuis of in=Of je nu thuis of in
Nergens een spoor van=Er was nergens een spoor van
Telkens weer een=Het is telkens weer een|Het was telkens weer een
Vind ik heel=Dat vind ik heel|Dit vind ik heel
Werkt dus=Het werkt dus|Dat werkt dus|Dit werkt dus|Je werkt dus
Ook iets voor=Ik heb ook iets voor|Dat betekent ook iets voor|Is dit ook iets voor
Altijd tot=Dat leidt altijd tot|Dit leidt altijd tot
Allebei op=Ze keken allebei op|Ze stonden allebei op|Ze waren allebei op
Ook al geen=Dat is ook al geen
Zonde van mijn=Ik vind het zonde van mijn|Het is zonde van mijn
Zo netjes=Het is wel zo netjes
Zag er allemaal=Het zag er allemaal
Werkt snel=Het werkt snel|Hij werkt snel|Dit werkt snel|Dat werkt snel
Wij geen=Als wij geen|Omdat wij geen|Helaas hebben wij geen
Tijd om naar de=Het is tijd om naar de|Het was tijd om naar de|Toen was het tijd om naar de|Dan is het tijd om naar de
Zou ik ook niet=Dat zou ik ook niet|Daar zou ik ook niet
Vind ik eigenlijk=Dat vind ik eigenlijk
Geen respect voor=Ik heb geen respect voor|Ze hebben geen respect voor
Prima op=Dat kan prima op|Kinderen vermaken zich prima op|Ik kan prima op
Zeker meer=Er zijn zeker meer|Ik ga zeker meer|Ik weet niet zeker meer|Er is zeker meer
Goed bestand tegen=Het is goed bestand tegen|Ze zijn goed bestand tegen|Hij is goed bestand tegen|Het materiaal is goed bestand tegen
Zeer goed bestand tegen=Ze zijn zeer goed bestand tegen
Toch wel lekker=Het is toch wel lekker
Gewoon lekker=Ik wil gewoon lekker|Ik zou gewoon lekker|Het is gewoon lekker|Ik ga gewoon lekker
Wel een=Het is wel een|Er is wel een|Het lijkt wel een|Ik heb wel een
Wel lekker=Het is wel lekker|Ik vind het wel lekker|Het was wel lekker
Een heel erg=Het is een heel erg|Het was een heel erg|Dit is een heel erg
Toch nog wat=Ik heb toch nog wat|Wil je toch nog wat
Voer voor de=Dat is voer voor de|Dit is voer voor de
Voer voor=Dat is voer voor|Dit is voer voor|Het is voer voor
Ook een=Er is ook een|Het is ook een|Ik heb ook een
Ook een mooi=Het is ook een mooi|Er is ook een mooi|Dat is ook een mooi
Ook een hele=Het is ook een hele|Ik heb ook een hele|Het is dan ook een hele|Er is ook een hele|Het was dan ook een hele
Genoeg om te=Het is genoeg om te
Best wel=Het is best wel|Ik ben best wel|Dat is best wel|Het was best wel|Ik heb best wel
Best wel een=Het is best wel een|Ik ben best wel een|Het was best wel een|Dat is best wel een
Dus ook=Het is dus ook|Dat geldt dus ook|Dat is dus ook
Dus ook een=Het is dus ook een|Dat is dus ook een|Er is dus ook een|Dit is dus ook een
Nu te koop=Het is nu te koop
Verkrijgbaar bij=Deze zijn verkrijgbaar bij|Het is verkrijgbaar bij|Ze zijn verkrijgbaar bij|Deze is verkrijgbaar bij
Een inspirerende=Het was een inspirerende|Het is een inspirerende
Niks bijzonders=Er is niks bijzonders|Ik heb niks bijzonders|Er was niks bijzonders|Dat is niks bijzonders
Goede kwaliteit=Het was van goede kwaliteit|Ze zijn van goede kwaliteit
Duidelijk geen=Het is duidelijk geen|Hij had duidelijk geen|Het was duidelijk geen|Dit is duidelijk geen
Eigenlijk geen=Ik heb eigenlijk geen|Er is eigenlijk geen|Het is eigenlijk geen
Gevoelig voor=Ze zijn gevoelig voor|Ik ben gevoelig voor|Ik ben erg gevoelig voor|Ben je gevoelig voor
Bestand tegen=Het is bestand tegen|Ze zijn bestand tegen
Een sportieve=Het was een sportieve|Het is een sportieve
Afgewerkt met=Het geheel is afgewerkt met|Het is afgewerkt met
Heerlijk warm=Het was heerlijk warm|Het is heerlijk warm|Het water is heerlijk warm
Spannend voor=Het is spannend voor|Het was spannend voor|Dat is spannend voor
Eigenlijk ook=Dat is eigenlijk ook|Het is eigenlijk ook|Ik ben eigenlijk ook
Wel gezellig=Het was wel gezellig|Het is wel gezellig|Ik vind het wel gezellig
Zeer slechte=Ondanks het zeer slechte|Ik heb zeer slechte|Dit is een zeer slechte
Ook heerlijk=Ik vind het ook heerlijk|Het is ook heerlijk|Het was ook heerlijk
Geen reactie=Er kwam geen reactie|Ik heb nog geen reactie
Heerlijk bij=Deze is heerlijk bij|Het is heerlijk bij|Ze zijn heerlijk bij|Ik vind het heerlijk bij|Het was heerlijk bij
Eenvoudig te=Het is eenvoudig te|Dit is eenvoudig te|Ze zijn eenvoudig te
Makkelijk in=Het is makkelijk in|Hij is makkelijk in
Hopelijk een=Het is hopelijk een|Dit is hopelijk een
Plaats voor=Er is plaats voor
Voldoet aan=Het voldoet aan|Hij voldoet aan|Je voldoet aan|U voldoet aan|Als je voldoet aan
Alleen veel=Het is alleen veel|Er is alleen veel|Er zijn alleen veel|Dat is alleen veel
Weer lekker=Het was weer lekker|Het is weer lekker|Je bent weer lekker|Ik ben weer lekker|Ik ga weer lekker
Helemaal te=Ik zit helemaal te|Het is helemaal te|Ik sta helemaal te|Het was helemaal te|Het is niet helemaal te
Helaas weer=Ik moet helaas weer|Het is helaas weer|Ik ben helaas weer|Het was helaas weer|Het zit er helaas weer
Heerlijk op=Het is heerlijk op|Het was heerlijk op|Ik vind het heerlijk op
Verder heel=Ik ben verder heel|Het is verder heel|Wat ik verder heel
Geen mooie=Het is geen mooie|Het was geen mooie|Is dat geen mooie|Als dat geen mooie
Perfect om=Het is perfect om|Ze zijn perfect om|Dit is perfect om|Hij is perfect om
Zeker iets=Dat is zeker iets|Dit is zeker iets|Er is zeker iets|Het is zeker iets
Ook alweer=Hoe zat het ook alweer|Hoe zit het ook alweer
Gelijk een=Ik heb gelijk een|Ik kreeg gelijk een|Dat is gelijk een
Altijd wat=Er is altijd wat|Het is altijd wat|Ik heb altijd wat
Gekocht in=Ik heb hem gekocht in|Ik heb ze gekocht in|Ik heb het gekocht in
Erg slecht=Ik ben erg slecht|Het is erg slecht|Het gaat erg slecht
Alles zeer=Het is alles zeer|Het was alles zeer
Veel leuke=Er zijn veel leuke|Ik heb veel leuke|Er zijn heel veel leuke
Ook altijd=Ik heb ook altijd|Het is ook altijd|U kunt ook altijd|Ik ben ook altijd
Altijd bij=U kunt altijd bij|Je kunt altijd bij|Ik ben altijd bij
Ook gewoon=Je kunt ook gewoon|Je kan ook gewoon|Het is ook gewoon
Nooit echt=Ik heb nooit echt|Ik ben nooit echt
Ook ideaal=Het is ook ideaal|Dit is ook ideaal|Ze zijn ook ideaal|Het is dan ook ideaal
Toch best=Dat is toch best|Het is toch best
Echt weer=Het is echt weer|Dit is echt weer|Het was echt weer|Ik moet echt weer
Alleen te=Het is alleen te
Toch voor=Wat is dat toch voor
Toch heel=Dat is toch heel|Het is toch heel
Niet duur=Het is niet duur|Ze zijn niet duur
Weer heel=Het was weer heel|Er zijn weer heel|Het is weer heel|Ik heb weer heel|Er is weer heel
Ook leuke=Er zijn ook leuke
Volle bak=Het was volle bak|Het was een volle bak
Beetje te=Het is een beetje te|Ik zit een beetje te
Handig in=Dit is vooral handig in|Dit is handig in|Dat is handig in|Het is handig in
Weinig te=Er is weinig te|Er valt weinig te|Er was weinig te|Dat heeft weinig te
Komt met=Hij komt met|Dit komt met|Je komt met|Dat komt met
Ook vaak=Ik heb ook vaak|Het is ook vaak
Past bij=Het past bij|Dat past bij|Dit past bij
Een daad=Het is een daad|Het was een daad
Ook echt=Het is ook echt|Ik ben ook echt|Ik heb ook echt|Het was ook echt
Een dijk=Het is een dijk|Dit is een dijk|Dat is een dijk
Toch erg=Het is toch erg|Ik ben toch erg|Dat is toch erg|Het zou toch erg
Zeker om=Het gaat zeker om|Het loont dus zeker om|Het loont zeker om
Zij een=Als zij een
Past op=Hij past op|Deze past op|Het past op|Ze past op
Ook net=Ik ben ook net|Ik heb ook net|Het is ook net
Ook per=U kunt ook per|Je kunt ook per
Te warm=Het is te warm|Het was te warm
Was 't=Dat was 't|Het was 't|Hij was 't|Ik was 't
Zo weer een=Ik kan zo weer een|Ik zou zo weer een
Te downloaden=Deze is te downloaden|Deze zijn te downloaden|Dit formulier is te downloaden
Nu weer in=Ik ben nu weer in|Ik zit nu weer in|Als ik nu weer in|Hij is nu weer in
Binnenkort weer een=Ik ga binnenkort weer een|Ik zal binnenkort weer een|Er zal binnenkort weer een
Altijd nog beter dan=Dat is altijd nog beter dan|Het is altijd nog beter dan
Perfect voor op=Deze bereidt perfect voor op
Zin in meer=Heb je zin in meer
Wel zo veilig=Dat is wel zo veilig
me moeder.=mijn moeder.
dja vu.=dj vu.
Geeft hem=Het geeft hem|Geef hem
Super service=Superservice
Te gek om=Het is te gek om|Het was te gek om|Ik vind het te gek om|Het lijkt me te gek om|Eigenlijk is het te gek om
Lijkt me veel=Het lijkt me veel|Dat lijkt me veel
Plaats genoeg=Er is plaats genoeg|Er was plaats genoeg
Op zoek naar=Bent u op zoek naar|Ben je op zoek naar|Ik ben op zoek naar|Wij zijn op zoek naar|Ben jij op zoek naar|U bent op zoek naar
Benieuwd hoe ze=Ik ben benieuwd hoe ze|Ik ben heel benieuwd hoe ze|We zijn benieuwd hoe ze|Ik ben wel benieuwd hoe ze
Prachtig stuk=Het is een prachtig stuk|Het was een prachtig stuk|Dit is een prachtig stuk|Je hebt een prachtig stuk
Zin in een leuke=Heb je zin in een leuke|Ik heb zin in een leuke
Graag de naam=Ik zou graag de naam
Heel benieuwd naar=Ik ben heel benieuwd naar|Ik ben ook heel benieuwd naar|Wij zijn heel benieuwd naar|Ik ben wel heel benieuwd naar|Ik was heel benieuwd naar|Ik ben echt heel benieuwd naar
Ligt aan het=Het ligt aan het|Dat ligt aan het|Dit ligt aan het
Lijkt me prima=Het lijkt me prima
er niet gerust in.=er niet gerust op.
Sindsdien geen=Sindsdien heb ik geen
U toe.=u toe.
Echt dat=Echt, dat
Gaan naar=Ze gaan naar|Wij gaan naar|Die gaan naar|Deze gaan naar
Scheelt je een=Dat scheelt je een|Het scheelt je een
Vond er=Ik vond er|Hij vond er|Ze vond er|Men vond er|Zo vond er|Je vond er
Mooi staaltje=Het is een mooi staaltje|Het was een mooi staaltje|Dit is een mooi staaltje|Dat is een mooi staaltje
Oorsprong van het=De oorsprong van het|Over de oorsprong van het
Lijkt me iets=Dat lijkt me iets|Dit lijkt me iets
Heel duidelijk en=Het is heel duidelijk en
Geen school=Er is geen school|Er was geen school|
Tips of=Heb je zelf tips of|Heb je tips of|Heeft u tips of|Heb jij nog tips of|Heb je nog tips of|Heb jij tips of
Wordt verzonden=Dit wordt verzonden|Deze wordt verzonden
Geen boom=Er was geen boom|Er is geen boom|Ik heb geen boom
Kijk uit naar je=Ik kijk uit naar je
Prijzen beginnen bij=De prijzen beginnen bij
Hele mooie foto's=Dit zijn hele mooie foto's
Zie uit=Ik zie uit
Voering van=De voering is van
Lekker zacht en=Het is lekker zacht en
Nu al de=Heb je nu al de|Ik heb nu al
Oh wat zijn=O, wat zijn
Prachtig deze=Prachtig, deze
Goed voornemen=Goed voornemen
weten hoor.=weten, hoor.
Old school=Oldskool
Oh boy,=O boy,
Never nooit=Nooit|Echt nooit
op twitter!=op Twitter!
genieten hoor!=genieten, hoor!
niet nodig hoor.=niet nodig, hoor.
O wacht=O, wacht
Haha dit=Haha, dit
niet teveel!=niet te veel!
Ideaal dus voor de=Het is dus ideaal voor de
Goed voornemen=Het is een goed voornemen
Lijkt mij echt=Het lijkt mij echt|Dat lijkt mij echt
Iets met het=Er was iets met het|Er is iets met het|Is er iets met het|Het heeft iets met het|Heeft het iets met het|Als er iets met het|Ik heb iets met het|Het zal wel iets met het
Allemaal net=Het is allemaal net|Het was allemaal net|Ze zijn allemaal net|Het ging allemaal net|Het leek allemaal net|Het gaat allemaal net|Het is het allemaal net|Het was het allemaal net
Boek is in=Het boek is in
Goed gegeten=Je hebt goed gegeten|Er werd goed gegeten
Had ik nooit=Dat had ik nooit|Dit had ik nooit|Daar had ik nooit|Anders had ik nooit|Zelf had ik nooit|Toch had ik nooit|Vroeger had ik nooit|Eerlijk gezegd had ik nooit
Heeft mijn moeder=Hij heeft mijn moeder|Dat heeft mijn moeder|Ze heeft mijn moeder|Die heeft mijn moeder
Misschien zelf=Je hebt het misschien zelf|Heb je misschien zelf|Je hebt misschien zelf|Of heb je misschien zelf|Mag ik misschien zelf|Of ben je misschien zelf|Zoals je misschien zelf|U heeft misschien zelf|Wilt u misschien zelf
Voor die tijd een=Het was voor die tijd een|Dit was voor die tijd een|Dat was voor die tijd een
Dan toch een=Als je dan toch een|Als er dan toch een|Als ik dan toch een|Dat is dan toch een|En als je dan toch een|Zou er dan toch een|En als er dan toch een|Zou het dan toch een
Ook weer heel=Het is ook weer heel|Dit was ook weer heel|Deze is ook weer heel
Zegt wel=Men zegt wel|Dat zegt wel|Hij zegt wel|Het zegt wel|Je zegt wel|Ze zegt wel|U zegt wel
Doet mijn=Dat doet mijn|Het doet mijn|Dit doet mijn|Hij doet mijn|Ze doet mijn|Je doet mijn
Ook beter=Het is ook beter|Het is dan ook beter|Dat is ook beter|Je kunt ook beter|Daarom is het ook beter|Het zou dan ook beter|Het zou ook beter|Je kunt dan ook beter
Leuk verhaal en=Het is een leuk verhaal en
Heel erg lekker=Het was heel erg lekker
Zal ik wel=Dan zal ik wel|Dat zal ik wel|Daar zal ik wel|Nu zal ik wel|Morgen zal ik wel|Die zal ik wel|Natuurlijk zal ik wel|Maar dat zal ik wel
Geen vrouwen=Er waren geen vrouwen|Er zijn geen vrouwen|Als er geen vrouwen
Erg goed,=Het eten was erg goed,|Het eten is erg goed,|Het ging erg goed,|Hij is erg goed,|Dit werkt erg goed,|Hij was erg goed,|Het gaat erg goed,|Hij doet het erg goed,|Het was erg goed,
Waard om=Het is de moeite waard om|Het is zeker de moeite waard om|Is het de moeite waard om|Het is echt de moeite waard om|Toch is het de moeite waard om|Het is zeer de moeite waard om|Het was de moeite waard om|Het is ook de moeite waard om
Erg duur=Het is erg duur|Ze zijn erg duur
Voelt toch=Het voelt toch|Dat voelt toch|Je voelt toch|Maar het voelt toch|Dit voelt toch|En dat voelt toch|U voelt toch
Voel me niet=Ik voel me niet|Maar ik voel me niet
Eerder iets=Het is eerder iets|Ik heb nooit eerder iets|Ik had nooit eerder iets|Ik heb al eerder iets|Ik heb al eens eerder iets|Ik had nog nooit eerder iets|Ik had al eerder iets|Ik heb eerder iets|Ik had eerder iets
Mooi helder=Het was mooi helder|Het is mooi helder
Wel eens van de=Heb je wel eens van de|Hebt u wel eens van de|Heeft u wel eens van de|Heb jij wel eens van de|Misschien heb je wel eens van de|Men spreekt wel eens van de
Doen ze in=Dat doen ze in|Dit doen ze in|Wat doen ze in|En dat doen ze in|Overwinteren doen ze in|En wat doen ze in
Op de hoogte blijven van al=
Heel blij dat=Ik ben heel blij dat
