# General replacement rules, used by org.languagetool.rules.en.SimpleReplaceRule
# Format: UTF-8, one entry per line in format: phrase=replacement
# 'phrase' is what the text is searched for. 'replacement' is the suggestion shown to the user.
# 'phrase' is searched for case-insensitively.
# Both 'phrase' and 'replacement' can contain more than one value when separated by '|'.
# Example:
# incorrect=suggestion one|suggestion two
# A message can be added by adding a tab and the message string. The format is then: phrase=replacement{\t}message
# If the message starts with 'http://' or 'https://', it is used as the URL, not as a message.
# NOTE: Do not use for words that users might have added to their spelling dictionary,
#       as this rule would then still be triggered.
crohns disease|chrons disease|chron's disease=Crohn's disease
bussines|bussiness=business	Did you mean "business", a commercial activity?
disencourage=discourage
disencouraged=discouraged
disencouraging=discouraging
kickass=kick-ass
Köln=Cologne
München=Munich
Nordrhein-Westfalen|Nordrhein Westfalen=North Rhine-Westphalia
Lissabon=Lisbon
Nürnberg=Nuremberg
#Bayern=Bavaria # see rule BAYERN
Rheinland-Pfalz|Rheinland Pfalz=Rhineland-Palatinate
Niedersachsen=Lower Saxony
Thüringen=Thuringia
Sachsen-Anhalt|Sachsen Anhalt=Saxony-Anhalt
#Catalunya=Catalonia
Schweiz=Switzerland
Österreich=Austria
#Wien=Vienna
Luzern=Lucerne
Sankt Moritz=Saint Moritz
Sankt Pölten=Saint Pölten
conversation rate=conversion rate
conversation rates=conversion rates
Barbara Streisand=Barbra Streisand
Nicholas Cage=Nicolas Cage
Jo Biden=Joe Biden
Nicky Minaj=Nicki Minaj
Engels & Völkers=Engel & Völkers
Micky Mouse=Mickey Mouse
Oscar Wild=Oscar Wilde
Christiano Ronaldo=Cristiano Ronaldo	Did you mean Cristiano Ronaldo, the professional soccer player?
Zack Snider=Zack Snyder
Zach Snyder=Zack Snyder
Dan Akroyd=Dan Aykroyd
Toby Maguire=Tobey Maguire
virtual signalling=virtue signalling
virtual signaling=virtue signaling
Warren Buffet=Warren Buffett
Brad Pit=Brad Pitt
Valteri Bottas=Valtteri Bottas
Pretty Patel=Priti Patel
Priti Petal=Priti Patel
New Dehli=New Delhi
New Deli=New Delhi
Selma Hayek=Salma Hayek
Wu Tang Clan=Wu-Tang Clan
Cindy Lauper=Cyndi Lauper
Lindsay Graham=Lindsey Graham
Lindsey Lohan=Lindsay Lohan
Uncle Cracker=Uncle Kracker
Vladimir Klitschko=Wladimir Klitschko
Toto Wolf=Toto Wolff
J.P. Morgan Chase=JPMorgan Chase
JP Morgan Chase=JPMorgan Chase
JP Morgan=J.P. Morgan
Karl Benz=Carl Benz
Phillips Airfryer=Philips Airfryer
Phillips Hue=Philips Hue
Phillips Senseo=Philips Senseo
Mark Andreessen=Marc Andreessen
Rammstein Air Base=Ramstein Air Base
Karine Jean Pierre=Karine Jean-Pierre
super dupa=super-duper
Disney Wold=Disney World
Sankt Petersburg=Saint Petersburg
PSG Eindhoven=PSV Eindhoven
Northrop Gruman=Northrop Grumman
Northrup Gruman=Northrop Grumman
Northrup Grumman=Northrop Grumman
enroute=en route
Darkwin Duck=Darkwing Duck
DB Cooper=D. B. Cooper
Petshop Boys=Pet Shop Boys
Terrence Hill=Terence Hill
JK Rowling=J. K. Rowling
Gordon Ramsey=Gordon Ramsay
We Bear Bears=We Bare Bears
Mathias Dopfner=Mathias Döpfner
Matthias Döpfner=Mathias Döpfner
Remmington Steele=Remington Steele
Remmington Steel=Remington Steele
Remington Steel=Remington Steele
Gary Kasparov=Garry Kasparov	Did you mean Garry Kasparov, the chess player?
Philip Plein=Philipp Plein
Phillip Plein=Philipp Plein
Britney Griner=Brittney Griner
Inglourious Bastards=Inglourious Basterds	Did you mean "Inglourious Basterds", the film by Quentin Tarantino? The film's name is misspelled on purpose.
Inglorious Bastards=Inglourious Basterds	Did you mean "Inglourious Basterds", the film by Quentin Tarantino? The film's name is misspelled on purpose.
Inglorious Basterds=Inglourious Basterds	Did you mean "Inglourious Basterds", the film by Quentin Tarantino? The film's name is misspelled on purpose.
Oliver Giroud=Olivier Giroud
Exxon Mobile=ExxonMobil
Curse Hero=Course Hero
Ethan Hawk=Ethan Hawke
Axel Rose=Axl Rose
Absolute Vodka=Absolut Vodka
add-ob=add-on
add-obs=add-ons
add-om=add-on
add-oms=add-ons
Bernie Maddoff=Bernie Madoff
processer=processor
processers=processors
unique selling preposition=unique selling proposition
unique selling prepositions=unique selling propositions
Hilary Clinton=Hillary Clinton
Hilary Rodham Clinton=Hillary Rodham Clinton
Hillary Duff=Hilary Duff
Hillary Swank=Hilary Swank
Tailor Swift=Taylor Swift
Alan Touring=Alan Turing
Joseph Göbbels=Joseph Goebbels
Josef Goebbels=Joseph Goebbels
Josef Göbbels=Joseph Goebbels
Steve Carrell=Steve Carell
Dave Chapelle=Dave Chappelle
Melitta Benz=Melitta Bentz
Tomb Rider=Tomb Raider
Barnes & Nobles=Barnes & Noble
Barnes and Nobles=Barnes & Noble
JRR Tolkien=J. R. R. Tolkien
South Carolin=South Carolina
North Carolin=North Carolina
Bud Lite=Bud Light
Fruit Loops=Froot Loops	Did you mean the breakfast cereal (which is spelled "froot" not "fruit")?
Leonardo Di Caprio=Leonardo DiCaprio	The surname of the famous actor is spelled as one word.
Di Caprio=DiCaprio	The surname of the famous actor is spelled as one word.
Johnny Deep=Johnny Depp	Did you mean "Johnny Depp" (American actor and musician)?
Julian Nagelsman=Julian Nagelsmann
Katherine Hepburn|Catherine Hepburn=Katharine Hepburn	The name of the famous actress is "Katharine".
Boznia and Herzegovina=Bosnia and Herzegovina
Boznia Herzegovina=Bosnia and Herzegovina
Boznia-Herzegovina=Bosnia and Herzegovina
Bosnia Herzegovina=Bosnia and Herzegovina
Bosnia-Herzegovina=Bosnia and Herzegovina
Key Lago=Key Largo
chick fil a=Chick-fil-A
chick fill a=Chick-fil-A
chicken fil a=Chick-fil-A
Ernest & Young=Ernst & Young
Hanna Montana=Hannah Montana
Edvard Munk=Edvard Munch
Edward Munch=Edvard Munch
Niki Haley=Nikki Haley
Phillip Morris=Philip Morris
untied Ireland=united Ireland
Downtown Abbey=Downton Abbey
Sascha Baron Cohen=Sacha Baron Cohen
30 Seconds to Mars=Thirty Seconds to Mars	Did you mean the music group?
cafe latte=caffe latte	Did you mean the beverage consisting of espresso and steamed milk?
café latte=caffe latte	Did you mean the beverage consisting of espresso and steamed milk?
cafè latte=caffe latte	Did you mean the beverage consisting of espresso and steamed milk?
derogative=derogatory	'Derogative' is less common than 'derogatory', and replacing it could make your writing clearer.
running nose=runny nose
gpt 3.5=GPT-3.5
Capital Hill=Capitol Hill	Unless you are writing about the place in Australia or Malawi, "Capitol Hill" is more likely.
along way=a long way
Burkina-Faso=Burkina Faso
Mallard reaction=Maillard reaction
dev ops=DevOps
port cochere=porte cochère
port cochère=porte cochère
aerogramme=aerogram	'Aerogram' is the more commonly used spelling.
aerogrammes=aerograms	'Aerograms' is the more commonly used spelling.
attogramme=attogram	'Attogram' is the more commonly used spelling.
attogrammes=attograms	'Attograms' is the more commonly used spelling.
centigramme=centigram	'Centigram' is the more commonly used spelling.
centigrammes=centigrams	'Centigrams' is the more commonly used spelling.
decigramme=decigram	'Decigram' is the more commonly used spelling.
decigrammes=decigrams	'Decigrams' is the more commonly used spelling.
decagramme=decagram	'Decagram' is the more commonly used spelling.
decagrammes=decagrams	'Decagrams' is the more commonly used spelling.
dekagramme=dekagram	'Dekagram' is the more commonly used spelling.
dekagrammes=dekagrams	'Dekagrams' is the more commonly used spelling.
exagramme=exagram	'Exagram' is the more commonly used spelling.
exagrammes=exagrams	'Exagrams' is the more commonly used spelling.
femtogramme=femtogram	'Femtogram' is the more commonly used spelling.
femtogrammes=femtograms	'Femtograms' is the more commonly used spelling.
gigagramme=gigagram	'Gigagram' is the more commonly used spelling.
gigagrammes=gigagrams	'Gigagrams' is the more commonly used spelling.
gramme=gram	'Gram' is the more commonly used spelling.
grammes=grams	'Grams' is the more commonly used spelling.
hectogramme=hectogram	'Hectogram' is the more commonly used spelling.
hectogrammes=hectograms	'Hectograms' is the more commonly used spelling.
kilogramme=kilogram	'Kilogram' is the more commonly used spelling.
kilogrammes=kilograms	'Kilograms' is the more commonly used spelling.
megagramme=megagram	'Megagram' is the more commonly used spelling.
megagrammes=megagrams	'Megagrams' is the more commonly used spelling.
microgramme=microgram	'Microgram' is the more commonly used spelling.
microgrammes=micrograms	'Micrograms' is the more commonly used spelling.
milligramme=milligram	'Milligram' is the more commonly used spelling.
milligrammes=milligrams	'Milligrams' is the more commonly used spelling.
nanogramme=nanogram	'Nanogram' is the more commonly used spelling.
nanogrammes=nanograms	'Nanograms' is the more commonly used spelling.
petagramme=petagram	'Petagram' is the more commonly used spelling.
petagrammes=petagrams	'Petagrams' is the more commonly used spelling.
picogramme=picogram	'Picogram' is the more commonly used spelling.
picogrammes=picograms	'Picograms' is the more commonly used spelling.
teragramme=teragram	'Teragram' is the more commonly used spelling.
teragrammes=teragrams	'Teragrams' is the more commonly used spelling.
yoctogramme=yoctogram	'Yoctogram' is the more commonly used spelling.
yoctogrammes=yoctograms	'Yoctograms' is the more commonly used spelling.
yottagramme=yottagram	'Yottagram' is the more commonly used spelling.
yottagrammes=yottagrams	'Yottagrams' is the more commonly used spelling.
zeptogramme=zeptogram	'Zeptogram' is the more commonly used spelling.
zeptogrammes=zeptograms	'Zeptograms' is the more commonly used spelling.
zettagramme=zettagram	'Zettagram' is the more commonly used spelling.
zettagrammes=zettagrams	'Zettagrams' is the more commonly used spelling.