# @author Yakov Reztsov
# TODO: дописать список

# Формат: ошибочная_фраза=правильная_фраза

# слова
курей=кур
ложить=класть
покласть=положить
положь=положи
положьте=положите
покладу=положу
ляжь=ляг
ляжьте=лягте

длинше=длиннее
ширше=шире
тончее=тоньше
тонче=тоньше
слаже=слаще
красивше=красивее

хужее=хуже

стригет=стрижёт
стригёт=стрижёт
стригем=стрижём
стригём=стрижём
стригешь=стрижёшь
стригёшь=стрижёшь
стригете=стрижёте
стригёте=стрижёте

бегим=бежим
бежите=бегите
бежи=беги
длиньше=длиннее 
нагинаться=нагибаться
застегать=застёгивать

ехай=поезжай
ехайте=поезжайте
едь=поезжай
езжай=поезжай
езжайте=поезжайте

приколон=приколот

порват=порван
порвата=порвана
даден=дан 

толью=толем
шампунью=шампунем
повидлой=повидлом

съемши=съев
поемши=поев
выпимши=выпив
купивши=купив
пришедши=придя

тубаретка=табуретка
ндравится=нравится
подчерк=почерк
подскользнуться=поскользнуться
коммунизьм=коммунизм
акадэмия=академия 

жгешь=жжёшь
жгёшь=жжёшь
жгет=жжёт
жгёт=жжёт
жгем=жжём
жгём=жжём
жгете=жжёте
жгёте=жжёте

пекешь=печёшь
пекёшь=печёшь
пекёт=печёт
пекем=печём
пекём=печём
пекёте=печёте

хочим=хотим
хочите=хотите

взади=сзади
дрыхнуть=спать
дрыхнет=спит
дрыхнул=спал
дрыхнула=спала
драпануть=убежать
драпает=убегает
драпанул=убежал
драпанула=убежала
назаду=сзади 
взад=назад
взаду=позади 
#взад назад=взад вперёд 
вовнутрь=внутрь 
куды=куда 
туды=туда
сюды=сюда 
тама=там 
здеся=здесь
тута=тут 
зазря=зря
зараз=сразу
сперва=сначала
перво-наперво=сначала
опосля=потом
впервой=впервые
по-новой=снова
глыбоко=глубоко
#без разницы=безразлично 
#взаправду=по правде 
зазря=зря 
ширше=шире
шарахнуть=ударить
шарахает=бьёт
шарахнул=ударил
шарахнула=ударила
шарахнуло=ударило
длиньше=длиннее 
напополам=пополам
#один за одним=один за другим
щас=сейчас

