# Expressões portuguesas redundantes
# (c) 2017 Tiago F. Santos
# Licensed under LGPL
#
# List triaged and compiled from multiple internet sources. 
# Sources:
# https://pt.wikipedia.org/wiki/Lista_de_express%C3%B5es_idiom%C3%A1ticas
# https://pt.wikipedia.org/wiki/Lista_de_pleonasmos
# Este texto é disponibilizado nos termos da licença
# Creative Commons - Atribuição - Compartilha Igual 3.0 Não Adaptada (CC BY-SA 3.0);
# pode estar sujeito a condições adicionais. Para mais detalhes, consulte as Condições de Uso.
# Some redundancies were also based on Lightproof rules
#
a seu critério pessoal=a seu critério
abismo profundo=abismo
abismo sem fundo=abismo
abismos profundos=abismos
abismos sem fundo=abismos
abotoadura de botões=abotoadura
abotoaduras de botões=abotoaduras
absoluta verdade=verdade
absolutamente inacreditáveis=inacreditáveis
absolutamente inacreditável=inacreditável
absolutas verdades=verdades
absoluto silêncio=silêncio
absolutos silêncios=silêncios
ainda permanece=permanece
ainda permaneces=permaneces
alameda de árvores=alameda
alamedas de árvores=alamedas
alastrar-se mais=alastrar-se
alcateia de lobos=alcateia
alcateias de lobos=alcateias
alerta prévio=alerta
alertas prévio=alertas
alfabeto de letras=alfabeto
alfabetos de letras=alfabetos
alteração posterior=alteração
alterações posteriores=alterações
ambas as duas=ambas|as duas
ambição pessoal=ambição
ambições pessoais=ambições
ambos os dois=ambos|os dois
andecamestre de onze meses=andecamestre
andecamestres de onze meses=andecamestres
aniquilação total=aniquilação
ano de doze meses=ano
anos de doze meses=anos
aparência exterior=aparência
aparência exterior=aparência
aparências exteriores=aparências
aparências exteriores=aparências
aposentadoria vitalícia=aposentadoria
aposentadorias vitalícias=aposentadorias
armada de navios=armada
armadas de navios=armadas
arquipélago de ilhas=arquipélago
arquipélagos de ilhas=arquipélagos
arvoredo de árvores=arvoredo
arvoredos de árvores=arvoredos
assembleia de parlamentares=assembleia
assembleias de parlamentares=assembleias
até hoje ainda se=até hoje|ainda se
até hoje, ainda se=até hoje|ainda se
atitude mental=atitude
atitudes mentais=atitudes
atlas de mapas=atlas
atrás na retaguarda=atrás
autossatisfação interior=autossatisfação
aviso prévio=aviso
avisos prévios=avisos
baleais de baleias=baleais
baleal de baleias=baleal
banda de músicos=banda
bandas de músicos=bandas
bando de pássaros=bando
bandos de pássaros=bandos
barbaramente torturada=torturadas
barbaramentes torturada=torturadas
bastante embriagada=embriagada
bastante embriagadas=embriagadas
beco sem saída=beco
becos sem saída=becos
biblioteca de livros=biblioteca
bibliotecas de livros=bibliotecas
biénio de dois anos=biénio
biénios de dois anos=biénios
bimestre de dois meses=bimestre
bimestres de dois meses=bimestres
boato falso=boato
boatos falsos=boatos
boiada de bois=boiada
boiadas de bois=boiadas
bónus adicionais=bónus
bónus adicional=bónus
bosque de árvores=bosque
bosques de árvores=bosques
brasas ardentes=brasas
breve alocução=alocução
breves alocuções=alocuções
brigadeiro da aeronáutica=brigadeiro
brigadeiro da aeronáutica=brigadeiro
brigadeiros da aeronáutica=brigadeiros
brigadeiros da aeronáutica=brigadeiros
burricada de burros=burricada
burricadas de burros=burricadas
cabidela de moedas=cabidela
cabidelas de moedas=cabidelas
cacho de frutas=cacho
cachos de frutas=cachos
cada segundo que passa=cada segundo
cada vez mais crescente=crescente
cadas vez mais crescente=crescentes
caravana de viajantes=caravana
caravanas de viajantes=caravanas
cardume de peixes=cardume
cardumes de peixes=cardumes
carvalhais de carvalhos=carvalhals
carvalhal de carvalhos=carvalhal
castinçais de castanheiros=castinçais
castinçal de castanheiros=castinçal
celebração alegre=celebração
cercada por todos os lados=cercada
cercadas por todos os lados=cercadas
cercado por todos os lados=cercado
cercais de cerquinhos=cercais
cercal de cerquinhos=cercal
choque brutal=choque
choques brutais=choques
chuva que cai=chuva
chuva que caiu=chuva
chuvas que caem=chuvas
chuvas que caíram=chuvas
chuvinha fina=chuvinha
chuvinhas finas=chuvinhas
clitóris feminino=clitóris
colaboração conjunta=colaboração
comparativamente maior que=menor que
comparativamente menor que=maior que
completa estranha=estranha
completas estranhas=estranhas
completo estranho=estranho
completos estranhos=estranhos
conclave de cardeais=conclave
conclaves de cardeais=conclaves
congregação de professores=congregação
congregações de professores=congregações
consenso de opinião=consenso
consensos de opinião=consensos
consistório de cardeais=consistório
consistórios de cardeais=consistórios
constelação de estrelas=constelação
constelações de estrelas=constelações
contratempo inusitado=contratempo
contratempos inusitados=contratempos
cordilheira de montanhas=cordilheira
cordilheiras de montanhas=cordilheiras
corja de malandros=corja
corjas de malandros=corjas
corpo docente de professores=corpo
corpos docentes de professores=corpos
critério pessoal=critério
critério pessoal=critério
cuidadosamente calculado=calculado
década de dez anos=década
décadas de dez anos=décadas
decamestre de dez meses=decamestre
decamestres de dez meses=decamestres
democracia popular=democracia
democracias populares=democracias
destino final=destino
destinos finais=destinos
destruição total=destruição
detalhes muito pequenos=detalhes
detalhes tão pequenos=detalhes
dia de 24 horas=dia
dias de 24 horas=dias
dia de amanhã=amanhã
dia de depois de amanhã=depois de amanhã
dia de depois de ontem=depois de ontem
dia de hoje=hoje
dia de ontem=ontem
discoteca de discos=discoteca
discotecas de discos=discotecas
duna de areia=duna
dunas de areia=dunas
elenco de actores=elenco
elenco de artistas=elenco
elenco de atores=elenco
elencos de actores=elencos
elencos de artistas=elencos
elencos de atores=elencos
enxame de abelhas=enxame
enxames de abelhas=enxames
equipa de jogadores=equipa
equipas de jogadores=equipas
escrutínio cuidadoso=escrutínio
esquadra de navios=esquadra
esquadras de navios=esquadras
esquadrilha de aviões=esquadrilha
estrutura geral=estrutura
estudo aprofundado=estudo
exército de soldados=exército
exércitos de soldados=exércitos
explosão violenta=explosão
explosões violentas=explosões
extremo limite=extremo|limite
extremos limites=limites|extremos
facto verdadeiro=facto
factos verdadeiros=factos
falso boato=boato
falso pretexto=pretexto
falsos boatos=boatos
falsos pretextos=pretextos
família de parentes em geral=família
famílias de parentes em geral=famílias
famosa celebridade=famosa|celebridade
farandula de mendigos=farandula
farandulas de mendigos=farandulas
fato de cabras=fato
fato verdadeiro=facto
fatos de cabras=fatos
fatos verdadeiros=factos
fauna de animais=fauna
faunas de animais=faunas
flora de plantas=flora
floras de plantas=floras
frota de navios=frota
frotas de navios=frotas
fundamento básico=fundamento
fundamentos básicos=fundamentos
gataria de gatos=gataria
gatarias de gatos=gatarias
gelo congelado=gelo
gelos congelados=gelos
general do exército=general
grande em tamanho=grande
grande furor=furor
grandes em tamanho=grandes
grandes furores=furores
grave crise=crise
herbário deplantas=herbário
herbários deplantas=herbários
história passada=história
histórias passadas=histórias
iguais a um outro=iguais
igual a um outro=igual
impulso súbito=impulso
impulsos súbitos=impulsos
instinto natural=instinto
instintos naturais=instintos
intrigante em natureza=intrigante
intrigante na natureza=intrigante
intrigantes em natureza=intrigantes
intrigantes na natureza=intrigantes
inusitado contratempo=contratempo
inusitados contratempos=contratempos
inúteis em função=inúteis
inútil em função=inútil
jovem em idade=jovem
jovens em idade=jovens
limite extremo=limite|extremo
limites extremos=limites|extremos
mais prováveis=prováveis
mais provável=provável
memória do passado=memória
memórias do passado=memórias
milénio de mil anos=milénio
milénios de mil anos=milénios
minha opinião pessoal=minha opinião|opinião pessoal
muitas maneiras diferentes=muitas maneiras
muito embriagada=embriagada
muito embriagadas=embriagadas
multidão de gente=multidão
multidões de gente=multidões
necessária experiência anterior=necessária experiência
necessário experiência anterior=necessário experiência
ninhada de filhotes=ninhada
ninhadas de filhotes=ninhadas
nonamestre de nove meses=nonamestre
nonamestres de nove meses=nonamestres
novena de nove dias=novena
novenas de nove dias=novenas
novidade inédita=novidade
novidades inéditas=novidades
nunca antes=nunca
nuvem de gafanhotos=nuvem
nuvens de gafanhotos=nuvens
o completo oposto de=o oposto de
o oposto completo de=o oposto de
octamestre de oito meses=octamestre
octamestres de oito meses=octamestres
olivais de oliveiras=olivais
olival de oliveiras=olival
opinião pessoal=opinião
opiniões pessoais=opiniões
panapaná de borboletas=panapaná
panapanás de borboletas=panapanás
penca de frutas=penca
pencas de frutas=pencas
pequeno detalhe=detalhe
pequeno em tamanho=pequeno
pequenos detalhes=detalhes
pequenos em tamanho=pequenos
perfeição máxima=perfeição
perigo grave=perigo
perigos graves=perigos
permanece ainda=permanece
permaneces ainda=permaneces
pistoleiro armado=pistoleiro
pistoleiros armados=pistoleiros
planeamento antecipado=planeamento
planeamentos antecipados=planeamentos
plano global=plano
planos futuros=planos
planos globais=planos
plêiade de artistas=plêiade
plêiades de artistas=plêiades
pouca em número=pouca
poucas em número=poucas
pouco em número=pouco
poucos em número=poucos
pré-requisito necessário=pré-requisito
prelatura de bispos=prelatura
prelaturas de bispos=prelaturas
primeira prioridade=prioridade
protagonista principal=protagonista
protagonistas principais=protagonistas
quadriénio de quatro anos=quadriénio
quadriénios de quatro anos=quadriénios
quadrimestre de quatro meses=quadrimestre
quadrimestres de quatro meses=quadrimestres
quinquénio de cinco anos=quinquénio
quinquénios de cinco anos=quinquénios
quinquimestre de cinco meses=quinquimestre
quinquimestres de cinco meses=quinquimestres
ramalhete de flores=ramalhete
ramalhetes de flores=ramalhetes
rara excepção=excepção
raras excepções=excepções
rebanho de ovelha=rebanho
rebanhos de ovelha=rebanhos
reboredo de carvalhos=reboredo
reboredos de carvalhos=reboredos
recorde histórico=recorde
recordes histórico=recordes
residente local=residente
residentes locais=residentes
resultado final=resultado
resultados final=resultados
século de cem anos=século
séculos de cem anos=séculos
semana de sete dias=semana
semanas de sete dias=semanas
semelhanças comuns=semelhanças
semestre de seis meses=semestre
semestres de seis meses=semestres
sentimento interno=sentimento
sentimentos internos=sentimentos
septuamestre de sete meses=septuamestre
septuamestres de sete meses=septuamestres
sesquicentenário de cento e cinquenta anos=sesquicentenário
sesquicentenários de cento e cinquenta anos=sesquicentenários
sesquisséculo de cento e cinquenta anos=sesquisséculo
sesquisséculos de cento e cinquenta anos=sesquisséculos
silêncio absoluto=silêncio
silêncios absolutos=silêncios
soma total=total|soma
souto de castanheiros=souto
soutos de castanheiros=soutos
tertúlia de parentes=tertúlia
tertúlias de parentes=tertúlias
todas as demais=as demais
todo o resto=o resto
todos as demais=as demais
todos o resto=os restos
todos os demais=os demais
todos sem exceção=todos
todos, sem exceção =todos
todos, sem exceção,=todos
torturada barbaramente=torturada
torturadas barbaramente=torturadas
total somado=total|somado
triénio de três anos=triénio
triénios de três anos=triénios
trimestre de três meses=trimestre
trimestres de três meses=trimestres
trio de três=trio
trios de três=trios
trompa de lamas=trompa
trompas de lamas=trompas
turma de alunos=turma
turmas de alunos=turmas
unido como um=unido
unidos como um=unidos
vara de porcos=vara
varas de porcos=varas
vários diferentes=vários
verdade absoluta=verdade
verdades absolutas=verdades
virá no futuro=virá
virão no futuro=virão
visível para o olho=visível
vivência subjetiva=vivência
vivências subjetivas=vivências

