# @author Yakov Reztsov
# TODO: дописать список

# Формат: ошибочная_фраза=правильная_фраза

# слова
ни будь=нибудь	Опечатка
по идти=пойти	Опечатка
по-крайней=по крайней	Опечатка
по-крайнему=по крайнему	Опечатка
по-полной=по полной	Опечатка
по-меньшей=по меньшей	Опечатка
по-большей=по большей	Опечатка
#
#1-го=первого	Некорректное сокращение
#2-го=второго	Некорректное сокращение
#3-го=третьего	Некорректное сокращение
2-ух=двух	Некорректное сокращение
3-ёх=трёх	Некорректное сокращение
3-ех=трех	Некорректное сокращение
4-ёх=четырёх	Некорректное сокращение
4-ех=четырех	Некорректное сокращение
5-ти=пяти	Некорректное сокращение
6-ти=шести	Некорректное сокращение
7-ми=семи	Некорректное сокращение
8-ми=восьми	Некорректное сокращение
9-ти=девяти	Некорректное сокращение
10-ти=десяти	Некорректное сокращение
4-ого=4-го	Некорректное сокращение
4-ому=4-му	Некорректное сокращение
5-ого=5-го	Некорректное сокращение
5-ому=5-му	Некорректное сокращение
6-ого=6-го	Некорректное сокращение
6-ому=6-му	Некорректное сокращение
7-ого=7-го	Некорректное сокращение
7-ому=7-му	Некорректное сокращение
8-ого=8-го	Некорректное сокращение
8-ому=8-му	Некорректное сокращение
9-ого=9-го	Некорректное сокращение
9-ому=9-му	Некорректное сокращение
10-ыми=10-ми	Некорректное сокращение
20-ыми=20-ми	Некорректное сокращение
30-ыми=30-ми	Некорректное сокращение
40-ыми=40-ми	Некорректное сокращение
50-ыми=50-ми	Некорректное сокращение
60-ыми=60-ми	Некорректное сокращение
70-ыми=70-ми	Некорректное сокращение
80-ыми=80-ми	Некорректное сокращение
90-ыми=90-ми	Некорректное сокращение
1-ый=1-й	Некорректное сокращение
1-ой=1-й	Некорректное сокращение
1-ая=1-я	Некорректное сокращение
1-ое=1-е	Некорректное сокращение
1-ые=1-е	Некорректное сокращение
1-ым=1-м	Некорректное сокращение
1-ом=1-м	Некорректное сокращение
1-ых=1-х	Некорректное сокращение
2-ой=2-й	Некорректное сокращение
2-ая=2-я	Некорректное сокращение
2-ое=2-е	Некорректное сокращение
2-ые=2-е	Некорректное сокращение
2-ым=2-м	Некорректное сокращение
2-ом=2-м	Некорректное сокращение
2-ых=2-х	Некорректное сокращение
3-ий=3-й	Некорректное сокращение
3-их=3-х	Некорректное сокращение
4-ый=4-й	Некорректное сокращение
4-ой=4-й	Некорректное сокращение
4-ая=4-я	Некорректное сокращение
4-ое=4-е	Некорректное сокращение
4-ые=4-е	Некорректное сокращение
4-ым=4-м	Некорректное сокращение
4-ом=4-м	Некорректное сокращение
4-ых=4-х	Некорректное сокращение
5-ый=5-й	Некорректное сокращение
5-ой=5-й	Некорректное сокращение
5-ая=5-я	Некорректное сокращение
5-ое=5-е	Некорректное сокращение
5-ые=5-е	Некорректное сокращение
5-ым=5-м	Некорректное сокращение
5-ом=5-м	Некорректное сокращение
5-ых=5-х	Некорректное сокращение
6-ой=6-й	Некорректное сокращение
6-ая=6-я	Некорректное сокращение
6-ое=6-е	Некорректное сокращение
6-ые=6-е	Некорректное сокращение
6-ым=6-м	Некорректное сокращение
6-ом=6-м	Некорректное сокращение
6-ых=6-х	Некорректное сокращение
7-ой=7-й	Некорректное сокращение
7-ая=7-я	Некорректное сокращение
7-ое=7-е	Некорректное сокращение
7-ые=7-е	Некорректное сокращение
7-ым=7-м	Некорректное сокращение
7-ом=7-м	Некорректное сокращение
7-ых=7-х	Некорректное сокращение
8-ой=8-й	Некорректное сокращение
8-ая=8-я	Некорректное сокращение
8-ое=8-е	Некорректное сокращение
8-ые=8-е	Некорректное сокращение
8-ым=8-м	Некорректное сокращение
8-ом=8-м	Некорректное сокращение
8-ых=8-х	Некорректное сокращение
9-ый=9-й	Некорректное сокращение
9-ой=9-й	Некорректное сокращение
9-ая=9-я	Некорректное сокращение
9-ое=9-е	Некорректное сокращение
9-ые=9-е	Некорректное сокращение
9-ым=9-м	Некорректное сокращение
9-ом=9-м	Некорректное сокращение
9-ых=9-х	Некорректное сокращение
агенство=агентство	Опечатка
акадэмия=академия	Опечатка
алерт=предупреждение	Жаргон
анимэ=аниме	Опечатка
афёра=афера
баструма=бастурма	Опечатка
бегим=бежим
бежат=бегут
бежи=беги
#бежите=бегите
#без разницы=безразлично
бесеребреница=бессребреница
бесеребренник=бессребреник
бессеребреник=бессребреник
бессеребреница=бессребреница
бессеребренник=бессребреник
биллиона=миллиарда	Не используется
биллионе=миллиарде	Не используется
биллион=миллиард	Не используется
биллионом=миллиардом	Не используется
биллиону=миллиарду	Не используется
бубон=помпон
взади=сзади
взад=назад
#взад назад=взад вперёд
взаду=позади
вьётся сердце=бьётся сердце
вьется сердце=бьётся сердце
#взаправду=по правде
в конце-концов=в конце концов
взаимообразно=заимообразно
вовнутрь=внутрь
во внутрь=внутрь
впервой=впервые
выпимши=выпив
глыбоко=глубоко
даден=дан
девайс=устройство	Жаргон
длинше=длиннее
длиньше=длиннее
драпает=убегает
драпанула=убежала
драпанул=убежал
драпануть=убежать
друшлаг=дуршлаг	Опечатка
дрыхнет=спит
дрыхнула=спала
дрыхнул=спал
дрыхнуть=спать
евойный=его
евоный=его
едь=поезжай
езжай=поезжай
езжайте=поезжайте
ехай=поезжай
ехайте=поезжайте
жгем=жжём
жгете=жжёте
жгет=жжёт
жгешь=жжёшь
жгём=жжём
жгёте=жжёте
жгёт=жжёт
жгёшь=жжёшь
жжошь=жжёшь
зазря=зря
законнорожденный=законнорождённый
заместо=вместо
зараз=сразу
застегать=застёгивать
здеся=здесь
ивоный=его
инет=интернет
имплементация=реализация
коммунизьм=коммунизм	Опечатка
красивше=красивее
креативный=творческий
куды=куда
купивши=купив
курей=кур
ложить=класть
ляжь=ляг
ляжьте=лягте
ляпота=лепота
маневренный=манёвренный
маневр=манёвр
маневровый=манёвровый
маструбация=мастурбация
мультиканальный=многоканальный
нагинаться=нагибаться
назаду=сзади
накласть=наложить
напополам=пополам
ндравится=нравится
небось=пожалуй
нету=нет
непрешол=не пришёл
#новорожденный=новорождённый
#один за одним=один за другим
одно временно=одновременно	Опечатка
оплоченный=оплаченный
опосля=потом
орангутанг=орангутан	Опечатка
оффлайн=офлайн	Устаревшая форма
тойже=той же	Опечатка
пекем=печём
пекешь=печёшь
пекём=печём
пекёте=печёте
пекёт=печёт
пекёшь=печёшь
перво-наперво=сначала
перетрубация=пертурбация
перетурбация=пертурбация
#переходный пешеход=пешеходный переход
пертрубация=пертурбация
повидлой=повидлом
подскользнуться=поскользнуться
подчерк=почерк
поемши=поев
покладу=положу
покласть=положить
положь=положи
положьте=положите
полувер=пуловер
по-новой=снова
порвата=порвана
порват=порван
придти=прийти
приколон=приколот
пришедши=придя
пробывать=пробовать
проэкт=проект	Опечатка
рюземе=резюме	Опечатка
саунд=звук	Жаргон
свекла=свёкла
светопредставление=светопреставление
сготовить=приготовить
с золотом кольцом=с золотым кольцом
скабрезный=скабрёзный
скурпулезный=скрупулёзный	Опечатка
скурпулёзный=скрупулёзный	Опечатка
слаже=слаще
#сперва=сначала
стери=сотри
стригем=стрижём
стригете=стрижёте
стригет=стрижёт
стригешь=стрижёшь
стригём=стрижём
стригёте=стрижёте
стригёт=стрижёт
стригёшь=стрижёшь
съемши=съев
сымать=снимать
сюды=сюда
тама=там
текет=течёт
текёт=течёт
тенета=тенёта
толью=толем
тончее=тоньше
тонче=тоньше
траффик=трафик	Устаревшая форма
траффика=трафика	Устаревшая форма
траффику=трафику	Устаревшая форма
траффиком=трафиком	Устаревшая форма
траффике=трафике	Устаревшая форма
траффики=трафики	Устаревшая форма
траффиков=трафиков	Устаревшая форма
траффикас=трафикам	Устаревшая форма
траффиками=трафиками	Устаревшая форма
траффиках=трафиках	Устаревшая форма
троеточие=многоточие
тубаретка=табуретка	Опечатка
туды=туда
#тута=тут
тюлью=тюлем
уморенный=уморённый
#у ней=у неё
уполномачивать=уполномочивать
уславливаться=условливаться
ферштейн=понятно
хочим=хотим
хочите=хотите
хужее=хуже
#че=что
чё=что
шаверма=шаурма
шампунью=шампунем
шарахает=бьёт
шарахнула=ударила
шарахнуло=ударило
шарахнул=ударил
шарахнуть=ударить
ширше=шире
щас=сейчас
экспрессо=эспрессо	Опечатка
