# Simple replace table for soft suggestions
# Format: word=suggestion1|suggestion2|suggestion3...

автовишка=автовежа
акаунт=обліковий запис|рахунок
апдейт=оновлення
Ашхабад=Ашгабат
Бабинопілля=Акрешори (1993)
бабинопільський=акрешорський (1993)
біложаровий=білорозжарений
Білорусія=Білорусь
Біньова=Беньова (2013)
Бісівка=Квітневе (1966)
Братове=Ботар
братолюбивість=братолюбність
брелок=дармовис
Вариводки=Варивідки
венгерський=угорський
вендор=постачальник
взаємодоповнюваний=взаємодоповняльний
видумка=вигадка
вижга=випал
виплавлення=витоплення
виплавлювання=витоплювання
виплавлювати=витоплювати
вишка=вежа|вартівня|шпилик
відображати=ctx: математика|показувати|зображати|відбивати
відображатися=ctx: математика|показуватися|зображатися|відбиватися
відображений=ctx: математика|відбитий|зображений|показаний
відображення=ctx: математика|відбивання|відбиття|відбиток|зображення|показ
відображуваний=ctx: математика|відбиваний|зображуваний|показуваний
відобразити=ctx: математика|показати|зобразити|відбити
відобразитися=ctx: математика|показатися|зобразитися|відбитися
відпарируваний=відбитий
відсканований=засканований|просканований
відсканувати=засканувати|просканувати
відскануватися=заскануватися|проскануватися
водогазоємний=водогазомісткий
водоємність=водомісткість
вологоємний=вологомісткий
вологоємність=вологомісткість
вольність=вільність|привілей
вторгатися=вдиратися|впиратися
вторгнутися=вдертися|впертися
Галаєвець=Галаївець (2015)
Ганді=Ґанді
Гаяна=Гайана (Класифікатор країн світу)
Гейзенберг=Гайзенберг
Гейзенберґ=Гайзенберґ
Гете=Ґете
Гете-інститут=Ґете-інститут
ґміна=гміна
Головецьк=Головецько (1989)
Голосієве=Голосіїв
Голосієво=Голосіїв
Греммі=Ґреммі
Ґренландія=Гренландія (Класифікатор країн світу)
давньоіудейський=давньоюдейський
датський=данський
датсько-ісландський=дансько-ісландський
датсько-шведський=дансько-шведський
датчанин=данець
датчанка=данка
двохмільйонний=двомільйонний
двохмільярдний=двомільярдний
двохтисячний=двотисячний
Демокрит=Демокріт
держатель=власник|тримач|держальник
Дніпродзержинськ=Кам'янське
дніпродзержинський=кам'янський
Дніпропетровщина=Дніпровщина
Доробратове=Доробратово
Драгове=Драгово
духовенство=духівництво
Ейнштейн=Айнштайн
екаунт=обліковий запис|рахунок
електроємний=електромісткий
електроємнісний=електромісткісний
електроємність= електромісткість
енергоємний=енергомісткий
енергоємність=енергомісткість
ємний=місткий
ємнісний=місткісний
ємність=місткість
жертвенний=жертовний
загородній=позаміський|приміський
задушевний=сердечний|щирий|щиросердечний|душевний
задушевність=сердечність|щирість|щиросердечність|душевність
заклеймити=затаврувати
заклеймлений=затаврований
заклеймований=затаврований
заклеймувати=затаврувати
Закроївщина=Закроівщина
закроївщинський=закроівщинський
Івачкове=Івачків (2008)
інь=їнь
іуда=юда
Іуда=Юда
іудаїзм=юдаїзм
іудей=юдей
іудейка=юдейка
іудейство=юдейство
іудейський=юдейський
іудео-арабський=юдео-арабський
іудео-перський=юдео-перський
іудин=юдин
Іудин=Юдин
казначей=скарбник
казначейство=скарбниця
казначейський=скарбничий
канадійський=канадський
капіталоємний=капіталомісткий
капіталоємність=капіталомісткість
квазівчений=квазінауковець
Квасове=Квасово
Китаєво=Китаїв
Кімнатка=Кімната (2009)
кіношник=кінороб
колчан=сагайдак
коментарій=коментар
Кушка=Серхетабат|Серхетабад
лайфхак=корисняк
лінитися=лінуватися
лонгрід=довгочит
Лохове=Лохово
лузер=невдаха
Лукачани=Лукачівка
Лукнове=Лукнове (2014)
Магарач=Відрадне
Мазинки=Мазінки (2013)
майєвтика=маєвтика
марочний=марковий
маститий=сивоголовий|поважний|почесний|шановний
матеріалоємний=матеріаломісткий
матеріалоємність=матеріаломісткість
металоємний=металомісткий
металоємність=металомісткість
місцерозташування=місце розташування
мітчик=значильник|значій
мітчик=різьборіз|гайкоріз|мутроріз
многогрішний=ctx: релігія,поезія|великогрішний|великогрішник
многостраждальний=ctx: релігія,поезія|великостраждальний|великострадний
многотрудний=ctx: релігія,поезія|великотрудний|велетрудний|(дуже) трудний|(дуже) важкий
Мочалине=Молчалине
Мукачеве=Мукачево (5188 від 27.09.2016, прийнято 23.05.2017)
мурал=стінопис
налаштунок=налаштовання
наробок=доробок|напрацювання
неофіціальний=неофіційний
неофіціальність=неофіційність
непідвідомчий=непідпорядкований|непідрядний
непідвідомчість=непідпорядкованість|непідрядність
Нетяжине=Нетяжино (2009)
НКАУ=Державне космічне агентство України (2010)
Новобарове=Новобарово (1995)
носоглотка=носоглотка|носогорло|носопролиг
обнародуваний=оприлюднений|оголошений
обнародування=оприлюднення|оголошення
обнародувати=оприлюднити|оголосити
обнародуватися=оприлюднювати|оголошувати
обстановка=обстава|обставини
Озірщина=Озерщина
омочений=обмочений
Оросієве=Оросієво
офіціальний=офіційний
офіціальність=офіційність
Охиньки=Охіньки (2009)
оцифрований=зацифрований
оцифровування=зацифровування
оцифровуватися=зацифровувати
оцифруватися=зацифрувати
павперизація=пауперизація
Пазинаки=Пазиняки (1989)
парируваний=відбиваний|відбитий
Пацканьове=Пацканьове (1995)
Петики=Петихи
Пирогово=Пирогів
підвідомчий=підпорядкований|підрядний
підвідомчість=підпорядкованість|підрядність
Пістрялове=Пістрялово (1995)
Повітне=Повітно (1990)
полтавчанин=полтавець
полтавчанка=полтавка
Порошкове=Порошково (1995)
поствоєнний=післявоєнний|повоєнний
постноворічний=післяноворічний
постправда=післяправда
постправдний=післяправдний
постсвятковий=післясвятковий
поціновка=оцінка|оцінювання
Прибілля=Ятвяги (2015)
призупинений=(тимчасово) зупинений
призупинення=(тимчасове) зупинення
призупинити=(тимчасово) зупинити|перепинити|притишити|пригальмувати
призупинитися=(тимчасово) зупинитися|притишитися|пригальмуватися
призупиняти=(тимчасово) зупиняти|перепиняти|пригальмовувати
призупинятися=(тимчасово) зупинятися|перепинятися|пригальмовуватися
просвітитель=просвітник
просвітительство=просвітництво
просвітительський=просвітницький
псевдовчений=псевдонауковець
пустодзвонний=пустодзвінний
пустодзвонність=пустодзвінність
радіовишка=радіовежа
радіокоментарій=радіокоментар
Рафайнове=Рафайново
рейхсканцлер=райхсканцлер
рейхскомісаріат=райхскомісаріат
рейхсфюрер=райхсфюрер
розділка=риска
розукрупнений=подрібнений|розбитий
ротаріанець=ротарієць
Рулеве=Рулево (1989)
русло=річище
русловий=річищний
Савойя=Савоя
Сасове=Сасово
Святошино=Святошин
Селиськи=Селіски
Середа=Вовче (1991)
Сєверодонецьк=Сєвєродонецьк (2008)
сєверодонецький=сєвєродонецький (2008)
Скипче=Скіпче (2015)
Собанівка=Сабанівка
соціо-культурний=соціокультурний
спасатися=ctx: релігія,поезія|рятуватися|визволятися
спасіння=ctx: релігія,поезія|рятування|рятунок|порятунок|визволення
співробітничати=співпрацювати
стекла=скла
стеклам=склам
стеклами=склами
стеклах=склах
стекол=скел
Страбичове=Страбичово (1995)
сумчанин=сум'янин
сумчанка=сум'янка
Сускове=Сусково (1995)
Сушне=Сушно (1989)
твердосплавний=твердостоповий
твердосплавність=твердостоповість
Текове=Теково (1995)
телебашта=телевежа
теплоємний=тепломісткий
теплоємність=тепломісткість
тернопільчанин=тернополянин
тернопільчанка=тернополянка
товкотнеча=тиснява|товчія|штовханина
Трудколонія=Медичне (1991)
трьохмільйонний=тримільйонний
трьохмільярдний=тримільярдний
трьохтисячний=тритисячний
Уотсон=Вотсон
услуга=послуга
Успіння=Перша пречиста
Фанчикове=Фанчиково (1995)
Фердінанд=Фердинанд
Фердінандів=Фердинандів
фондоємний=фондомісткий
фондоємність=фондомісткість
фрейдівський=фройдівський
Фрунзенка=Діброва (2016)
хльосткий=хвиський|дошкульний|шпаркий
хльосткіший=хвиськіший|дошкульніший|шпаркіший
чеддер=чедер
чернігівчанин=чернігівець
чернігівчанка=чернігівка
чотирьохмільйонний=чотиримільйонний
чотирьохмільярдний=чотиримільярдний
шарикопідшипник=кулькова вальниця|кульковальниця
шарикопідшипниковий=кульковальничний
шкло=скло
шльопанець=ляпанець
янь=ян
Яремча=Яремче (2006)
