# Simple replace table
# Format: word=suggestion1|suggestion2|suggestion3...

# TODO: add inflection support for suggestions

абсорбуючий=поглинальний|вбиральний|усмоктувальний|абсорбівний|що абсорбує|що всотує|що всмоктує|що поглинає|що вбирає
абстрагуючий=що абстрагує|абстрагувальний|абстракційний
авансуючий=що авансує|авансодавець
авіаобробка=авіаоброблення
авіапаливо=авіапальне
авось=ачей|чей|(а)чень|може|може чи не|може-таки
автогоночний=автоперегоновий
автоматизуючий=що автоматизує|автоматизувальний|автоматизаційний
автомийка=автомийня
агітуючий=що агітує|зайнятий агітацією|агітаційний|агітатор
агонізуючий=що агонізує|охоплений агонією|в агонії|при смерті|напівживий
адаптуючий=що адаптує|адаптувальний|адаптаційний|пристосувальний
адресуючий=що адресує|адресувальний|адресант|відправник
адсорбуючий=що адсорбує|адсорбувальний|адсорбційний
аерофотозйомка=аерофотознімання|аерофотографування
азбостальний=азбосталевий
акаунт=обліковий запис|рахунок
акаючий=що акає|аакуватий
акліматизуючий=що акліматизує|акліматизувальний|для акліматизації|зайнятий акліматизацією|акліматизатор|акліматизаційний|акліматизаторний
акомпануючий=що акомпанує|пригравач|акомпаніатор|акомпанувальний|пригравацький
акредитуючий=що акредитує|акредитивний
активізуючий=що активує|активізувальний|активаційний|активатор
активнодіючий=активний
активуючий=що активує|активатор|активувальний|активаційний
акумулюючий=що акумулює|акумулювальний|призбирувач|акумулятор|акумуляційний
акцелератор=акселератор
алітуючий=алітувальний
альпага=альпака
альпаговий=альпаковий
амвросія=амброзія
аміаковий=амоніаковий
аналгезуючий=що знеболює|аналгетик|знеболювальний|анестетичний|аналгетичний
аналізуючий=що аналізує|здатний проаналізувати|зайнятий аналізом|аналітик|аналізатор|аналітичний
анестезуючий=що анестезує|анестезний|анестезійний|анестетичний|знеболювальний|знечулювальний
антикризисний=антикризовий
арочний=арковий|луковий
атакуючий=атакувальний|нападний
багатократний=багаторазовий
багатократно=багаторазово
багатонаправлений=багатонапрямний
багатообіцяючий=багатонадійний|багатообіцяльний
багаточисельний=численний|рясний
багаточисленний=численний
бажаючий=охочий|який бажає (хоче)
балда=блазень|ґолда|бельбас|бовдур|телепень|ступа
балда=ґуля|довбня|довбешка|молот
балочний=балковий|трямовий|сволоковий
баночний=банковий|слоїковий
банщик=лазник|лазнюк|мильник
банщиця=лазниця
баранка=бублик|обарінок
барелей=барелів
барочний=барковий|бароковий
бархатний=оскамитовий|бархатовий
бархатність=оксамитовість
бахромчастий=торочкуватий|бахрімчатий
бахромчатий=торочкуватий|бахрімчатий
башмак=черевик|шкарбан
башмачний=черевичний
башмачник=черевичник|швець
безалаберний=безладний|розкидкуватий|нерозсудливий
беззавітний=безоглядний|щиросердий
беззавітність=безоглядність|щиросердя
беззавітно=безоглядно|щиросердо
безоружний=беззбройний|неозброєний
безпересадочний=безпересадний
безпідкладочний=безпідкладковий
безпорядок=безлад|безладдя|безладнява|нелагода|нелад|розгардіяш|непорядок|безуряддя
безпосадочний=безперервний
безпричасний=непричетний
безсонниця=безсоння|нічниці|несплячки
безстержневий=безстрижневий
безстержневість=безстрижневість
безстержньовий=безстержневий
безчинство=бешкет
безчинствувати=бешкетувати|бешкети справляти|галабурдити|сваволити|скандалити
бережливий=ощадливий|ощадний|щадний|дбайливий
бережливіший=ощадливіший|ощадніший|щадніший|дбайливіший
бережливість=ощадливість|ощадність|дбайливість
бережливо=ощадливо|ощадно|дбайливо
бережливіше=ощадливіше|ощадніше|дбайливіше
беспредел=сваволя|безкрай|безгрань|безмір|безмеж
битком=напхом|набгом|натоптом|повно-повнісінько
біга=перегони|гони|біговисько|втіки|мандри
бігаючий=верткий|бігучий|обіжний
біги=перегони|гони|біговисько|втіки|мандри
біметалічний=біметалевий
благаючий=що благає|благущий|слізний
благовонний=запашний|запашистий|пахучий
благоговійно=побожно|святобожно
благоговіння=побожність|побожна покора|святобожність|святобливість
благоговіти=побожно схилятися|побожно (святобожно) шанувати|з побожною (святобожною) пошаною ставитися|побожно коритися
благоденствіє=щасливе життя|благоденство|гаразд
благозвучний=доброзвучний|легкозвучний|милозвучний|доброгласний
благополучний=щасливий|безнапасний
благополучніший=щасливіший
благополучність=добра доля|щастя|добробут|гаразд
благополуччя=добра доля|щастя|добробут|гаразд
благотворний=цілющий|добровпливовий|доброчинний|спасенний
благоустрій=доброустрій|порядок|добрий лад
благочиння=добродійство|добродіяння|благодійство|благодіяння|доброчинність|добродійництво
блимаючий=що мигтить|що мерехтить|миготливий|мерехтливий|мигкий
блідніючий=що блідне|напівзблідлий
блокуючий=що блокує|блокувальний
блочний=блоковий|блочоковий
блукаючий=блуденний|блудний|бродячий|мандрівний
болільник=вболівальник
бритвений=бритовний|голінний
брюзклий=брезклий|обрезклий|брезький
брюки=штани
брючний=штанний
бувший=колишній|булий|давніший
будоражити=баламутити|розбудоражувати|колошкати|ґвалтувати|розбуркувати|куйовдити
будоражитися=баламутитися|розбудоражуватися|колошкатися|ґвалтуватися|розбуркуватися|куйовдитися
будучи=бувши
будучність=майбутність|майбутнє|прийдешність|прийшлість|прийдість|будучина|будущина
будь-ласка=будь ласка
буйок=поплавище|кітва
булижник=буковий камінь|кругляк|бурківка
булькаючий=що булькотить|булькітливий|булькотючий
бунтуючий=що бунтує|бунтівний|бунтівник
бутильований=бутельований|пляшковий|в пляшках
ваблячий=звабливий|вабливий|вабний|звабний|принадний
ваграночний=вагранковий
вбиваючий=що вбиває|убивчий|душогубний|смертоносний|смертовбивчий|смертельний
вдостоєний=відзначений|ушанований|нагороджений
вдостоєність=відзначеність|вшанованість|нагородженість
вдостоїти=відзначити|вшанувати|нагородити
вдостоїтися=відзначитися|вшануватися|нагородитися
вдостоювання=відзначання|вшановування|нагороджування
вдостоювати=відзначати|вшановувати|нагороджати
вдостоюватися=відзначатися|вшановуватися|нагороджатися
вепр=вепер
вербовка=вербування|вербунок|набирання|затягання|затяг
верстка=верстання|заверстування
вертушка=вертулька|дівка-дзиґа
взаємодіючий=що взаємодіє|скоординований|співзалежний|взаємної дії
взаємообумовлений=взаємозалежний|взаємопов'язаний|зв'язаний|співзалежний
взаємообумовленість=взаємозалежність|взаємопов'язаність|зв'язаність|співзалежність
взаємопорозуміння=взаєморозуміння|обопільна злагода|згода
взамін=замість|на заміну
взаперті=в зачині|під замком|за руками
#взводний/V    #> зводовий|звідний|чотовий|чотар
вибілка=убілювання|убілування|вапнування|білування
вибілюючий=що вибілює|вибілювальний
виборщик=виборець
вибуваючий=що вибуває|вибутний
вибухаючий=що вибухає|вибухущий|вибуховий
вивірка=вивіряння|вивірення|перевір
вивозка=вивіз|вивозіння
вивчаючий=що вивчає|що студіює|що досліджує|допитливий|уважний|пильний|гострий
видворений=виселений|випертий|виставлений|депортований
видворення=випровадження|депортація|виселення
видворити=виселити|виперти|виставити|депортувати
видворяти=виселяти|випирати|виставляти|депортувати
видресируваний=видресуваний
видресируваність=видресуваність
видресирувати=видресувати
видресируватися=видресуватися
видужуючий=що видужує|підлікований|майже здоровий|відхворілий
вижати=витискати|вичавлювати|видушувати
вижатися=витискатися|вичавлюватися|видушуватися
вижга=оджога|пройдисвіт|проноза
виздоровлення=одужання
визивати=викликати
визиватися=викликатися
викидиш=викидень|викидок|викидча|недорід|виливок|вибрудок|уровище
викладка=викладання|виладовування|обкладання|обмурування|облямування|вираховування|вимірковування|розмірковування
виклейка=виклеювання|обклеювання|виклеїння|обклеїння
викликаючий=що викликає|визивний|зухвалий|задирливий|задерикуватий|зачіпний|зачіпливий
вимисел=вигадка|вигад|вигади|небилиця
виносливий=витривалий
випарка=випарювання|випарення
випереджаючий=що випереджає|випереджальний|випереджувальний|випередник|для випередження|з випередженням
випереджуючий=що випереджає|випереджальний|випереджувальний|випередник|для випередження|з випередженням
випихнутий=випханий|випхнутий|виштовханий|виштовхнутий|виштурханий|виштурхнутий
виплавлений=витоплений
випромінюючий=що випромінює|випромінний|випромінчий|емісійний|випромінювальний
випростовуючий=що випростує|випростувальний|випрямний
випускаючий=що випускає|випусковий|емісійний|випускний
вирівнюючий=що рівняє|вирівняльний|вирівнювальний|зрівняльний|зрівнювальний
виробляючий=що виробляє|виробний
виручений=вторгований
висидка=висідка|сидіння|висиджування
висихаючий=що сохне|схнучий
висловлюючий=що висловлює|що каже
висміюючий=що висміває|глузливий|гумористичний|сатиричний
виснажуючий=виснажливий|знесилювальний|зморювальний
високомарочний=високомарковий
високомірний=зарозумілий|бундючний|пихатий
високомірність=зарозумілість|бундючність|пихатість
високопарність=високомовність|пишномовність
високопревосходительство=ясновельможність
виставочний=виставковий
виступаючий=що виступає|виступач|промовець|доповідач|випнутий|випнений|висунутий|виткнутий|виступлений|витичний|виступний
витаращаний=вирячений|витріщений|вибалушений
витвережуючий=що тверезить|що витвережує|витверезний|тверезущий|витверезливий
витоки=джерела
витопка=опалення|огріття|вишкварювання
вихідець=виходець
виховуючий=що виховує|для виховання|виховальний|виховний
вичікуючий=що очікує|очікувальний|очікувач
вищестоячий=вищий|зверхній|надрядний
вищестоящий=вищий|зверхній|надрядний
виючий=що виє|скиглявий|ревучий
вібруючий=що вібрує|вібратор|вібраційний|вібрувальний
відбиваючий=що відбиває|відбивальний|відбивчий
відводка=відведення|відводження
віддрукований=видрукуваний
віддрукувати=видрукувати
віддрукуватися=видрукуватися
відеозйомка=відеознімання|фільмування
відживаючий=що відживає|відживаний|перестарілий|старомодний
відзив=відкликання|відклик|думка|відгук|відповідь|відпис|обзив
відізваний=відкликаний
від'їжджаючий=що від'їжджає|що вирушає|від'їжджий
відкаточний=відкотний|вивізний
відкачка=висмоковування|висмокування
відключання=відмикання|відімкнення|роз'єднання
відключати=відмикати|роз'єднувати
відключатися=відмикатися|роз'єднуватися
відключений=відімкнений|роз'єднаний
відключення=відмикання|відімкнення|роз'єднування|роз'єднання
відключити=відімкнути|роз'єднати
відключитися=відімкнутися|роз'єднатися
відкупорений=відіткнутий|відкоркований|розкоркований|відбитий|розпакований|розшити
відкупорка=відтикання|відкорковування|відбивання|розденання|розпаковування|розшивання
відлагоджений=налагоджений
відлагодження=налагодження|зневадження
відлагоджувальний=налагоджувальний|зневаджувальний
відлагоджувати=налагоджувати|зневаджуати
відлагоджуватися=налагоджуватися|зневаджуатися
відлагодити=налагодити|зневадити
відлагодитися=налагодитися|зневадитися
відлучка=відлучення|відлука|відгода
відмашка=відмахування|відмах
відмивка=відмивання|відпирання
відмочка=відмочування|розмочування|відмочення|розмочення
відновлюючий=відновчий|відновлювальний|що відновлює|відбудовчий|відбудовувальний|що відбудовує
відображати=показувати|зображати|відбивати
відображатися=показуватися|зображатися|відбиватися
відображаючий=що відображає|відбиває|відображальний|відбивальний
відображений=показаний|зображений|відбитий
відображуючий=що відображає|відбиває|відображальний|відбивальний
відобразити=показати|зобразити|відбити
відобразитися=показатися|зобразитися|відбитися
відокремлюючий=що відокрелює|відокремлювальний|сепарувальний
відпечатаний=відбитий|видрукований|надрукований
відпочиваючий=що відпочиває|відпочивальний|відпочивальник|відпочивник
відправка=виряджання|відряджання|виправляння|посилання|вирушення
відриваючий=що відриває|відривальний|розривальний
відрощений=вирощений|запущений
відсвіжуючий=що відсвіжує|відсвіжливий|відсвіжний|для відсвіження|відсвіжувач
відсидка=висидка
відсилка=відсилання|відіслання|посилання
відсікаючий=що відтинає|відтинач
відслідковування=слідкування|стеження|простежування
відслідкувати=прослідкувати|простежити
відсмоктуючий=що відсмоктує|смоктальний|відсмоктувальний|відсисний
відстаючий=що відстає|непромітний|неметкий|позадницький|відсталий|слабенький|що пасе задніх
відступаючий=що відступає|відступальний|відступний
відтворюючий=що відтворює|відтворювальний|репродукувальний
відтинаючий=що відтинає|відтинач
відтінюючий=що відтінює|підкреслювальний
відтіняючий=що відтінює|підкреслювальний
відхиляючий=що відхиляє|відхилювальний|відхильний
відчислення=відрахування
відчитатися=прозвітувати
відштовхуючий=що відштовхує|відштовхувальний|відбивальний|огидний|потворний
відщепенець=відступник|відступця|єретик|невірний
вірнопідданство=вірпопідданість
віруючий=що вірить|вірянин
вказуючий=що вказує|вказівний
власть=власть|влада|сила|право|воля|верх
вмикаючий=що вмикає|вмикальний|вмикач
вмираючий=що помирає|вмирає|конає|вмирущий|присмертний|смертельний
#вмішуватися/B    #> втручатися
вникання=вдавання|вглядання
вникати=вдаватися|вглядатися
вникнути=вдатися
внучатий=у других|троюрідний
водочерпалка=водочерпальниця|водочерпачка
войлок=повсть
волаючий=кричущий|що волає
волокита=тяганина
ворогуючий=що (який) ворогує|розсварений|розбратаний|ворожий|неприязний|супротивний|ворог
воронка=вікнина|лійка|лієчка|вирва|западина|улоговина|заглибина
восторжествувати=затриюмфувати|взяти гору|взяти верх
вотчина=батьківщина|дідивщина
воцерковлення=уводини|вивід|уцерковлення
воюючий=войовий|що воює|супротивний
впихнути=упхати|упхнути|запихати|запхати|запхнути|убгати
впихнутий=упхнутий|запихнутий
впихнутися=упхатися|упхнутися|запихатися|запхатися|запхнутися|убгатися
впливаючий=що впливає|дійовий
впроголодь=надголодь|обголодь
вражаючий=що вражає|разючий|дивовижний|винятковий
врізка=врізування|врізання
врозріз=всупереч
врозумляти=напоумляти|напучувати|на (добрий) розум наставляти|клепку вставляти
врукопашну=врукопаш
всезнаючий=усезнавець|всевідець|всевіда|всезнайко|знаюка
всеобіймаючий=всеосяжний|всеохопний|всебічний
всеохоплюючий=всеосяжний|всеохопний|всебічний|універсальний|поголовний|панорамний
всеперемагаючий=всепереможний|звитяжний|здатний здолати все
всепоглинаючий=всепоглинальний|всепоглинущий
всерйоз=серйозно|навсправжки
всеціло=цілком|цілковито|зовсім|до краю
всліпу=наосліп|осліп|на темні очі
всмоктуючий=що всмоктує|всмоктальний|вбирущий|смоктущий|засмоктущий
втемну=навмання|наосліп|осліп|на темні очі
втопаючий=що потопає|потопельник
вторгатися=вдиратися|впиратися
вторгнення=впад|наїзд|забіг|втручання|вдирання|залізання
вторгнутися=вдертися|впертися
вуалюючий=що вуалює|вуалювальний|що личкує
вугол=кут|ріг|куток|закуток
вуз=виш|ВНЗ
вузьконаправлений=вузькоспрямований|сфокусований
вулканізуючий=що вулканізує|вулканізаторний|вулканізаційний|вулканізатор
вхолосту=нечинно|марно|даремно
вчителевий=вчителів|вчительський|учительський
в'янучий=що в'яне|майже зів'ялий
гавкаючий=що гавкає|брехучий|гавкучий|гавкітливий
газопоставка=газопостачання
газоутворюючий=газоутворювальний|газогенераторний
галопуючий=що галопує|скачущий|нестримний|невпинний|обвальний
галстук=краватка
галтель=жолобник|круглий гебель
гальмуючий=гальмівний|гальмувальний|сповільнювальний
гарцюючий=що гарцює|баский
гаснучий=який гасне (згасає, погасає, тухне, потухає, чахне)|згасний|згасальний|погасальний
генералізуючий=узагальнювальний
генеровуваний=генерований
генеруючий=утворювальний|творильний|породжувальний|генерувальний|генерівний
герметизуючий=ще герметує|герметувальний
гинучий=що гине|пропащий|зникомий|умирущий|мрущий
гідроочистка=гідрочищення
гідротермообробка=гідротермооброблювання|гідротермооброблення
гімнастьорка=гімнастівка
гірорульовий=гіростерничий|гірокермовий|гіростерновий
гірчинка=гіркуватість
глиба=брила|груда|грудомаха
глобалізовуваний=глобалізований
#глупіший/VY    #> дурніший|безголовіший|дурноверхіший
#глупство /n2n.p1    #> нерозум|дурний розум|недоумство|дур|дурість|дурощі|дурування
гниючий=що гниє|загниваний|напівзогнилий|пойнятий гниттям|майже зогнилий|гнилявий|гнилущий
гоголевий=Гоголів
головизна=риб'яча голова
головнокомандуючий=головнокомандувач|головний командир
головокружіння=головокруття|запаморока
головуючий=що головує|голова
голодовка=голодування
голодуючий=що голодує|голодняк|голодник|голодюк
голосуючий=що голосує|учасник голосування|голосувальник|виборець
голублячий=приголубливий
голуб'ятня=голубник|голубничок
гонка=перегони|гонитва|гоніння
гоночний=перегоновий
горбушка=окраєць|цілушка
горець=верховинець|гірняк|горянин
горілочний=горілчаний
горнична=покоївка
гострослів=гострослов
гофмановий=Гофманів
гравіровка=ритування|гравірування|ритовництво|гравірувальне майстерство
гражданка=цивілка
грампластинка=грамплатівка
гранулюючий=що гранулює|гранулювальний
грасирувати=гаркавити
граючий=що грає|зайнятий грою|звиклий грати|гравець|гравчиня|грайливий
грохочення=гуркотання|туркотання|бухання
грядущий=що йде|прийдешній|майбутній|наступний
грязнуля=задрипа|затьопа|замурзанка|замазура|нетіпаха|захвойданка|нечупара
грясти=іти|наставати|наближатися
гусеничний=плазуновий
давка=тиск|стиск|тискнява|тиснява
даїшник=даївець
даламберовий=Даламберів
далекойдучий=далекосяжний|глибокий
дафнієвий=Дафніїв
дача=давання|подача
даючий=що дає|давач
двигтячий=двигтючий
двірцевий=палацовий
двонаправлений=двонапрямний
#двоствольний/V    #> двохцівковий|двохрульний
дебош=бешкет|галабурда|дешпет|буча|гармидерування
девелопер=розробник
девелоперський=розробницький
девелопмент=розвиток|розвій|перебіг|розробляння|розроблення|розгортання
деградуючий=що деградує|зворотний|регресивний|ретроградний|у стані занепаду
дедлайн=граничний термін (реченець)|кінцева дата
дед-лайн=граничний термін (реченець)|кінцева дата
дежа-вю=дежавю|дежав'ю
дезертирувати=дезертувати|тікати
дезінфікуючий=що дезинфікує|дезинфекційний|для дезинфекції|дезинфектор|дезинфектант
дезінформуючий=що дезинформує|дезинформаційний|окозамилювальний|дезинформатор|окозамилювач
дезодоруючий=що дезодорує|дезодораційний|знепахний|для дезодорації|дезодоратор|дезодорант
дезорієнтуючий=що дезорієнтує|дезорієнтаційний|оманливий|оманний
декодуючий=що декодує|декодовувальний|дешифровувальний
денатуруючий=що денатурує|денатураторний|денатураційний|денатуратор|для денатурації
держчиновник=держслужбовець|урядовець
дерзати=важитися|наважитися|поважитися|завзятися|насмілюватися|насмілитися|(з)осмілитися
десенсибілізуючий=що десенсибілізує|десенсибілізаційний|десенсибілізаторний
дестабілізуючий=що дестабілізує|дестабілізаційний|дестабілізатор
детектуючий=що детектрує|детектувальний
детонуючий=що детонує|детонаційний|вибуховий
деформуючий=що деформує|що спотворює|що перекручує|деформувальний|спотворювальний|перекручувальний
диковинка=дивинка|дивничка
диктовка=диктування|диктант
димоутворюючий=що утворює дим|димоутворювальний
дисгармонуючий=дисгармонічний|негармонічний|дисгармонійний|негармонійний|неузгіднений|неоднострійний
дисонуючий=дисгармонійний|неспівзвучний|дисонівний
диспергуючий=що диспергує|диспергувальний
диференціюючий=що диференціює|диференціювальний|відрізняльний
дишло=дишель|війя
діагоналізуючий=що діагоналізує|діагоналізаційний
дійствительно=дійсно|насправді
діючий=що діє|чинний|діяльний|дієвий|дійовий|активний
довгограючий=що довго грає|довгогральний|довгограйний|довгограй|тривалий|затяжний|довгочасний|протяжний|тривкий
довгодіючий=довготривалий|тривалий
довгодозріваючий=довгозрілий
доводка=доводіння|викінчування|доведення|викінчення|доведеність|викінченість
довузівський=довишівський
дожарений=досмажений|усмажений|допряжений|допечений
дозуючий=що дозує|дозувальний|розподільчий|дозатор
#доказати/AW :perf    #> довести
#доказувати/AGO :imperf    #> доводити
докрашений=дофарбований
долька=частка
домінуючий=панівний|домінантний|переважний|головний|основний|найпоширеніший
домосідство=домування|домонтарювання|домонтарство|домарство|сидіння вдома to twisters.lst
домочадець=сім'янин|домівник
доповнюючий=що доповнює|доповняльний|доповнювальний|додатковий|доповнювач
доречі=до речі
дороговартісний=коштовний|який дорого коштує|дорогий
досліджуючий=що досліджує|дослідний|дослідницький|розвідувальний|дослідник|експериментатор|розвідник
доставлюваний=достачуваний
достовірний=вірогідний|певний|правдивий|достометний|перевірений
достовірніший=вірогідніший|певніший|правдивіший
достовірність=вірогідність|певність|правдивість
достоїнство=гідність|достойність
дошлий=достиглий|дорослий|бувалий
драглевидний=драглеподібний
дратуючий=який дратує|дратівний|дратівливий|дражливий|подразливий|подразний
древньоєврейський=давньоєврейський|староєврейський
древньоіндійський=давньоіндійський|староіндійський
древньокам'яний=давньокам'яний|старокам'яний
древньоримський=давньоримський|староримський
древньослов'янський=давньослов'янський|старослов'янський
дрейфуючий=що дрейфує|самопливний|пливний|дрейфівний|дрейфувальний
дренуючий=що дренує|дренувальний
дресирований=дресований
дресирувальний=дресувальний
дресирувальник=дресувальник
дресирувальниця=дресувальниця
дресирування=дресування|муштрування|муштра
дресирувати=дресувати
дресируватися=дресуватися
дрімаючий=дрімотний|дрімучий
дружелюбний=приязний|дружелюбивий|дружній|прихильний|ласкавий
дружелюбніший=приязніший|дружніший|дружелюбивіший
дружелюбність=приязність|дружелюбивість|дружність|прихильність|ласкавість
друкуючий=що друкує|друкарський|друкувальний
дряхлий=спорохнілий|дряглий|старезний
дублюючий=що дублює|дублювальний
думаючий=що думає|думний|вдумливий
еволюціонуючий=що еволюціонує|еволюційний
ежектуючий=що викидає|викидальний|виштовхувальний|ежектувальний
економічніший=економніший
екрануючий=що екранує|екранний|екранувальний|щитовий
експлуатуючий=що екслуатує|експлуатаційний
екстрагуючий=екстрагувальний|екстрактивний
екстраполюючий=що екстраполює|екстраполяторний|екстраполятор
електризуючий=що електризує|електризаторний|електризатор|запалющий|запальний
електроізолюючий=електроізоляційний|електроізолювальний
елімінуючий=що елімінує|елімінаційний
еліпсовидний=еліпсоподібний
емітуючий=що емітує|емісійний|емітівний|випромінний|емітент
енергозбереження=енергоощадження
енергозберігання=енергоощадження
енергозберігаючий=енергоощадний
енергопоставка=енергопостачання
еталонуючий=що еталонує|еталонувальний|градуювальний|калібрувальний
єдинодушний=однодушний|одностаний|односердний|односердий
єдинодушність=однодушність|одностайність|односердність
єдинодушно=однодушно|в одну душу|одностайно|односердно|односердо|як одно серце
єсть=так
жадаючий=жадний|спраглий|жадібний|жажденний|прагнучий|жагучий|жадак
жалячий=жалкий|жалливий|жижкий|жаркий|кусливий|їдкий
жарознижуючий=жарознижувальний
жвачка=жуйка
жевріючий=що жевріє|охоплений жевривом (червінню)|палахкотливий|розчервонілий|розжеврілий|розжеврений
желатинізуючий=що желатинізує|що желатинує|желатинізувальний|желатинізаційний
живописний=мальовничий|мальований|малюнковий|малярський
жилплоща=житлоплоща
життєстверджуючий=життєствердний|оптимістичний|сповнений життя
жовтіючий=що жовтіє|чимраз жовтіший
жовторотик=жовтодзьоб|жовтодзьобик|жовтодзюб|пуцьверінок|голопуцьок
жолобовидний=жолобоподібний
журналізм=журналістика
жуючий=що жує
забавненький=кумедненький|веселенький
забастовка=страйк|страйкування
забастувати=страйкувати|бастувати|застрайкувати|забастувати
забракнуло=забракло
забруднюючий=що забруднює (бруднить, занечищує, каляє, закалює, загиджує)|забруднювальний|занечищувальний|закалювальний|загиджувальний|забруднювач|закалювач|занечищувач|загиджувач|забрудник
забугорний=закордонний
завалочний=завалювальний
завбазою=завбази
заввідділенням=заввідділу|заввідділення
заввідділом=заввідділу
завершуючий=який завершує (вивершує, довершує)|завершальний|прикінцевий|кінцевий|остаточний|останній|яким закінчується|завершувач
завихрений=завихорений
завідомо=свідомо|звідома|знаючи наперед
завідуючий=завідувач
завітний=заповітний|щиросердий|таємний|святотаємний
завкадрами=завкадрів
завкафедрою=завкафеди
завклубом=завклубу
завлабораторією=завлабораторії
завозня=пором|дуб
заворожуюче=заворожливо|чарівливо
завсектором=завсектора
завскладом=завскладу
завфермою=завферми
завшколою=завшколи
зав'южений=занесений (заметений, завіяний) снігом
завюрвідділом=завюрвідділу
загальнозначимий=загальнозначущий
загальнозначимість=загальнозначущість
загасаючий=що гасне|згасає|загасає|погасає|згасальний|погасальний
заглавний=титульний|заголовний
загородний=заміський
заготівка=заготівля|заготовляння|заготовлення|заготовина|готовик|заготовлене
заготовка=заготівля|заготовляння|заготовлення|заготовина|готовик|заготовлене
заготовочний=заготовчий|заготівний
заготовщик=заготівник|готувальник
заготовщиця=заготівниця|готувальниця
загрузка=завантажування|завантаження|вкладання
задаючий=що задає|що керує|що запускає|керівний|рушійний|задіювальний|задавальний
задержка=задержання|затримання|загаяння|загайка|загай|угайка|угайство|загальмування|перебивка
задержуючий=що затримує|затримний|затримувальний|тамувальний|загатистий
задіювати=залучати|пускати в дію|уводити в експлуатацію
задіяний=залучений|пущений в дію|уведений в експлуатацію
задіяння=залучення|пускання в дію|уведення в експлуатацію
задіяти=залучити|пустити в дію|увести в експлуатацію
задрапірувати=задраповувати|задрапувати|запинати|запнути|зап'ясти
задрапіруватися=задраповуватися|задрапуватися|запинатися|запнутися|зап'ястися
задувка=задування|задуття|роздмухування|роздмухання
заздравний=заздоровний
заземлюючий=що уземлює|що заземлює|уземлювальний|заземлювальний
зазнайка=задавака|чванько|хвалько
заказний=замовний|замовлений|на замовлення зроблений|рекомендований (лист)
закидка=закидання|закидання
закипаючий=що закипає|кип'ячий
закладочний=закладинний
заклепочний=заклепний|нютувальний|нютовий
закликаючий=що закликає|закликач|закличний|зазивний
заключати=ув'язнювати|зачиняти|замикати|закидати|засаджувати|містити|вміщати|мати в собі|виводити|робити висновок|висновувати|кінчати|закінчати|складати|укладати|підписувати
заключити=ув'язнити|зачинити|замкнути|закинути|засадити|вмістити|вивести|зробити висновок|виснувати|скінчити|закінчити|скласти|укласти|підписати
заключний=прикінцевий|кінцевий|остаточний
заколисуючий=що заколисує|заколисливий|присипний|снотворний|снодійний|колисковий
закононароджений=законний|законнороджений|шлюбний
законопослушний=законослухняний|законопокірний|законопокірливий
законопослушність=законослухняність|законопокірність|законопокірливість
закорочуючий=що закорочує|закорочувальний|закоротний
закріплюючий=що закріплює|закріпний|прикріпний|скріпний|злучний
закріпляючий=що закріплює|закріпний|прикріпний|скріпний|злучний
закупорений=заткнутий|заткнений|затканий|закоркований|зачопований|затушкований|запакований
закупорений=заткнутий|заткнений|затканий|закоркований|зачопований|затушкований|запакований
закупорити=затикати|заткнути|закорковувати|зачоповувати|чопувати
закупоритися=затикатися|заткнутися|закорковуватися|зачоповуватися|чопуватися
закупорювання=затикання|закорковування|зачоповування|затушковування|запаковування
закупочний=закупний
закусочний=закусковий
заломлюючий=заломлювальний|рефрактивний
замазочний=замазувальний
замараний=замазаний|замащений|забруднений|забруджений|закаляний|покаляний|умазаний|умащений|упаскуджений|закаканий|уроблений|забагнений|заваляний чим|поваляний|виваляний|зашурований|задрипаний|забрьоханий|закреслений|замазаний|вимазаний|закаляний|скаляний|заплямований
замашистий=замашний|розмашний
замітний=помітний|примітний|прикметний|знатний|знатий|значний
заморожуючий=що заморожує|морозильний|заморожувальний
занавіска=завіска|завісочка|фіранок|фіранка
занавісковий=завісковий|заслонний|фіранковий
запалюючий=що запалює|запалювальний|запальний
запам'ятовуючий=запам'ятовувальний
запевняючий=що запевнює|запевнювальний|переконливий
заперечуючий=що заперечує|заперечник|заперечувач|заперечливий|заперечний
запилка=запилювання|надпилювання
записуючий=що записує|записувальний|записний|самописний|записувач
запитаність=потрібність (чогось)|потреба (в чомусь)|попит
заплатка=латка|лата|залата|лат|лаття
запліднюючий=що запліднює|запліднювальний|заплідний
заповнюючий=що заповнює|заповнювальний|наповнювальний
зарубіжжя=закордон|закордоння
зарубіжка=закордон|закордоння
зарубіжний=закордонний
заряджаючий=який ладує (наладовує, заправляє, набиває, заряджає)|заряджальний|зарядовий|ладувальний|ладівний|набивальний|набивний|заряджальник|зарядник|заправник|набивач|набивальник|ладівник|ладувальник
засадка=засаджування|засадження|засадіння|засад
засахарений=зацукрований|зцукруватілий
засилка=засилання|заслання
засинаючий=що засинає|засипущий|сонний
заскорузлий=зашкарублий|закоржавілий
заскорузлість=зашкарублість|зкоржавілість
засліплюючий=що сліпить|сліпучий|осліпливий|засліпливий|яскравий
засолка=засолювання|соління|засолення|засіл
заспокоюючий=що заспокоює|заспокійливий|гамівний|гамувальний|миротворчий|заспокоювач
заставочний=заставний
застінок=катівня
застрашуючий=що страхає|застрашливий|острашливий|жахливий|страхітливий|страшкий
засуджуючий=що засуджує|що осуджує|осудливий|огудливий|пересудливий|осудник|огудник
засушка=засушування|засушення|засушок
затемнюючий=що затемнює|затемнювальний
затихаючий=що затихає|послаблий
затійний=химерний|хитрий|мудрий
затічний=запливний
затія=вигадка|витівка|замір
затребуваний=потрібний|популярний|зажаданий|запрошений|викликаний
затребуваність=потрібність|потреба|попит|жаданість
затребування=зажадання|вимога
затребувати=зажадати|запросити|викликати
затримуючий=що затримує|затримний|гальмівний|тамувальний
затухаючий=що згасає|загасний|згасний
затягуючий=що затягує|затяжний
заушний=позавушний
захвальоний=захвалений|перехвалений
захватка=зачіпка
захватність=замашність|заборчість|самобраність|загарбність
захникати=заскімлити|зарюмсати|запхикати
заходячий=що заходить|західній|призахідній
захоплюючий=що захоплює|забирає|захватний|забирущий|захопливий
захоронений=похований|похоронений
захоронювати=ховати|хоронити
захоронюватися=ховатися|хоронитися
зашифровка=зашифровування
заявочний=заявковий|заявний
заядлий=запеклий|заїлий|завзятий|завзятущий|запінений|забісований
збаламучуючий=що баламутить|баламутливий|бунтівливий|баламут
збалуваний=розпещений|розпущений|розпонаджений|мазаний|пещений|розпусний|запаньканий|заласканий|жирований
збезводнюючий=що зневоднює|зневоднювальний
збезсилілий=знесилений|збезсилений|виснажений
збираючий=що збирає|збиральний|комплектувальний
збільшуючий=що збільшує|збільшувальний|збільшувач
зборка=збирання|складання|монтаж|брижа|збірка|зборини|зморшки|збори|рями|пухлики
збуджуючий=що збуджує|збудний|збудливий|збуджувальний|збурювальний
збурюючий=що збурює|збурний|збурювальний
зварганити=скапарити|спартолити|зляпати|склепати|спартачити|стулити|стелепати
звершитися=ставатися|статися
звеселяючий=що веселить|розвесельний|веселющий
звисаючий=що звисає|обвислий|навислий|завислий
звільняючий=що звільнює (звільняє, визволяє)|звільнювальний|визвольний
звогчений=відволожений|приволожений
зволожуючий=що зволожує|зволожувальний|відволожувальний
звужуючий=що звужує|звужувальний
звуковідтворюючий=звуковідтворювальний
звуковловлюючий=звуковловлювальний
звукозаписуючий=звукозаписувальний
звукоізолюючий=звукоізоляційний
звукопідсилюючий=звукопідсилювальний
звукопоглинаючий=звукоізоляційний|звукопоглинальний
звукоуловлюючий=звуковловлювальний
зв'язуючий=що зв'язує|що сполучає|що поєднує|зв'язкий|зв'язувальний|в'язальний|сполучний|єднальний|поєднавчий|поєднальний|розігрувач
згасаючий=що гасне|згасний|згасальний|згасавий|погасальний
згинаючий=що згинає|згинальний|згинний
згладжуючий=що згладжує|згладжувальний
зговірливий=згідливий|згодливий|лагодливий|схильчивий|умовний
згущонка=згущене молоко|згущівка|згущик
здвигнений=зсунутий
здержаний=стриманий
здіяний=вчинений|скоєний|сподіяний
здравомислячий=розсудливий|розважливий|розважний
зебувидний=зебуподібний
#землеробство/i    #> хліборобство|рільництво|ратайство
землесосний=землесмоковий
землеудобрювальний=угнійливий|підгнійний
землянистий=землястий|землистий
зерноїдовий=зерноїдний
зернопоставка=зернопостачання
з'єднуючий=що об'єднує (єднає)|об'єднавчий|єднальний|об'єднувач
зжмаканий=зіжмаканий|пожмаканий|зібганий|зжужмлений|зім'ятий|перем'ятий|змервлений
зжмакати=зіжмакати|зібгати|зім'яти
зимуючий=що зимує|зимівник|зимовик|зимушній|зимувальний
зісковзнути=ізслизнути|зринути|спорснути
зіяючий=що зяє|що зіхає|що зіває|зяючий|зівущий|зівучий
зйомка=знімання|фільмування
зйомочний=знімальний
злачний=зелений затишок|вертеп|кубло|травнистий|порослий
злітно-посадочний=злітно-посадковий
зловіщий=лиховісний|зловісний|зловорожий|зловіщий|зловіщуватий
зловонний=смердючий|смердячий
зловредний=шкідливий
зловредніший=шкідливіший
злонавмисний=зломисний|зловмисний|зловільний
злонравний=злосливий
злонравність=злосливість
злотворний=лиходійний|злочинний|шкідливий
злучка=парування|припуск|спуск
змичка=з'єднування|з'єднання|стик|звязок|єднання
зм'якшуючий=що пом'якшує|пом'якшувальний|зм'якшувальний|м'якшильний|пом'якшувач
значимий=значущий|важливий|вагомий|ваговитий|змістовний|промовистий
значиміший=важливіший|вагоміший|ваговитіший|змістовніший|промовистіший
значимість=значущість|важливість|вагомість|ваговитість|змістовність
знаючий=що знає|тямучий|тямущий|досвідчений|обізнаний|компетентний|знавець|знайко
знебарвлюючий=що знебарвлює|знебарвлювальний|знебарвний|знебарвлювач
знеболюючий=що знеболює|знеболювальний|протибольовий|анестетичний|анальгетичний
зневоднюючий=що зневоднює|зневоднювальний
знежирюючий=що знежирює|знемаснювальний|знежирювальний|випощувальний
знезаражуючий=що знезаражує|що дезинфікує|знезаражувальний|дезінфекційний|знезаражувач|дезінфектор
знепилюючий=що знепилює|знепилювальний
знешкоджуючий=що знешкоджує|знешкоджувальний|знешкодний|для знешкодження
зникаючий=що зникає|зникомий|вимирущий|загрожений|приречений|на межі зникнення|майже зниклий
знищуючий=що нищить|винищувач|нищитель|викорінювач|губитель|вигубник|нищівний|знищувальний|вигубчий|вибавчий|вигубливий
зноска=виноска|посилання|покликання
зобастий=воластий|ґушуватий
зобиджений=ображений|скривджений|покривджений|уражений
зобижений=ображений|скривджений|покривджений|уражений
зобов'язуючий=що зобов'язує|зобов'язувач|зобов'язчий|зобов'язальний
зогнутий=зігнений
зогрітий=зігрітий
зондуючий=що зондує|зондувальний
зонтиковидний=зонтоподібний
зорний=зоровий|зорній|любистковий
зрівноважуючий=що зрівноважує|зрівноважувальний
зрівнюючий=що рівняє|зрівняльний|зрівнювальний|зрівнювач|зрівняльник
зрізуючий=що зрізає (стинає)|зрізувальний|зрізувач
зростаючий=що росте (зростає)|наростальний|зростальний|чимраз (все, дедалі) більший (вищий тощо)|ростучий
зсуваючий=що зсває|що зрушує|зсувальний
зупиночний=зупинний|припинний|перебивний
зустрічаючий=що зустрічає|зустрічальник|зустрічний
зчитуючий=що зчитує|зчитувальний|читальний
зяючий=що зяє|що зіхає|що зіває|зяючий|зівущий|зівучий
іго=ярмо
ігрища=грища
ідеалізуючий=що ідеалізує|ідеалізаційний|ідеаліст
ідентифікуючий=що ідентифікує|ідентифікаційний
ізолюючий=що ізолює|ізоляційний|ізолятивний|ізолянтний
ізсушений=висушений|зсушений|спраглий
ізюмина=родзинка
імпонуючий=що імпонує|уподобаний|до вподоби
імуномодулюючий=імуномодулювальний
інгібуючий=інгібувальний|інгібіторний|затримувальний|сповільнювальний|гальмувальний|гальмівний
індексуючий=що індексує|індексувальний|індексаційний
інжектуючий=що інжектує|інжекторний|інжекційний|впорскувальний|інжектор
ініціюючий=що ініціює|ініціювальний|початковий|спричиняльний
інструментовка=інструментування
інтегруючий=що інтегрує|що об'єднує|інтегрувальний|об'єднавчий
інтерполюючий=що інтерполює|інтерполювальний|інтерполяційний
інтерпретуючий=що інтепретує|тлумачний|інтепретувальний|інтерпретаторський
інтерферуючий=що інтерферує|інтерференційний|інтерферівний
інтригуючий=що інтригує|цікавий|гостроцікавий|загадковий|таємничий
інфільтруючий=що інфільтрує|інфільтративний|інфільтраційний
інформуючий=інформувальний|інформаційний|повідомчий
іонізуючий=іонізувальний|іонізівний|іонізаційний
існуючий=що існує|чинний|теперішній|наявний|присутній|реальний|заведений
йодуючий=що йодує|йодувальний
йонізуючий=що йонізує|йонізувальний|йонізаційний
кабацький=шинковий|шиноцький|шинкарський|корчемний
каблучний=підборовий|обцасовий|каблуковий
кагебіст=кадебіст
казенник=магазин|задок
каптьорка=каптерка
караючий=що карає|каратель|карник|каральний
качка=гойдання|колихання|коливання|хитання|гойданина|хитанина на морі|хитавиця|гойдавиця (морська)
керосинка=гасівка|гасниця|гасничка|балцанка
керсправами=керівник справ
керуючий=що керує|керівник|управитель|адміністратор|провідник|лідер|керманич|стерновий|керівний|провідний|адміністративний|кермовий
кишечник=кишківник
кінозйомка=кінознімання|фільмування
класифікуючий=що класифікує|класифікаційний|класифікатор
кліпаючий=що моргає|розморганий|моргун|кліпко|моргучий|миготливий|мерехтливий|блимкий
клянчити=канючити|циганити|лабзюкати|лабзюкувати|жебрати|миркати
ковзаючий=що ковзає|ковзний|рухомий
кодифікуючий=що кодифікує|кодифікаційний|кодифікатор
кодуючий=що кодує|кодувальний
кожанка=шкуратянка|шкірянка
командировка=відрядження
командуючий=що командує|командний|командувач
компенсуючий=що компенсує|компенсувальний|компенсаційний|компенсаторний
компілюючий=що компілює|компіляційний|компілятивний|компілятор
комплектуючий=що комплектує|комплектувальний|комплектувальник|компонент|складник
компонуючий=що компонує|компонувальний|складальний
компрометуючий=що компрометує|що вводить у славу, неславу|компромітаційний|очорнювальний
компромітуючий=що компрометує|що вводить у славу, неславу|компромітаційний|очорнювальний
комунікабельний=товариський|привітний
комунікабельність=товариськість|привітність
комутуючий=що комутує|комутаційний|комутаторний|комутатор
конаючий=що конає|що помирає|що вмирає|вмирущий|мирущий|мрущий|присмертний|смертельний
конкуруючий=що конкурує|конкурентний|суперницький|конкурент
консервуючий=що консервує|консервувальний|консерваційний
консолідуючий=що консолідує|консолідаційний|гуртувальний|об'єднавчий|консолідатор|об'єднувач
контрамарочний=контрамарковий
контрастуючий=що контрастує
контролюючий=що контролює|контрольний|перевірчий
конфліктуючий=що конфліктує|конфліктний|суперечливий
концертуючий=що концертує|концертант|гастролер
координуючий=що координує|координатор|координаційний|узгоджувальний
корегуючий=що коректує, коригує, корегує|що виправляє (поправляє)|коригувальний (корегувальний)|коректувальний|для корекції
коректуючий=що коректує, коригує, корегує|що виправляє (поправляє)|коригувальний (корегувальний)|коректувальний|для корекції
кореспондуючий=що кореспондує|що листується|переказний
корзина=кошик|кіш|кошіль|кошелина|кошар|кошівка|козуб|сапет|солом'яник|стуга
корзинка=кошичок|кіш|кошіль|кошелина|кошар|кошівка|козуб|сапет|солом'яник|стуга
корзиновий=кошиковий
коригуючий=що коректує, коригує, корегує|що виправляє (поправляє)|коригувальний (корегувальний)|коректувальний|для корекції
кормоприготувальний=кормоготувальний
кородуючий=що кородує|корозійний
короткодіючий=короткотривалий
короткоживучий=нетривалий|недовготривалий|недовгочасний
короткоіснуючий=недовгочасний|недовготривалий|короткочасний|недовговічний|скороминущий|нетривалий
косичка=кіска|косиця
кофейниця=кавничка|кавниця|каволюбка
кофейня=каварня|кав'ярня
кража=крадіж|крадіж|крадіжка|крадіння
краснобай=(добрий) балакун|(порожній) красномовець|балаклій
кривдячий=що кривдить|кривдник|образливий|прикрий|дошкульний
кризисний=кризовий
крокуючий=що крокує|крокувальний|кроківний
кромка=крайка|окрайка|окравка|ребро|пруг|пружок
крон-принц=кронпринц
крон-принцеса=кронпринцеса
крупний=великий|немалий|чималий|грубий|буйний|дорідний|дорідливий|буйний|краплистий|краплястий|крапчастий|ядерний|значний|важливий|видатний|визначний|славний|славетний|знаний
крупніший=більший|грубший|буйніший|значніший|важливіший|видатніший
крупно=значно|добряче|чимало|буйно
крупніше=значніше|буйніше
крупнозернистий=крупнистий|крупкий|(про сіль) дрібкова, дрібковата, дрібчаста, цупка|(про пісок) шорсткий|жорсткий|(про злаки) ядренистий, ядерний, ядрений|(про камні) грубозернястий, крупкий
крутизна=крутість|круча
кульмінуючий=кульмінаційний
курирувати=опікати|опікувати|опікуватися|наглядати|курувати
курируватися=опікатися|опікуватися|куруватися
кучкуватися=купчитися|скупчуватися|кублитися|гуртуватися
кушетка=канапка|канапа
лазутчик=вивідувач|вивідач|шпиг|шпигун|пластун
лактуючий=лактаційний
лапша=локшина
лаючий=що гавкає|гавкучий|брехливий
легуючий=легувальний
линька=линяння|блякнення|половіння|линьба|линовище|линовисько
лихорадка=пропасниця|лихоманка|гарячка|трясця|трясовиця|трясучка|веснуха
лідируючий=що лідерує|лідер|передовий|провідний|головний|авангардний|перший
лікуючий=що лікує|лікувальний
лімітуючий=що лімітує|лімітний|лімітаційний
лінеаризуючий=що ліанеризує|лінеаризувальний|лінеаризаційний
літаючий=летючий|льотовий|літний
локалізуючий=що локалізує|локалізувальний
лубочний=лубовий|лубковий|луб'яний
луночка=дучечка|ямочка|кубашок|ковбашок|мисочка|серпок
ляльковод=ляльковик
максимізуючий=що максимізує|максимізувальний|максимувальний
малочисельний=нечисленний
малюючий=що малює|малювальний|маляр|малювальник
маневреність=маневровість
маркірований=маркований|значений|замаркований|помаркований|позначений|пописаний
маркірувальний=маркувальний
маркірування=маркування|відзначання|писання|карбування
маркірувати=маркувати|значити|відзначати|карбувати
маркіруватися=маркуватися|значитися|відзначатися|карбуватися
маркуючий=що маркує|що відзначає|маркувальний
марочний=марковий
маршуючий=що маршує|маршовик|маршувальник|маршувальний|на марші
маслина=оливка
маслинка=оливка
маслинковий=оливковий
маслиновий=оливковий
мати-одиночка=мати-одиначка
маючий=що має
медвежий=ведмедячий|ведмежий
металобрухт=брухт|металолом
метастазуючий=що метастазує|метастазотворчий
мешкаючий=що проживає|жилець|житець|мешканець
мигаючий=що кліпає|що мигтить|що миготить|що блимає|миготливий|мигкий|блимкий|мигтючий|мигкотючий|мерехтливий
минаючий=що минає (проходить, проминає, спливає, збігає)|минущий|проминущий|проминальний|зникомий|прохідний|перехідний|перехожий|прохідний
минулорічний=торішній|тогорічний
мислячий=мислездатний|мисленний|миследумний|розумний|вдумливий
миючий=що миє|мийний|мийчий
мігруючий=що мігрує|міграційний|мігрувальний|непосидющий|мігрант
міжвузівський=міжвишівський
міліцейський=міліціонер|міліційний
міліючий=що міліє|щораз плиткіший|майже обмілілий|напівзмілілий
мільйонщик=мільйонник
мільйонщиця=мільйонниця
мінімалізація=мінімізація
мінімізуючий=що мінімізує|мінімізувальний|мінімувальний
міроприємство=захід
містоутворюючий=містотвірний|містотворчий|містоформувальний
місцеблюститель=намісник|заступник|екзарх|вікарій
місцезнаходження=місце|місцеперебування|становище|географічне місце|географічне становище|позиція|ситуація|розташування
мітингуючий=що мітингує|мітингувальник|мітингар
міцніючий=що міцніє|щораз міцніший
мобілізуючий=що мобілізує|мобілізувальний|мобілізаційний|урухомлювальний
моделюючий=що моделює|моделювальний|моделіст|модельєр|модельник
модулюючий=що модулює|модулювальний|модуляційний|модулятор
моніторити=контролювати|спостерігати|стежити|провадити (поточний) контроль
монометалічний=монометалевий
монтировка=монтування|змонтування|монтажка|монтувалка
моргаючий=що моргає|моргун|кліпко|моргучий|миготливий|мерехтливий|блимкий
морковний=мокрв'яний
мужчина=чоловік
мусолити=ялозити|мастити|мурзати|замурзувати|слинити|заслинювати|масльонити|рюмсати|жвакати
мусолитися=ялозитися|маститися|мурзатися|замурзуватися|слинитися|заслинюватися|масльонитися|рюмсатися|жвакатися
м'якоть=м'якуш|м'якота|мизка|молот|гамуз
набавочний=наддатковий|набавний|накидний|надданий
наверстати=надолужити|навернути|нагнати|натягти
навик=вправність|уміння|звичка|навичка
нависаючий=що нависає|навислий|звислий|завислий
наводка=наводження|наводіння|напроваджування|наведення|напровадження|направляння|справляння|скеровування|націлювання
навчаючий=що навчає|навчальний|вишкільний
нагнітаючий=що нагнітає|нагнітальний|нагнітний
награвірований=награвірований|наритований|виритуваний|виритий|понагравіровуваний
нагромаджуючий=що нагромаджує|нагромаджувальний|нагромаджувач|накопичувач
нагрянути=наскочити|набігти|насунути|налетіти
надв'язка=наштуковування|надточування|підточування|наставляння|доплітання|доплетення|доплетіння|надточка|наточка|доточка|підточка|доплітка
надихаючий=що надихає|що запалює|що окриляє|що наснажує|надихущий|запалющий|наснажливий
над'їжджаючий=що над'їжджає|на під'їзді|під'їжджанин
надурочний=позанормовий|наднормовий|позачерговий|надробочий
надурочно=позанормово|наднормово|позачергово
нажаль=на жаль
назріваючий=що назріває|близький|недалекий|(цілком) реальний
найекономічніший=найекономніший
наказуючий=що наказує|наказовий|командний|владний|повелитель|командир|наказодавець
накарачках=рачки
накачка=помпування|напомповування|насмоковування|напомпування|упоювання|надудлювання|напихання|напхання
накінець=нарешті
накінець-то=нарешті
накладаючий=що накладає|накладальний|накладач|накладальник|кладій
наковка=наковування|уковування|наклепування|сталення (стаління)|насталювання|накування (накуття)|укування (укуття)|наклепання|насталеіння|карбування|накарбовування|насікання|кування|накарбування|насічення|накування (накуття)
накоплений=призбираний|назбираний|зібраний|нагромаджений|збитий (до купи)|скупчений|накупчений|накопичений|нажитий|набутий|придбаний|надбаний|попризбируваний
наладжений=полагоджений|налагоджений|злагоджений|наладнаний|поладнаний|направлений|поналагоджуваний|понаправляний|налагоджений|наладнований|напосуджений|нарихтований (нариштований)
налом=готівкою
нападаючий=нападник|нападальний|нападний
наперевіс=напереваги
наперсточник=наперсткар
напівгусеничний=напівплазуновий
наплавка=натоплювання|натоплення|наганяння|нагнання|наплавляння|наплавлення
напочатку=на початку|спочатку|попереду|спершу|перше
направляючий=напрямний|направний|спрямовувальний|скеровувальний|чоловий
напружуючий=що напружує|натягальний|напружливий
наркоугруповання=наркоугруповання
наростаючий=що наростає|наростальний|зростальний|нарощуваний|нестримний
нарочний=посланець|гінець|навмисний|умисний
насичуючий=що насичує|насичувальний
насищений=насичений|нагодований|задовольнений|багатий (на що)
насморк=нежить
настилка=настилання|настелювання|наслання|настелеіння|мостіння|намощування|намощення (намостіння)|брукування|набруковування|настілка|поміст|устілка
настоєчка=настояночка|вистоялочка
настроюючий=що настроює|що наладовує|ладувальний|настроювальний|регулювальний
наступаючий=що настає|що надходить|надхожий|прийдешній|наступний|майбутній
натощак=натще|натщесерце|не поївши|на порожній шлунок
наукоємний=наукомісткий
научаючий=навчальний|учительний|напучувальний|напучливий
нафтоперевалочний=нафтоперевалковий|нафтоперевальний|нафтоперевантажний
нафтопоставка=нафтопостачання
нахиляючий=що нахиляє|що гне|нахильний
неблагонамірений=недобромисний|не з добрими замірами|недобрих замірів
неблагополучність=нещасливість|недобра доля|нещастя|негаразд|небезпечність
неблагополучно=негаразд|нещасливо|небезпечно|непевно|неладно
неблагополуччя=недобра доля|нещастя|негаразд
невгаваючий=безнастанний|безперестанний|нескінченний|безперервний|безупинний|невиводний
невгасаючий=незгасний|невгасний|непогасний|невгасимий|незгасимий
невзаємодіючий=що взаємодіє|скоординований|співзалежний|взаємної дії
невипромінюючий=невипромінний|безвипромінний|нерадіаційний|безрадіаційний|непроменистий
невисихаючий=що не сохне|що не висихає|що не пересихає|несхнучий
невідбиваючий=невідбивальний|невідбивчий|нездатний відбивати
невідповідаючий=що не відповідає|невідповідний|нереагівний|несприйнятливий
невіруючий=невірний|безвірний|небоговірний|безбожний|невір|невіра|невірець|невірник|безвірник|бузувір|що не вірить|невірний
невмовкаючий=немовчущий|безугавний|неугавний|невгавущий (невгавучий)|невгамовний
невоюючий=що не воює|що не бере участи в війні|невойовий
невстигаючий=що не встигає|неуспішний|слабенький
невтихаючий=нестишний|непритишний|невтишний|невтишимий|невгавний (неугавний)
невтоленність=невгамованість|непогамованість|незаспокоєність
нев'янучий=невідцвітний|неоцвітний|нев'янущий|нев'янущий|невмирущий|непропащий|неминущий
нев'янучий=невідцвітний|неоцвітний|нев'янущий|невмирущий|непропащий|неминущий
негаснучий=який не гасне (згасає, погасає, тухне, потухає, чахне)|незгасний
неглупий=недурний|недурноголовий|небезголовий|(доволі, досить) розумний
недіючий=що не діє|нечинний|недіяльний|недієвий|недійовий|неактивний
недіючість=нечинність
недовиробка=недовиріб|недовироблення
недозволяючий=що не дозволяє|заборонний
недомогання=нездужання|недугування|легка недуга|легка неміч
недостовірний=вірогідний|певний|правдивий|достометний|перевірений
недостовірність=вірогідність|певність|правдивість
недружелюбний=неприязний|недружелюбивий|недружній|неприхильний|неласкавий
недружелюбність=неприязність|недружелюбивість|недружність|неприхильність|неласкавість
незадіяний=незалучений|не пущений в дію
незамерзаючий=що не замерзає|незамерзущий|незамерзний
незатребуваний=непотрібний|незапитаний|незапрошений|невзятий
незатребуваність=непотрібність|незапитаність|відсутність попиту
незатухаючий=що не згасає|незгасний|невгамівний
#незважаючи adv    #> не зважаючи|не вважаючи|всупереч|наперекір|попри|дарма|хоч|без огляду
незгасаючий=що не згасає|незгасний|невгамівний
незговірливий=згідливий|згодливий|лагодливий|схильчивий|умовний
незмовкаючий=тривалий|немовчущий
незникаючий=незникний|ненульовий|відмінний від нуля|незникомий
незростаючий=що не зростає|невисхідний
неіонізуючий=нейонізівний
неіснуючий=що не існує|відсутній|нереальний|вигаданий|уявний
нейтралізуючий=нейтралізувальний
некоагулюючий=незгортний|некоагульовний
нелітаючий=нелетючий|нельотовий|нелітний
немислячий=нездатний мислити|безголовий|бездумний|безмисленний
ненавидячий=повний ненависті|сповнений ненависті|ненависник
необнародуваний=неоголошений|неоповіщений|неознаймований
неперекриваючий=неперетинний|неперекривний
неправомочний=неправосильний
непрацюючий=що не працює|незайнятий|нерухомий|неробочий
непрезентабельний=непристойний|непоказний|неповажний|нестатечний
неприглядний=непоказний|нечепурний|мізерний|жалюгідний
непроникаючий=непроникливий
непроточний=нетекучий|небігучий|непливучий
нервуючий=що нервує|дратівний|дражливий|дратівливий
нерезонуючий=нерезонансний|нерезонівний
нерозплавлений=нерозтоплений|нерозталий
нерозуміючий=що не тямить|не знавець|нетямущий|нетямовитий|некмітливий|некомпетентний
неспівзвучний=суголосний
неспівпадіння=незбіг|незбіжність|розбіжність|суперечність
неспроста=недурно|недарма|недаром
нестаріющий=вічномолодий|вічноюний|вічносвіжий
нестиковка=нестикування
нестихаючий=нестишний|непритишний|невтишний|невтишимий|неугавний
нестройність=нестрункість|безладність|нестатурність|неставність|нескладність|незгідність|незграйність|негармонійність
несучий=що несе|тримальний|опорний|носійний|несний
неув'язка=непогодженість|непогодження|непоєднаність|непоєднання|нев'язь|нестикування|нестикуваннячко|нестик
неув'язочка=непогодженість|непогодження|непоєднаність|непоєднання|нев'язь|нестикування|нестикуваннячко|нестик
нехватка=недостача|нестача|брак
нехтуючий=що нехтує|що ігнорує
нечистоплотність=неохайність
нижчестоячий=нижчий|підрядний|підпорядкований
нижчестоящий=нижчий|підрядний|підпорядкований
ниючий=що ниє|скимний|тупий|терпкий|щемлячий
нітрифікуючий=нітрифікувальний
новинарний=новинний|журналістський|газетярський
нововиявлений=нововідкритий
нокаутуючий=що нокаутує|що збиває з ніг|карколомний
нон-грата=нонграта
нормуючий=що нормує|нормувальний|нормувальник
носоглотка=носопролиг
ностальгуючий=що ностальгує|стужений
нудьгуючий=що нудьгує|нудьгар|знуджений
нуртуючий=що нуртує|клекітний
нюшкуючий=що нюшкує|нюхач|нюхальник
обаблений=збаблений
обварний=обварений|запарений
обволікаючий=що обгортає|обгортальний|охоплювальний
обгинаючий=що огинає|огинальний
обготівковування=переведення в готівку|інкасування
обготівковувати=переводити в готівку|інкасувати
обготівковуватися=переводитися в готівку|інкасуватися
обготівкувати=перевести в готівку|інкасувати
обготівкуватися=перевестися в готівку|інкасуватися
обезбарвлений=знебарвлений|позбавлений кольору, фарби
обезболений=знеболений|анестезований
обезболювальний=знеболювальний
обезболюючий=знеболювальний|протибольовий|аналгетик|анестетичний
обезводнений=зневождений|дегідрований
обезглавити=стяти голову|зітнути голову|відтяти голову|знечолити
обезглавлений=безголовий|з відтятою головою
обезголовлений=безголовий|з відтятою головою
обездолений=знедолений|бездольний
обездуховлений=знедуховлений|пустодухий
обезжирений=знежирений|знетовщений|знемаснений|випощений
обеззаражений=знезаражений|дезинфікований
обеззаражувальний=знезаражувальний
обеззаражуваний=знезаражуваний
обеззаражуючий=що знезаражує|знезаражувальний|дезинфекційний|дезинфектор
обеззброюючий=що знезброює|роззброює|знезброювальний|знезбройний|роззброювальний|роззбройний|знезброювач|роззброювач
обезземелений=збезземелений
обезземелення=збезземелення
обезземелити=збезземелити
обезземелювання=збезземелювання
обезземелювати=збезземелювати
обезкровлений=знекровлений
обезнадієний=позбавлений надії|зневірений
обезпліднений=знепліднений|яловий
обезсилений=знесилений|збезсилений|виснажений|занепалий|охлялий
обезславлений=знеславлений|збезславлений|ославлений
обезсмертити=зробити безсмертним|унесмертельнити|знесмертити|збезсмертити
обезталанений=знедолений|збезталанений|знещасливлений
обезчещений=безчещений|зганьблений|зганьбований
обертаючий=що обертає|обертальний|повертальний
об'єднуючий=що об'єднує (єднає)|об'єднавчий|єднальний|об'єднувач
обзаведення=заведення|справляння|придбання
обзавестися=придбати|справити|завести|завестися|охазяйнуватися
обзаводитися=придбавати|справляти|заводитися|заводити|справляти
обивательщина=обивательство
обидчивий=образливий|уразливий
обитель=житло|господа|оселя|домівка|мешкання|помешкання
обігріваючий=що обігріває|огрівний|обігрівальний
обідаючий=що обідає|за обідом
обілити=оббілити|вибілити
обілювати=оббілювати|вибілювати
обіцяючий=що обіцяє|обіцяльний|повен надій (сподівань)|обіцяльник
обіщаний=обіцяний
об'їждчик=об'їзник|об'їзний
облагороджуючий=що ушляхетнює|що поліпшує
обласкати=милувати|обмилувати|приголублювати|приголубити
облачення=церковний одяг|убір|одежа|одягання|убирання
обледеніння=обмороження|обморожування|обмерзлість|обмерзання
обледеніти=обмерзнути|узятисяв (вкритися) льодом (кригою)
обломковий=уламковий
облюбований=уподобаний|обмилований|вибраний|улюблений|ухвалений
облюбування=уподобання
облюбувати=уподобати|обмилувати|вибрати|улюбити|ухвалити
облягаючий=обтислий
обмацуючий=що обмацує|обмацувальний
обмежуючий=що обмежує|здатний обмежити|обмежувач|обмежувальний|межовий
обмиваючий=що обмиває|обмивальний
обмивка=обмивання|змивання|умивання|обмиття|обливання|облиття
обмундирований=умундирований|припоряджений
обмундировувати=умундировувати|припоряджати|справляти одяг
обмундирування=умундирування|припорядження|спорядження|виряд
обмундирувати=умундирувати|припорядити|справити одяг
обмундируватися=умундируватися|припорядитися|справити одяг
обнадіювати=запевняти|убезпечати|подавати надію
обнадіяти=запевнити|убезпечити|дати надію
обнулення=занулення|занулювання
обнуління=занулення|занулювання
обов'язуючий=що (який) зобов'язує|зобов'язувач|зобов'язчий|зобов'язальний
обоюдний=обопільний|взаємний|двосічний
обпалюючий=що обпалює|палючий|пекучий
ображаючий=що кривдить|кривдник|образливий|прикрий|дошкульний
обривчастий=урвистий|крутий|спадистий|стрімкий|крутоберегий|крутосхилий
обрізочний=обрізувальний|обрізальний
обробляючий=що обробляє|обробний|оброблювальний|оброблювач
оброчний=чиншовий
обручальний=заручний
обрюзглість=брезклість|одутлість
обсадка=обсаджування
обслуговуючий=що обслуговує|обслуговчий|обслуговий|обслужний|обслужувальний
обслужуваний=підтримуваний|обслуговуваний
обслужуючий=що обслуговує|обслуговчий|обслуговий|обслужний|обслужувальний
обсмолка=обсмолювання|осмолювання
обсмолюючий=що обсмолює|обсмолювальний
обстановочний=обставинний
обтікаючий=що обтікає|обтікальний|навколишній|навкружний|охоплювальний
обточка=обточування|обточення
обтяжка=обтягання|обтягнення
обтяжуючий=який обтяжує|обтяжувальний|обтяжувач
обхоплюючий=що охоплює|охоплювальний|охопний
обширний=широкий|просторий|розлогий|широкополий|широкопросторий|ширококраїй
обширність=широкість|просторість|розлогість
обштукатурений=обтинькований
овочівський=овочевий
огинаюча=обвідна (крива)
оглобля=голобля|голобелька|голоблище|голобляка
оготівковування=переведення в готівку|інкасування
огризок=недогризок
одживаючий=що відживає|неактивний|відсталий|перестарілий|старомодний
одиночка=одинець|одиниця|одинак|одиначка|безпарий
одиночка=одинець|одиниця|одинак|одиначка|безпарий
одиночний=одиничний|поодинчий|поодинокий|індивідуальний
одиночниця=одинак|одиначка|самітник|самітниця
одіяло=ліжник|укривало|ковдра|рядно|ряденце
одкаточний=відкотний; вивізний
одкачка=випомповування|випомпування|відсмокування
одлучка=відлучення|відлука|відгода
одноблочний=одноблоковий
одножолобчатий=одножолобчастий
одноканальний=одноканаловий
одноковшевий=одноківшевий
одноковшовий=одноківшевий
однонаправлений=однонапрямний
односільчанин=односелець
одноствольний=одноцівковий|одностовбурний|одностеблий
односуставний=односуглобовий
одужуючий=що одужує|майже здоровий|напіввидужалий|підлікований|видужанець
одурманюючий=що дурманить|задурливий|дурманний|запаморочливий|запаморочний
одуряючий=що дурманить|задурливий|дурманний|запаморочний|запаморочливий
оживляючий=живлющий|живущий|животворний
озаглавити=дати назву|дати заголовок|назвати|затитулувати
озаглавлювати=давати назву|давати заголовок|називати|затитуловувати
оздоровлюючий=що оздоровлює|оздоровчий|оздоровний|терапевтичний
оздоровляючий=що оздоровлює|оздоровчий|оздоровний|терапевтичний
оказуваний=роблений|чинений|виявлюваний|відданий
окалічений=скалічений|калічений|покалічений|знівечений|обезвічений
окам'янілий=скам'янілий|закам'янілий|покам'янілий|скаменілий|закаменілий|покаменілий
окам'янілість=скаменілість|скам'янілість|кам'янина
окатоличений=скатоличений|покатоличений|златинений|полатинений|латинник
окирковка=кайлування|обкайловування
окислений=окиснений|оксидований
окільцьований=закільцьований|обкільцьований|обкручений|загнузданий|захомутаний|обложений|оточений
оклейка=бклеювання|обліплювання|обклейка|обліпка
окольцьований=закільцьований|обкільцьований|обложений|оточений|закільцьований|обкручений|загнузданий|захомутаний
окорок=окіст|плічко|лопатка|стегно|шинка|вудженина
окороковий=окісний
окраїна=край|кінець|окрайок|закрайок|виріжок
окраїнний=закрайковий|покутній|українний
окрашений=покрашений|викрашений|закрашений|помальований|пофарбований|обкрашений|обмальований|обфарбований
окрилюючий=що окриляє|наснажливий|надихальний|надихущий
окриляючий=що окриляє|наснажливий|надихальний|надихущий
окріплий=зміцнілий|скріплий|уматерілий|уматернілий|поздоровілий|стверділий|стужавілий
округлояйцеподібний=округлий|овоїдний|опуклий|яйцюватий
олениха=олениця
омебльований=мебльований|умебльований|обмебльований
онімечений=знімчений|обнімчений
оновлюючий=що оновлює|оновлювальний
опадаючий=що опадає|що осідає|що спадає|падний|осідальний|спадний
опалесціюючий=що опалесцює|опалесцівний|опалесцентний|переливчастий
опалка=обсмалювання|смалення|обпалювання
оперізуючий=що оперізує|що підперізує|оперізувальний|поясуватий|оточувальний
опечалений=засмучений|зажурений|засумований
опікаючий=що опікає|опікунський|опікунчий|заступницький|що обпікає|що обпалює|обпалювальний|випалювальний|палючий|пекучий
опікуючий=що опікає|опікунський|опікунчий|заступницький
оплодотворений=запліднений
ополісканий=обполісканий
ополосканий=обполісканий
ополощений=обполісканий
ополчитися=употужнитися на кого|повстати на кого, проти кого|стати, змагатися проти
опорожнений=спорожнений|випорожнений
опорочений=заплямлений|зганьбований|зганьблений|зґанджований|ославлений|збезчещений
опорочити=заплямити|зганьбувати|зганьбити|зґанджувати|ославити|збезчестити
опорочувати=заплямлювати|ганьбувати|ганьбити|ґанджувати|ославлювати|безчестити
опошлений=вульгаризований|заяложений|затяганий
опоясаний=підперізаний|підперезаний|заперезаний|оперезаний|опасаний
оправдуючий=що виправдовує|виправдувальний|виправдавчий
опресований=обгнічений|обтиснений
опромінюючий=що опромінює|опромінювальний
оптимізуючий=що оптимізує|оптимізувальний|оптимізаційний
опушка=узлісся|підлісся|залісок|узлісок|надулісся|берег (край) ліса|(об)лямівка хутряна|брам
оп'янілий=сп'янілий|підпилий
оп'яняючий=п'яний|п'янкий|п'янкуватий
організовуючий=що організовує|організаційний|що впорядковує|впорядкувальний
організуючий=що організує|організаційний|що впорядковує|впорядкувальний
органозберігаючий=органозбережний
ореол=авреоля|сяйво
орієнтуючий=що орієнтує|орієнтувальний|орієнтаціний
орошений=зрошений|политий
осавулиний=осавулин
освистаний=обсвистаний|висвистаний
освідомлюючий=що дає знати|що інформує|інформаційний|інформатор
освіжающий=що відсвіжує|відсвіжувач|свіжистий|відсвіжущий|відсвіжливий|відсвіжний
осилити=перемагати|перемогти|подужати|здоліти|подолати
осиплий=охриплий|хриплий|хрипкий
осідаючий=що осідає|осідальний
осінити=отінити|окрити|покрити|огорнути|благословити|знаменати|оклонити
осіняти=отіняти|отінювати|окривати|покривати|огортати|охоплювати|спалахувати|осявати|з'являтися|благословляти|знаменати|оклоняти
оскалений=вискалений|вищирений|оскирений|повискалюваний|повищирюваний
осколочний=осколковий|уламковий|друзковий
оскуділий=зубожілий|зматчілий|ослаблий
ослаблюючий=що послаблює|послаблювальний
осмолюючий=що обсмолює|обсмолювальний
осмутнілий=похмурнілий
осмучений=засмучений|сумний|зажурений|смутний|невеселий|потьмарений|охмарений|похмарений
оснастка=опорядження|наряджання|пристроювання|наряддя|пристрій
осніжений=засніжений
основоутворюючий=наріжний|засадничий|засадовий|основоположний|базовий
оспорити=заперечити|не визнати|змагатися
оспорювати=заперечувати|змагатися|сперечатися|не визнавати|поборюватися
оспорюватися=заперечуватися|сперечатися|не визнаватися
осріблений=сріблений|посріблений|висріблений
остерігаючий=що застерігає|застерігальний|попереджальний|застережливий
острижений=обстрижений|коротковолосий
острокінчастий=гострий|гостроносий|гострокінцевий|кінчастий|стрімчастий|шпичастий|шпилястий
осцилюючий=що коливається|коливальний|осцилювальний|осциляційний|гойдальний|хитальний|коливний
отесаний=обтесаний
отоплювальний=опалювальний
оточуючий=навколишній|обвідний|окружний
отрушений=обтрушений
офарблений=покрашений|викрашений|закрашений|помальований|пофарбований|обкрашений|обмальований|обфарбований
офранцужений=зфранцужений
охарактеризувати=схарактеризувати
охарактеризуватися=схарактеризуватися
охвачений=обхоплений|обнятий|пойнятий|понятий
охолоджуючий=що охолоджує|що студить|охолоджувальний|холодильний
охоплюючий=що охоплює|обхоплювальний|охоплювальний|обхопний|обгортальний|обвідний|осяжний
охороняємий=що охороняють|стережений|бережений|пильнований
оцинковка=цинкування|поцинкування|поцинковання
оціночний=оцінювальний|цінувальний|оцінний
оцінюючий=що оцінює|оцінювальний|цінувальний|оцінний|оцінювач|цінувальник
оцукрений=зацукрований
оцукрюючий=що зацукрює|цукрувальний
очепурений=причепурений|прибраний|припоряджений|зряджений|прихахулений|прикукоблений
очистка=очищування|очищення|чищення|вичищання|вичищення
очищаючий=що очищає|очищальний|очисник|вичищувач
очікуючий=що очікує|очікувальний|очікувач
очорнений=почорнений|обчорнений|обмовлений
очумілий=очманілий|очамрілий
ощаснений=ущасливлений
пагубний=згубний|згубливий
падаючий=що падає|падущий|падучий|падний|спадний|впадний
пакляний=клоччаний
палатка=намет|шатро|таш|таша|ятка
палаючий=що палає|у вогні|у полум'ї|палкий|пекучий|пломінкий|палючий|палахкотючий|палахтючий|палахкотливий|палахкий
палкучий=плакучий
пальчатий=пальчастий
панбархатний=оксамиитовий
пануючий=панівний|керівний|переважний
папка=тека|обгортка|картон|палітурка
паразитуючий=що паразитує|паразитичний|паразитарний
парик=перука
паркетошліфовка=паркетошліфування|паркетошліфовання
паровозобудівельний=паротягобудівний
паровозовагоноремонтний=паротяговагоноремонтний
паровозозбиральний=паротягозбиральний
паровозоскладальний=паротягоскладальний
пародіюючий=що пародіює|пародійний|пародист
партнерша=партнерка
паруючий=що парує|повитий парою|паркий
патокоутворюючий=патокотвірний|патокотвірник
пахати=орати|плужити|ралити|ішачити|гарувати|не покладати рук|важко працювати
педвузівський=педвишівський
пенетруючий=що пенетрує|проникливий|пронизливий|жорсткий
первіснообщинний=первісногромадський
первонароджений=перворідний|первородний|перворідень
перебілка=перебілення|перебілювання
переборка=перебирання|перегортання|пересипання|перебірка|перегородка|розгородка|пересічка|перениз
перебраковка=перебракування|перебраковування
перебуваючий=що пробуває|що перебуває
перебудовчий=перебудовний
переважаючий=переважний|переважливий|найпоширеніший|панівний
перевалочний=перевалковий|перевальний|перевантаж
перевиборчий=перевиборний
перевивка=перевивання|переплітання|обмотування|пересукування|перекручування
перевірочний=перевірковий|перевірчий|вивірчий
перевіряючий=що перевіряє|контролер|перевірник|перевіряльник|контрольний|перевірчий
переводи=перекази|переклади
перевозка=перевозіння|перевіз
перев'язочний=перев'язувальний|перев'язний|завивний|в'язальний
переговірний=розмовний|перемовний
переговірник=перемовник|розмовник
переговорник=перемовник|розмовник
передаточний=передавальний|передатковий|передатний|уступний
передвзятість=упередженість
передержка=передержування|передержання|перетримування|перетримання|перепускання|перепущення|переховування|переховання|перевитрачування|перевитрачення|пересмикування
передматчовий=передматчевий
передуючий=попередній|передніший|передущий
переекзаменовка=новий іспит|повторний іспит|перепит
переживаючий=що переживає|вражений|уболівальник
пережиточний=пережитковий
перезарядковий=перезаряджальний
переіменований=перейменований
переіначений=переінакшений
переінструментовка=переінструментування
перекачка=перепомповування|перепомпування|пересмокування
перекличка=перекликання|переклик|переліка
переключання=перемикання
переключати=перемикати
переключатися=перемикатися
переключений=перемкнутий
переключення=перемикання
переключити=перемикнути
переключитися=перемикнутися
перековка=перековування|перекування
переконуючий=що переконує|переконливий|доводливий
перекопка=перекопування|перекопання
перекриваючий=що перекриває|перекривний|перекривач
переливка=переливання|переточування|пересипання|перетоплювання
переложний=переліжний
перемішуючий=що перемішує|змішувальний|перемішувальний|мішальний|мікшувальний|змішувач
перемножуючий=що перемножує|перемножний
переналадка=переналагоджування|переналагодження|(повторне) реґулювання|(повторне) зреґулювання|переладовування|переладування|перелаштовування|перелаштування|переюстовування|переюстування
переобмундирований=переумундирований|переприпоряджений
переодітий=передягнений|передягнутий|перебраний
переоркестровка=переоркестрування
перепахати=переорати|переплужити|переішачити|перегарувати
переписка=переписування|переписання|листування|кореспонденція
переплавка=перетоплювання|переливання|переплавляння|перегоніння|перепускання
перериваючий=що перериває|переривальний
перерізуючий=що перерізує|різальний
перерозстановка=перерозставляння|перерозставлення
пересадковий=пересідний|пересадний
пересадочний=пересідний
пересахарений=перецукрований
пересихаючий=що пересихає|висихний|(майже) пересохлий
пересушка=пересушування|просушування
перетасовка=перемащування|перемішування|перетасовування|перемащення|перетасування|(людей) переміщування|переміщення
перетворюючий=що перетворює|перетворювальний|трансформаційний|конверсійний|конвертер|перетворювач
перетинаючий=що перетинає|перетинний|перехресний
перетягуючий=що перетягує|перетягальний
переупаковка=переупаковування|переупакування
переустрій=перебудова|перебудовування|перебудування|реорганізація
перечислити=перерахувати|переписати|перелічити
перечислитися=перерахуватися|переписатися|перелічитися
перечисляти=перераховувати|переписувати|перелічувати
перечислятися=перераховуватися|переписуватися|перелічуватися
перешивка=перешивання|перешиття
перешкоджаючий=що перешкоджає|що заваджає|перешкодний|перепинний|перешкодник
перешліфовка=перешліфовування|перешліфування
перешнуровка=перешнуровання
перигелійний=перигелієвий
перила=бильця|поруччя|поручата|поручні|баляси
перистокрилий=пір’їстокрилий
персидський=перський
персистуючий=тривкий|незникний|персистентний|тривалий|стійкий|незбутній|стабільний
перфоруючий=що перфорує|перфораторний|перфораційний|перфоратор
перцівочний=перцівковий
першопрохідник=першопроходець
печіночний=печінковий
пивничий=пивничний
пиловсмоктуючий=пиловсисний|пиловбирущий
пирожниця=пиріжниця|пиріжечниця
питаючий=що питає|питальний|запитливий|запитувач|питайко
питомницький=розсадницький|плодорозсадницький
питтєвий=питний
піврозпад=напіврозпад
підбадьорюючий=що бадьорить|що збадьорує|бадьорливий|збадьорливий
підбілка=подбілювання|забілювання|забіл
підбурюючий=що підбурює|що намовляє|підбурювач|підбурник|намовник
підворітня=підворіття|підворітниця
піддержка=підтримка|підтримок|підтримання|підпора|підмога|підпомога|запомога|допомога|заратування
піджарений=підсмажений|засмажений|спражений
підзабутий=призабутий
підкачка=підпомповування|підпомпування
підключивши=увімкнувши|під'єднавши|приєднавши
підключити=увімкнути|під'єднати|приєднати
підключитися=увімкнутися|під'єднатися|приєднатися
підкоряючий=що скоряє|що підкоряє|що покоряє|що упокорює|що зневолює|що зачаровує|чарівний|чарівник
підкрашений=підмальований|підфарбований
підлавлювати=підхоплювати|переймати|заловлювати
підлавлюватися=підхоплюватися|перейматися|заловлюватися
підладжений=припасований|підладнований|підстроєний
підловити=підхопити|перейняти|заловити
підловитися=підхопитися|перейнятися|заловитися
піднімаючий=що підіймає|що здіймає|підіймальний|підіймач
підодіяльник=підковдра
підозріваючий=що підозрює|підозріливий|недовірливий
підпадаючий=що підпадає|підлеглий|підхожий|приналежний
підпираючий=що підпирає|підпиральний|підпірний|підпора
підрисований=підмальований
підрізка=підтинання|підрізування|підкроювання
підростаючий=що підростає|молодий|новий
підрубка=підрубування|підтинання|підруб
підсадка=підсаджування|досаджування
підсвічник=свічник|свічничок|посвітач|ставник|світоч|світич|світач
підсилюючий=що підсилює|підсилювальний|підсилювач
підсихаючий=що підсихає|схнучий|напіввисохлий
підслуховуючий=що підслуховує|що підслухує|підслуховий|підслухач|підслухувач
підсніжник=первістка|проліска|переліска|проліски|скороліски|просерен|просерень|первоцвіт|брандушка
підспудний=прихований|захований|підкилимний
підстановка=підставляння|підставлення
підстружка=підстругування|підстругання
підсумовуючий=що підсумовує|підсумковий|узагальнювальний|сумарний
підсушка=підсушування
підтасовка=підтасовування|підтасування
підтверджуючий=що підтверджує|що потверджує|що стверджує|підтверджувальний|потверджувальний|стверджувальний|підтвердний|потвердний|ствердний|підтверджувач|потверджувач|стверджувач
підтримуючий=що підтримуює|тримальний|підтримувальний|опорний|опоровий|підсилювальний|підживлювальний
підходящий=підхожий|підхідний|прикладний|відповідний|слушний|нагідний|догідний|пригідний
підчас=під час
пірнаючий=що пірнає|поринальний|пірнальний|норець
післяпосадочний=післяпосадковий/V
післясмак=посмак
плаваючий=що плаває|плавець|пливучий|плавучий|плавний|водоплавний|хиткий|нестійкий|рухомий|мінливий|незакріплений
плагін=додаток|модуль|втулок
пластинчатозябровий=пластинчастозябровий
платок=хустка|хустина
платочок=хустинка|хустиночка
плачучий=що плаче|плачущий|плачливий
плевритичний=превритний
плівкоутворюючий=плівкоутворювальний
плінтовка=плінтування|плінтовання
плісировка=плісування
плодородний=плідний|родючий|урожайний
пломеніючий=що пломеніє|полум'яний|пломінкий|пломенистий|вогнистий|стожарий|палахкий|палахливий|палахкотливий|пахахкотючий
плоскоріжучий=плоскорізальний
плошка=мисочка|мисчинка|ринка|риночка|риновка|каганець|каганок|каганчик
площадковий=майданний|площинковий
побідоносний=переможний
побільшуючий=що збільшує|збільшувач|збільшувальний
поблажка=потур|потурання|попуск|попуст
поблеклий=побляклий|збляклий|пополовілий|споловілий|полинялий|злинялий|вицвілий|зів'ялий|змарнілий
поближче=ближче|ближченько
поблискуючий=що виблискує|блискотливий|мерехтливий|ряхтливий
поборотий=переможений|поборений|подужаний|пересилений|переважений
побритий=виголений|підголений|вибритий
#побудка /n10.p2                 #> спонукування|підгоніння|призводження|підбуджування|підохочування|спонукання|підігнання|призведення|підбудження|підохочення
побутуючий=що має поширення|поширений|живий|постійно-побутовий
повадка=повада|звичка|нахил|унада|налога
поважаючий=що поважає|що шанує|шановливий|шанувальник
повальний=пошесний|загальний|поголовний|вселюдний
поварський=кухарський|пекарський
повергнений=звалений|повалений|скинений|скинутий|кинутий|кинений
повержений=звалений|повалений|скинений|скинутий|кинутий|кинений
повертаючий=що повертає|вертальний|повертальний|обертальний
повзаючий=що повзає|повзкий|ковзний|пластун
повідок=повідець
повідомлюючий=що повідомляє|оповісник|вісник|інформатор
повільнотверднучий=повільнотвердний
повільнотужавіючий=повільнотужавний
повновагомий=повноцінний|значний|показний|поважний|промовистий
поворонований=поворонений
повторювально-узагальнюючий=повторювально-узагальнювальний
повчаючий=що повчає|повчальний|навчальний|менторський|напутник|ментор
погиблий=загиблий|згиблий|пропащий|страчений
поглинаючий=що поглинає|поглинальний|абсорбційний|поглинущий|вбирний
погреб=льох|погріб|погребище|пивниця|склеп
подавлений=пригнічений|задавлений|задушений|погамований|притлумлений|придушений
подавляти=пригнічувати|задавлювати|задушувати|гамувати|притлумлювати
подавлятися=пригнічуватися|задавлюватися|задушуватися|гамуватися|притлумлюватися|придушуватися
подвійнозаломний=двозаломний
подвірній=подвірний
подвоюючий=що подвоює|подвоювальний
подразнюючий=що (який) подразнює|що дратує|що дражнить|подразливий|подразний
подушечний=подушчаний|подушковий
пожираючий=що пожирає|що жере|жерущий|пожирач|жерун
пожиттєвий=довічний|доживотний|досмертний
пожиттєво=довічно|повік|до смерті
позаучбовий=позанавчальний
позволений=дозволений|вільний
позиціонування=позиціювання
позиціонувати=позиціювати
позиціонуватися=позиціюватися
поіржавлений=поіржавілий|зіржавілий|заіржавілий
показуючий=що показує|вказівний|показувальний|індикаторний
покладистий=покладливий|укладливий|згодливий|несперечливий|схильчивий|рахманний|потульний|уважливий
покороблений=скорчений
покрашений=помальований|пофарбований
покриваючий=що покриває|покривальний|накривальний
покровитель=заступник|ласкавець|опікун|патрон|протектор|меценат
покровителька=заступниця|ласкавиця|опікунка|меценатка
полегшуючий=що полегшує|полегшувальний|допоміжний
полискуючий=що полискує|лискучий|лиснючий|лиснявий
поліметалічний=поліметалевий
поліпшуючий=що поліпшує|що покращує|поліпшувальний
поліровка=полірування|поліровання|лощіння|глянсування
поліруючий=що полірує|полірувальний|полірувальник
поліцейський=поліційний|поліціянт|поліцай
полка=полиця|поличка
половіючий=що половіє|що мерхне
поломеніючий=що пломеніє|що палає|полум'яний|пломінкий|пломенистий|вогнистий|стожарий|палахкий|палахливий|палахкотливий|пахахкотючий
поломка=ламання|зламання|поламання|злам|полім
полоса=смуга|пасмуга|попруга|пасман|басаман
полосатий=смугастий|смужкатий|смугнастий|смуганистий|посмугований|пасистий|пасмистий|пасемистий
полуменіючий=що пломеніє|що палає|полум'яний|пломінкий|пломенистий|вогнистий|стожарий|палахкий|палахливий|палахкотливий|пахахкотючий
полум'яніючий=що пломеніє|що палає|полум'яний|пломінкий|пломенистий|вогнистий|стожарий|палахкий|палахливий|палахкотливий|пахахкотючий
поляризуючий=що поляризує|поляризаційний|поляризувальний
поменше=менше|меншенько|трохи менше
помимо=крім|опріч|окрім|проти|поза
помираючий=що помирає|вмирає|конає|вмирущий|мирущий|мрущий|присмертний|смертельний
пом'якшуючий=що пом'якшує|пом'якшувальний|зм'якшувальний|м'якшильний|пом'якшувач
понижуючий=що понижує|що знижує|знижувальний|зменшувальний
понятійний=поняттєвий
понятний=зрозумілий
попадаючий=що влучає|влучний|що потрапляє
попахати=поорати|поплужити|поралити|поішачити|погарувати|важко попрацювати
попеліючий=що попеліє|жаристий
попереджуючий=що попереджає|застережливий|застережний|запобіжний|запобігальний|перестережний|попередливий|профілактичний
поповий=попів|попівський
поповнюючий=що поповнює|поповнювальний|поповнювач
поправочний=поправковий|виправний|коригувальний|корекційний
попратий=праний|попраний|стоптаний|потоптаний|підтоптаний|знехтуваний|зневажений|зламаний
поприще=кар'єра|поле|театр|арена|терен
попрікати=дорікати|докоряти|виказувати|вимовляти|нарікати
попрікнути=дорікнути|докорити|виказати|вимовити
порабощений=зневолений|поневолений|уярмлений|покріпачений|підбитий
поражений=ударений|улучений|уражений
порешечений=порешетений|здіравлений|подіравлений|постріляний
поржавлений=поіржавілий|зіржавілий|заіржавілий
пориваючий=що пориває|поривний|захватний
породотворний=породотвірний
порошковидний=порошкуватий|пилуватий
порчений=причинний|псований|зіпсований|бракований
посадочний=посадковий|висадковий
посахарений=зацукрований|цукрований|поцукрований
посил=посилання|надсилання
посилочний=посилковий|пакунковий
посмішище=(по)сміховисько|(по)сміховище|посміх
поставка=постачання|достачання|постача
поставщик=постачальник|достачальник
постановочний=поставний|постановчий
постилка=слання|стеління|простилання|підстелення|розстеляння|простирання|застеляння|мостіння|підстилка|підстілка|постілка|послання|підклад
постільничий=постільник|ліжничий
посткризовий=післякризовий
потомствений=нащадний|нащадковий|спадковий
потопаючий=що потопає|потопельник|утопленик|тонучий
потрясаючий=що вражає|приголомшливий|разючий|запридушний
похожий=схожий|подібний
почасовий=погодинний
почасово=погодинно|від години
початкуючий=що починає|зачинатель|ініціатор|початківець|дебютант|започатковувач|новачок
почитаючи=шануючи|поважаючи|величаючи
пошкоджуючий=що псує|ушкодливий|ушкідний|шкідний
пошукувач=здобувач
#появитися/B    #> з'явитися|виявитися|виникати
поясниця=поперек
пояснюючий=що пояснює|пояснювальний|роз'яснювальний|тлумачний|описовий
правлячий=керівний|керівничий|владущий
правомочний=правоможний|правосильний|судоправний|правочинний|уповноважений
правомочність=омпетентність|управненість|повновласть
правооборотний=правообертовий
прагнучий=що прагне (лине, прямує)|прагнущий|жаждущий|спрямований|націлений
празник=свято
практикуючий=що практикує|практик|з практикою
працюючий=що працює|працівний|робітний|робочий|справний|працівник|робітник
преблагополучний=прещасливий
предводительство=привід|провід|головування|отаманування|ватагування|маршальство
предостатньо=задосить
представляючий=що презентує|презентант|презентаційний|що відрекомендовує|зазнайомлювач|рекомендаційний|що розігрує|актор|артист|що зображує|що репрезентує|представник|речник|репрезентант|що являє|що уявляє|що становить
предстоятель=настоятель|настоятелька|голова
презентабельний=пристойний|показний|поважний|статечний
презентабельніший=пристойніший|показніший|поважніший|статечніший
презентабельність=пристойність|показність|поважність|статечність
презентабельно=пристойно|показно|поважно|статечно
презентабельніше=пристойніше|показніше|поважніше|статечніше
преславутий=горезвісний|сумнозвісний|славлений
престарілий=престарий|старезний|похилий
престижитаторський=престидижитаторський
прибавочний=додатковий|над-
прибивка=прибивання|прибиття
прибуваючий=що прибуває
приваблюючий=що приваблює|привабливий|вабливий|вабний|спокусливий|приворотний
привичка=звичка|навичка|призвичайка|призвичаєння|звичай|манера|традиція
привідкрити=прочиняти|прохиляти|відчиняти|відхиляти|відтуляти|відгорнути
приводка=приводження|припроваджування||приведення|припровадження|доводження|призводження|доведення|призведення|наводження|подавання|наведення|подання|отвережування|опам'ятування|опам'ятання|отвереження||зводження|зведення|прирядкування
привозний=привізний
прив'ядаючий=що в'яне|прив'ялий
пригасаючий=що пригасає|пригаслий
пригноблюючий=що притискає|гнобитель|гонитель|пригноблювач|утискувач
приговор=присуд|вирок|засуд|осуд|рішенець|декрет|суд
пригодитися=знадобитися|придатися|здатися|стати у пригоді
приголомшуючий=приголомшливий|запаморочливий|ошелешливий|запридушний|могутній
пригоночний=припасовувальний
пригородський=передміський
придушуючий=що придушує
приєднуючий=що приєднує|сполучальний|з'єднувальний|злучальний|зв'язувальний|єднальний
приземистий=низький|присадкуватий
признак=ознака|познака|прикмета|знак|слід
призупинений=припинений|перепинений|запинений
призупинення=припиняння|припинення|перепиняння|перепинення|запиняння|запинення|загаяння|загайка|загай
призупинити=припинити|перепинити|запинити|притишити|пригальмувати
призупинитися=припинитися|перепинитися|запинитися|притишитися|пригальмуватися
призупиняти=припиняти|перепиняти|запиняти|пригальмовувати
призупинятися=припинятися|перепинятися|запинятися|пригальмовуватися
приймаючий=що приймає|приймальний|приймач|приймальник
прийом=приймання|прийняття|вітання|зустріч|напад|захід|раз|спосіб|удаль|вдача
прийомний=приймальний|вступний|вітальний|порційний|названий
прикрашаючий=що прикрашає|прикрашальний
прилипаючий=що прилипає|що пристає|прилипа|липкий|прилипчастий|чіпкий|масткий|беручкий|беркий
приліжний=пильний|старанний|роботящий|упадливий|працьовитий|горливий|беручкий
прилягаючий=прилеглий|суміжний|сусідній|прилепистий|облиплий
приметаний=приживлений|на живу нитку пришитий|прифастриґований|прижилований
примикаючий=що притикає|що притикається|що припирає|що межує|прилеглий|притичний|сумежний
примінений=застосований|пристосований|прикладений|ужитий
примінити=застосувати|пристосувати|прикласти|ужити
примірний=зразковий|взірцевий|приблизний|орієнтовний|прикидний
примірочний=приміряльний
принудительний=примусовий|роблений з примусу (примусом)|приневільний
припадочний=припадковий|нападний|причинний|причинуватий
приплюснутий=приплесканий|приплескуватий|плескатий|плескуватий|плесковатий
приплюснутість=приплесканість|приплескуватість|плескатість|плескуватість
прирубка=прирубування|прирубання
присилка=надсилання|присилання|надіслання|прислання|подавання|присил
прислонений=приставлений|притулений|прихилений|припертий|обпертий
прислуговуючий=що прислуговує|прислужливий|послужливий|слуга|служник
присоромлюючий=що присоромлює
приспатий=приспаний
пристоячий=що пристоїть
притирка=притирання|притертя|натирання|стирання|припасування
притік=приплив|доплив|наплив|притока|гілка
притікаючий=що притікає|що припливає|припливний|напливний
притому=до того ж|до того ж таки|ще
приточка=приточення|припасування|доточка
приходний=прихідний|прибутковий
прихожанин=парафіянин
причуда=примха|химера|химерія|химорода|химородь|дивацтво
прищепка=прищіпка
пробивка=пробивання
пробігаючий=що перебігає|перебіжний|мимобіжний|проминущий
пробілка=вибілювання|біління|білування
пробочний=корковий
пробуксовка=пробуксовування|буксування
провисаючий=що провисає|провислий|обвислий|провислий|прогнутий
провірений=перевірений|вивірений|звірений
проводжаючий=хто проводить|хто проводжає|хто виряджає|хто випроводжає|проводжальник|супровідник
провозоспроможність=провізна спроможність
провокуючий=що провокує|провокатор|провокаційний|провокативний|провокаторський
проворонений=проґавлений|пропущений
прогниваючий=що прогниває|(майже) прогнилий
прогнозуючий=що прогнозує|прогнозувальний|прогнозний|прогностичний|передбачальний
програмуючий=що програмує|програмувальний|зайнятий програмуванням|програміст
прогресуючий=що прогресує|поступний|поступальний|прогресивний
прогульщик=прогульник
прогульщица=прогульниця
продавщиця=продавчиня|продавниця
продажа=продаж|спродаж|продавання|продання
продовгуватий=довгастий|довгуватий|подовгий
продовжуючий=що продовжує|продовжувач
продукуючий=що продукує|що утворює|утворювальний
проектуючий=що проектує|зайнятий проектуванням|проєктувальний|проекційний|проектувальник
прожарка=прожарювання|прожарення
проживаючий=що проживає|жилець|мешканець
проїжджаючий=що проїжджає|проїжджий|подорожній
проїздка=проїжджання
проймаючий=що проймає|що діймає|що дошкуляє|дошкульний|шкулький
прокатка=вальцювання|катання|прокатання
прокваска=проквашування|проквашення
проковка=проковування|виковування|кування|виковок
проколка=проколювання|протикання|простромлювання|просаджування|проштрикування|прокіл
прокопка=викопування|прокопування
прокрустовий=прокрустів
проллятий=розлитий|пролитий|розіллятий
проложений=прокладений|проведений|уторований|промощений|перекладений
прольотка=дрожка|бігунці
прольотний=перелітний
промаркірований=промаркований|замаркований|позначений|мічений
промашка=хиба|прогріх|промахування|махання
проминаючий=що минає (проходить, проминає, спливає, збігає)|минущий|проминущий|проминальний|зникомий|прохідний|перехідний|перехожий
промоушен=реклама|просування|стимулювання|популяризація|підтримка|допомога
промоушн=реклама|просування|стимулювання|популяризація|підтримка|допомога
пронизуючий=що пронизує|пронизливий|пронизуватий|проникливий|гострий|верескливий|різкий|проразливий|шпуйний
проникаючий=що проходить|що промикується|що просмикується|проникливий
пропадаючий=що пропадає|напівзниклий|зникомий|запропасливий|пропащий
пропарка=пропарювання
прописочний=прописковий
проплавка=розтоплювання|перетоплювання
пропускаючий=що пропускає|пропускальний
прорезинений=гумований|прогумований
проривка=проривання|прориття|прокопування|висмикування
прорисований=перемальований|перерисований|перезнятий|перебитий
проробка=пророблення|опрацювання|опрацьовування
проронений=упущений|пробовкнутий|прослуханий|недочутий
проростаючий=що проростає|висхожий|зіхідний|майже пророслий
прорубка=прорубування|прорубання|протереблювання|протереблення|протереб|розрубування|перерубування|розрубання|перерубання
просапка=просапування
просвітительний=просвітний|просвітній|просвітницький|просвітянський
просвітність=поруватість
прославляючий=що славить|прославитель|хвалитель|хвалій|величальник|величальний|славословний|панегіричний
#простой/e    #> простоювання|вистоювання|перестоювання
просто-напросто=просто|просто-таки|попросту
просторний=просторий|простірний|повільний|розлогий|розложистий|розлеглий
просушка=просушування|просушення|пересушування
протестуючий=що протестує|протестаційний|протестант
противідкотний=противіткітний
протидіючий=що протидіє|що діє проти|що чинить опір|протидійний|протиборчий|супротивний|несприятливий
протизачаточний=протизаплідний
протипожарний=протипожежний
протиріжучий=протирізальний
протирічити=суперечити|перечити|сперечатися|противитися|розбігатися
протиріччя=сперечання|суперечність|супротивність|розбіжність
протискарлатинозний=протискарлатиновий
#проточний/V    #> текучий|бігучий|пливучий
профілюючий=що профілює|профільний|профілювальний|профілювальник
прохолоджуючий=що холодить|холодливий|прохолодний
процвітаючий=що процвітає|квітний|квітистий|квітучий|успішний
прочий=інший|решта
прощупаний=намацаний|налапаний
прощупати=намацати|налапати|промацати
прощупатися=намацатися|налапатися|промацатися
прощупувати=намацувати|налапувати|промацувати
прощупуватися=намацуватися|налапуватися|промацуватися
прямодіючий=прямодійний
прямостоячий=прямий|випростаний|прямостійний
прямоточний=прямопотоковий|прямотічний|прямотечійний|прямоструминний|прямоструменевий
прямуючий=що прямує|по дорозі до|на шляху до|подорожній
пугало=страховище|страшило|пострах|страх|страхопуд|пудало|опуд|лякало|лякайло|лякачка|страшок|дід солом'яний
пузирковий=бульбашковий
пульсуючий=що пульсує|пульсівний|биттєвий|імпульсний|імпульсовий
пустушка=дурниця|марниця|дрібниця|абищиця|пусте|байка|порожняк|соска|пипка|мізюк|смочок|дурник|шелихвіст|пустоб'яка|пустоб'яха
путьовий=путній|путящий
п'янка=пиятика|гульня|дудліж
п'ятикупольний=п’ятибанний
раболіпний=підлесливий|облесливий|підлесний|облесний|підлепливий|підлепний|знижений|невільничий|побожний
раболіпство=підлесливість|улесливість
раболіпствувати=плазувати|колінкувати|холопствувати|лизати халяву|лизати чоботи|рачки лазити (перед ким)
радіовипромінюючий=радіовипромінний|радіовипромінювальний|радіопроменувальний
радіосенсибілізуючий=що сенсибілізує|сенсибілізувальний|сенсибілізаційний|сенсибілізатор
радіючий=радий|зраділий|охоплений радістю|сповнений радощів
радуга=веселка|райдуга
радужка=райдужка|райдужна оболонка|ірис
радужний=веселковий/V
ракушка=мушля|черепашка|скойка
рамочний=рамковий/V
рандомізуючий=що рандомізує|рандомізаційний|хаотизаційний
распрі=чвари|сварка|незгода|колотнеча
раціоналізуючий=що раціоналізує|раціоналізаційний
рашпильний=рашпільний/V
реагуючий=що реагує|здатний зареагувати|реагівний|реагент
реверсуючий=що вертає|реверсивний|реверсувальний|вертальний|оборотний|перевертальний
революціонізуючий=що революціонізує|що радикально міняє
регенеруючий=що регенерує|що відновлює|відновлювальний|реґенерувальний|реґенераційний
регламентуючий=що регламентує|регламентувальний|регламентаційний|для регламентації
регулюючий=що регулює|регулювальний|регулювальний|регуляційний|регулятор
редукуючий=що редукує|редукувальний|редукційний|редукторний|редуктивний
реєструючий=що реєструє|реєстраційний|реєструвальний
резинка=гумка
резонерствуючий=що резонерствує|резонерський|резонер
резонуючий=що резонує|резонансний|резонансовий|відлунистий|резонатор
рейдуючий=що рейдує|змушений рейдувати|зайнятий рейдом|рейдовик|рейдовий
рекомендуючий=що рекомендує|рекомендаційний|порадник
ремонтнопридатний=ремонтопридатний/V
ренегатствуючий=що ренегатствує|ренегатський|ренегат
ретируватися=відступати
ретушерний=ретушевий/V
рибовозний=рибовізний/V
ридаючий=що ридає|ридальний|у сльозах
рижий=рудий/V
рижіший=рудіший/VY
рижобородий=рудобородий/V
рижоволосий=рудоволосий/V
рижовусий=рудовусий/V
рижохвостий=рудохвостий/V
рижуватий=рудуватий/V
рикаючий=що реве|сповнений рику|рикало|ревун|рикун|ревучий
римуючий=що римує|римувальний|римотворчий|римувальник
риночний=ринковий
рискований=ризикований/V
рифма=рима
рідіючий=що рідшає|ріденький|рідкуватий
ріжучий=що ріже|різальний|різкий|пронизливий
різнобій=різнобіжність|брак згоди|незлагода
#рішатися/JHR :imperf    #> зважуватися|наважуватися|пускатися
рішаючий=вирішальний|вирішний|головний|основний|провідний|стрижневий|розв'язувальний|ухвальний
рішитися=зважитися|наважитися|пуститися
рожевіючий=що рожевіє|напіврожевий|майже рожевий
розбалуваний=розпещений|розбещений|розпущений|розпаскуджений|зледащілий|розледащілий
розбірка=розбирання|сортування|розкидання|демонтаж
розбраковка=розбраковування|розбракування
розвантажуючий=що розвантажує|розвантажувальний|вивантажувальний
розвиваючий=що розвиває|розвивальний|розвивчий
розвозка=розвіз|розвозини
розв'язуючий=що розв'язує|розв'язувальний
розгалужуючий=що розгалужує|відгалужувальний|для галуження
розгальмовуючий=що розгальмовує|розгальмовувальний
розгинаючий=що розгинає|розгинальний|розгинач
розгріваючий=що розігріває|розігрівальний|розігрівач
розділюючий=що розділює|розподільчий|роздільний|розділювальний|розподільний|розрізнювальний|розділовий|розбратній|роз'єднавчий|межовий|розподілювач
розділяючий=що розділює|розподільчий|роздільний|розділювальний|розподільний|розрізнювальний|розділовий|розбратній|роз'єднавчий|межовий|розподілювач
роздражнюючий=який роздражнює|дратівний|дратівливий|дражливий|подразливий|подразний
роздразнюючий=який роздражнює|дратівний|дратівливий|дражливий|подразливий|подразний
роздруківка=роздрук
роз'єднуючий=що роз'єднує|роз'єднувальний|розлучний
роззброюючий=що знезброює|роззброює|знезброювальний|знезбройний|роззброювальний|роззбройний|знезброювач|роззброювач
розігріваючий=що розігріває|розігрівальний|розігрівач
роз'їдаючий=що роз'їдає|їдкий|ядучий|роз'їдний
розкачка=розгойдування|розгойдання|розхитування|розхитання
розквітаючий=що розцвітає|майже розквітлий|квітучий
розкисаючий=що розкисає|майже розкислий
розкладаючий=що розкладає|розкладальний|розкладач|розкладник
розклейка=розклеювання|розклеєння
розкошелитися=брязнути гаманцем|розв'язати калитку|розкопотитися
розкрашений=розмальований|розфарбований|кольоровий
розкупорений=відіткнутий|відкоркований|розкоркований|відбитий|розпакований|розшитий
розкупорка=відіткнення|відкорковування|розкорковування|розпакування
розливка=розливання
розмагнічуючий=що розмагнічує|демагнетизаційний|знемагнетовувальний|відмагнетовувальний|демагнетовувальний|розмагнетовувальний
розмикаючий=що розмикає|розмикальний|розмикач
розмочка=розмочування|розмочення
розноска=рознос|розношення|розношування|рознесення
рознощик=розносник|розносець|носій|газетоноша, листоноша...
розпаковка=розпаковування|розпакування
розписний=мальований|розмальований|писаний|мережаний
розплавка=розтоплювання|розтоплення|топлення
розподіляючий=що розподіляє|розподільчий|розподільний|розподілювач|розподільник
розпутаний=розплутаний
розрисований=розмальований|писаний
розрихлити=підпушити|розпушити
розрихлитися=підпушитися|розпушитися
розрихляти=підпушувати|розпушувати
розрихлятися=підпушуватися|розпушуватися
розрубка=розрубування|розрублення
розрушати=руйнувати|розруйновувати|бурити|валити|розкидати
розряджаючий=що розряджає|розрядний|розрядник|що вичепурює|прикрашальний
розсадка=розсаджування|розсадження
розсіюючий=що розсіює|розсіювальний|розсівний|розсівач|розсівальник
розстановка=розставлювання|розставляння|розставлення|розстава|розклад
розтерзання=роздертя|потала
розтруска=розтрушування|розтрушення|розтрус
розтушовка=розтушовування|розтушування
розузорений=змережаний|помережаний
розукрупнений=подрібнений|розгромаджений|розбитий
розуміючий=що тямить|знавець|тямущий|тямовитий|кмітливий|компетентний
розфокусовка=дефокусування|здефокусування|розфокусовування|розфокусування
розчіплюючий=що розчіпляє|що відчипляє|розмикальний|відчіпляльний
роз'яреність=розлюченість
рудник=копальня|рудня
руйнуючий=що руйнує|руйнівник|плюндрій|спустошувач|руйнівний|руїнницький|спустошливий
рукоятка=держак|держално|ручка|руків'я|стебло|хрест
рукоять=держак|держално|ручка|руків'я|стебло|хрест
рульовий=кермовий|стерновий|стерничий|стерник|керманич
рябинівка=горобинівка
ряджений=переодягнений|маскований|замаскований
салотопка=салотопня|салган|сальня
салфетка=серветка
самодовліючий=самодостатній|самоцінний|незалежний
свобідний=вільний
свобідно=вільно
свободівець=свободовець
своєвільство=сваволя|свавілля|свавільство|самовільство|самовільність|самочинство
святкуючий=що святкує|учасник свята|празничанин|святковий
священичий=священицький
сенсибілізуючий=що сенсибілізує|сенсибілізаційний|сенсибілізувальний|очутливлювальний
сервіровка=сервування
сивіючий=що сивіє|щораз сивіший|напівсивий|сивавий|просивілий|сивастий|шпакуватий|посивілий
сигналізуючий=що сигналізує|сигнальний
синіючий=що синіє|чимраз синіший|засинілий
синтезуючий=що синтезує|синтезувальний|синтезатор
синхронізуючий=що синхронізує|синхронізаційний|синхронувальний|синхронізувальний|синхронізатор
сищик=слідець|вивідач|детектив|слідчий|нишпорка
сіріючий=що сіріє|чимраз сірішій|огортуваний сірістю
сіятельний=ясновельможний
сіяючий=що сяє|осяйний|сяйний|сяйливий
скануючий=що сканує|сканувальний|сканувальник|сканер
скачка=скакання|стрибання|плигання|перегони|гони|верхогони|біговисько|гонитва
скачування=звантаження|стягування
сквернений=споганений|опоганений|запоганений|закаляний|згиджений|спаскуджений|опаскуджений|зневажений|збезчещений
скеровуючий=що скеровує|спрямовувальний|скеровувальний|напрямний
скидка=скидання|знижка
скимлячий=що ниє|скимний|терпкий|тупий|щемлячий
скип'ячений=закипілий|кипілий|зокроплений|спарений
скімлячий=що верещить|вискун|верескун|верещака|верескливий|вискливий|вискотливий
складчина=складка
склочний=чварний
склочник=кляузник|інтриган
сковуючий=що сковує|сковувальний|сковувач
сколюючий=що сколює|сколювальний|відколювальний
#скорегувати/AB    #> скоректувати|виправити|скоригувати
скоропашка=дряпак
скорочуючий=що скорочує|вкорочувальний
скраснілий=почервонілий
скріплюючий=що скріплює|скріпний|скріплювальний|кріпильний|закріплювальний
скрючений=скорчений|покорчений|скоцюрблений|скручений|скарлючений|покарлючений|зсудомлений|покулений
скука=нудьга|нудота
слиханий=чуваний|чутий
слідкуючий=що слідкує|що стежить|відстежувальний
слідуючий=наступний|черговий|дальший|подальший|другий|такий
сміхотворний=сміховинний
сміхотворність=сміховинність
сміхотворно=сміховинно
снігурочка=Снігуронька
снігуроччин=Снігуроньчин
соковижималка=соковидавлювач|соковичавлювач|соковичавниця|сокодавилка
сокровенний=таємний|потаємний
сокровенніший=(най)потаємніший
солодкоїжка=ласун|ласунка|ласуха|ласій|ласійка|ласолюб|ласолюбка
сопроцесор=копроцесор|співпроцесор
сортир=нужник
сортуючий=що сортує|що впорядковує|сортувальний|впорядковувальний
состав=склад|сполука|речовина|суміш|валка|поїзд
сохнучий=що сохне|сушений|висушуваний|схнучий
сочний=соковитий
спадаючий=що спадає|спадний
спакощений=спаскуджений|споганений|загиджений|згиджений|скапощений
спалахуючий=що спалахує|палахливий|огненний|огнистий
спасатися=рятуватися
спецпідготовка=спецвишкіл
співаючий=о співає|співець|співак|співун|співучий
співзвучний=суголосний
співзвуччя=суголосся
співіснуючий=що співіснує|добросусідський|паралельний
співпадати=збігатися|сходитися
співпадаючий=що збігається|що зходиться|збіжний
співпасти=збігтися|зійтися|злитися|припасти
співпричетність=причетність
співставити=зіставити|порівняти|провести паралель
співставитися=зіставитися|порівнятися
співставлення=зіставлення|порівняння
співставляти=зіставляти|порівнювати|проводити паралель
співставлятися=зіставлятися|порівнюватися
співставляючий=що зіставляє|що порівнює|порівнювач
співтовариство=спільнота|товариство|спілка|компанія
співчуваючий=що співчуває|сповнений співчуття|прихильник|симпатик|співчутливець
співшукач=шукач|пошукач|конкурсант|учасник конкурсу
сплиття=випливання|виплиття|виринання|зринання
сповзаючий=що сповзає|зсуваний
сповільнюючий=що сповільнює|сповільнювальний|гальмівний|гальмувальний|затримувальний
споживаючий=що вживає|споживач|користувач
спостерігаючий=що спостерігає|зайнятий спостереженням|спостерігач|споглядач|дозорець
спотворюючий=що спотворює|спотворювальний|викривлювальний|деформувальний|знеформлювальний
спотілий=спітнілий|употілий|упрілий|змокрілий|гарячий
спочиваючий=що спочиває|що відпочиває|спочивальний|відпочивальний|на спочинку
справка=довідка
сприймаючий=що сприймає|сприймальний|сприйнятливий|впізнавальний|рецепторний|сприймач|рецептор
сприяючий=що сприяє|сприятливий|добрий (на що)|гарний (на що)|погожий|погідний
спродажа=спродаж
спрощуючий=що спрощує|спрощувальний|полегшувальний
спрямовуючий=що спрямовує|напрямний|направний|чоловий|направник
спуганий=сполоханий|спуджений
спугнути=сполохати|спудити
спустошуючий=що спустошує|спустошливий|спустошливої дії
ссуда=позика
стабілізуючий=що стабілізує|стабілізаційний|стабілізувальний|усталювальний
ставня=віконниця
стажер=стажист
старина=старовина|давнина
старіючий=що старіє|зістарюваний|постарілий|зістарений
стверджуючий=що стверджує|ствердливий|стверджувальний|стверджувач
#ствол/efg    #> стовбур|стебло|стеблина|дуда|цівка|рура|жерло
стервозний=стервезний|стервенний|стервенський
стервозність=стервезність|стервенськість
стержень=стрижень|шворінь|серце|основа
стержневий=стрижневий|швореневий|основний
стиковка=стикування
стимулюючий=що стимулює|заохочує|збуджує|заохочувальний|збуджувальний|стимуляційний|заохочувач|збуджувач|стимулятор
стираючий=що стирає|стиральний
стискаючий=що стискає|стискальний|стискувальний|стискний|стисний|стискач
стискуючий=що стискає|стискальний|стискувальний|стискний|стисний|стискач
стогнучий=що стогне|жалібний|тужливий|стогній|скиглій|зі стогном
стомлюючий=що стомлює|стомливий|виснажливий
стравити=нацькувати|вивести|випасти
стравитися=нацькуватися|вивестися|випастися
стравлювати=цькувати|нацьковувати|виводити|випасати
стравлюватися=цькуватися|нацьковуватися|виводитися|випасатися
страждаючий=що страждає|сповнений муки|мученик|страдник|страдний|страдницький|довготерпеливий
страйкуючий=що страйкує|страйкар|учасник страйку|охоплений страйком
страусиний=страусовий
страхаючий=що встрашує|що лякає|лячний|застрашливий|настрашливий
стремління=потяг|поривання|жага|прямування
стрем'янка=драбинка|драбина|ступанка|східня (сходня)|сходні
стрибаючий=що стрибає|стрибучий|пострибущий|плигучий
стримуючий=що стримує|здержує|стримувальний|стримчий|стримувач|здержувальний|здержувач|тамувальний|тамувач|гальмівний
стрілочний=стрілковий|виличний
стріляючий=що стріляє|що штрикає|стрілючий|штрикучий|стрілець
стробуючий=що стробує|стробувальний
#строгіший/VY    #> суворіший|гостріший
строчка=рядок|стебнування|вистіг
структуризувати=структурувати
структуризуватися=структуруватися
структуруючий=що структурує|структурувальний|структуроутворювальний
стягуючий=що стягає|стягувальний|стяжний
судорга=судома|судорга|судомлення|корч|корчі|конвульсія
судорога=судома|судорга|судомлення|корч|корчі|конвульсія
супроводжуючий=що супроводжує|супутній|супровідний|провожатий|супровідник
сутеніючий=що меркне|напівзгаслий|напівпомерклий|загасущий|вгасущий
суцільнометалічний=суцільнометалевий
схватка=сутичка|бій|герць|бійка|сварка|суперечка|хомут|лисиця|перейма
сьогохвилинний=миттєвий|негайний|на цю хвилину|мить
сягаючий=що сягає|простертий|простягнутий|простягнений|розпросторений|простелений|розлеглий|простяжний
сяючий=що сяє|опромінений|осяяний|сяйнистий|блискучий|сяйливий|осяйний|сяйний|пишно блискучий|променистий
табулюючий=що табулює|табулювальний|табуляційний
танцюючий=що танцює|розтанцьований|закружений у танці|танцюрист|танцівник|танцювальник|танцюра|танцювальний|танцівливий
тасуючий=що тасує|тасувальний|тасувальник
твердотільний=твердотіловий|твердотілий
тепловиділяючий=тепловидільний
тепловипромінюючий=тепловипромінний
теплоізолюючий=теплоізолювальний|теплоізоляційний|теплозахисний
терзання=муки|мордування|шматування|шарпання|роздирання
терзати=дерти|роздирати|шарпати|мордувати|мучити
тестуючий=що тестує|тестувальний|випробувальний|випробовчий|перевірчий
тиквочка=гарбузочок
типізуючий=що типізує|типізаційний
ткань=тканина|матерія|полотно|сукно
ткачиха=ткаля
тліючий=що тліє|напівзотлілий|пойнятий тлінням|ледве теплий|жаристий|розжеврілий
толковий=тямкий|тямучий|тямущий
томність=млость (млість)|млості|зомління|втома
тонізуючий=що тонізує|тонізувальний|тонізаційний|збадьорливий|збудний|збудливий|збуджувальний
тонучий=що тоне|напівзатонулий|потопальник
тонуючий=що тонує|тонувальний
торжество=(урочисте) свято|урочистість
торжествувати=(урочисто, бучно) святкувати|тріумфувати
торжествуючий=що торжествує|тріумфальний|урочистий|переможний|урочий
транслюючий=що транслює|транслювальний|трансляційний|транслятор
транспонуючий=що транспонує|транспонувальний|транспозиційний
#транспортабельний/V    #> переносний|пересувний|рухомий|транспортовний
транспортуючий=що транспортує|транспортувальний
трансформуючий=що трансформує|трансформаційний|перетворювальний|конверсійний
трасуючий=що трасує|трасувальний
триваючий=що триває|не припинюваний|тяглий|безперервний
тріумфуючий=що тріумфує|тріумфальний|переможний|урочистий
тройка=трійка|троян
трудолюбивий=працьовитий|роботящий
туземний=тубільний|місцевий
тунелюючий=що тунелює|тунелювальний
турбуючий=що докучає|що турбує|неспокійний|тривожний|докучливий|настирлиний|дошкульний
тусівка=збіганка|збіговисько|тусня|тусняк|тусман|тусування
тучність=гладкість|ситість|опасистість|угноєність
тушонка=тушкованка
тягнутий=тягнений
тягнучий=що тягне|тягач|тяговий|тягучий
тяп-ляп=сяк-так|абияк|нашвидку|нашвидкуруч|на галай-балай
убавлений=зменшений
убиваючий=що вбиває|убивчий|душогубний|смертоносний|убивця|душогуб
убратий=опоряджений|чупарний
убуваючий=що меншає|спадний|низхідний|убутний
увалистість=вибоїстість|ямкуватість
уварка=уварювання|уварення
удостоєний=відзначений|ушанований|нагороджений
удостоєність=відзначеність|вшанованість|нагородженість
удостоїти=відзначити|вшанувати|нагородити
удостоїтися=відзначитися|вшануватися|нагородитися
удостоювання=відзначання|вшановування|нагороджування
удостоювати=відзначати|вшановувати|нагороджати
удостоюватися=відзначатися|вшановуватися|нагороджатися
удушливий=задушливий|задушний
узагальнюючий=що узагальнює|узагальнювальний|узагальнений|сумарний|підсумковий
узгоджуючий=що узгіднює|узгіднювальний|узгоджувальний|координувальний|координаційний
указуючий=що вказує|вказівний
уклономір=похиломір|схиломір
уклонопокажчик=схилопокажчик
уловлюючий=що вловлює|ловильний|захоплювальний
умикаючий=що вмикає|вмикальний|вмикач
умираючий=що помирає|вмирає|конає|вмирущий|присмертний|смертельний
уніфікуючий=що уніфікує|уніфікувальний|уніфікаційний|об'єднавчий
упаковка=упаковування|спаковування|пакування|упакування|спакування|упаковання|обгортка
упихнутий=упхнутий|запихнутий
упідлеглений=підпорядкований
уповільнюючий=що сповільнює|сповільнювальний|гальмівний|гальмувальний|затримувальний
управляючий=що керує|керівник|управитель|адміністратор|керівний|адміністративний|кермовий
уражаючий=що вражає|разючий|дивовижний|винятковий
урозумляти=напоумляти|напучувати|на (добрий) розум наставляти|клепку вставляти
уряджаючий=що уряджає|організаційний|організаторський|організатор
усезнаючий=усезнавець|всевідець|всевіда|всезнайко|знаюка
усеобіймаючий=всеосяжний|всеохопний|всебічний
усеохоплюючий=всеосяжний|всеохопний|всебічний|універсальний|поголовний|панорамний
усеперемагаючий=всепереможний|звитяжний|здатний здолати все
усепоглинаючий=всепоглинальний|всепоглинущий
усерйоз=серйозно|навсправжки
ускладнюючий=що ускладнює|ускладнювальний
усмирити=втихомирити|приборкати|угамувати|притишити|приструнчити
усмиряти=втихомирювати|приборкувати|притишувати|вгамовувати|приструнювати
успіти=устигнути|поспіти
установлюючий=що встановлює|установчий|інсталяційний|запроваджувач|установник|інсталятор
устій=стоян|підпора|підвалина
уступка=поступка|знижка
утворюючий=що утворює|утворювальний|твірний
утікаючий=що втікає|втікач
уточнюючий=що уточнює|уточнювальний|уточнювач
утрачаючий=що втрачає|утратливий
утримуючий=що утримує|утримувальний|тримальний
учбовий=навчальний
ущільнюючий=що ущільнює|ущільний|ущільнювальний|ущільнювач
уяснити=з'ясувати|усвідомити|зрозуміти
фазорегулюючий=фазорегулювальний
фарбуючий=що фарбує|фарбувальний|фарбувальник
фашиствуючий=що фашиствує|фашистський|фашизм
фіксуючий=що фіксує|що закріплює|фіксувальний|фіксаційний|закріплювальний|фіксатор|фіксувальник
фільтруючий=що фільтрує|фільтраційний|фільтрувальний|фільтрівний
флуктуючий=що флуктує|флуктівний|із флуктуаціями|флуктуаційний|мінливий
флуоресціюючий=флюоресцентний|флюоресцівний
флюктуючий=що флуктує|флуктівний|із флуктуаціями|флуктуаційний|мінливий
флюоресціюючий=флюоресцентний|флюоресцівний
фокусуючий=що фокусує|фокусувальний
фонтануючий=що фонтанує|грайний|водограйний|фонтанний
форматуючий=що форматує|форматувальний
формовка=формування|формовання
формоутворюючий=формоутворювальний
формуючий=що формує|формувальний|формотворчий|формувальник
форсуючий=що форсує|форсувальний
форточка=(віконна) кватирка|кватирочка
фотозйомка=фотографування
фотосенсибілізуючий=фотосенсибілізаційний|фотосенсибілізаторний|фотосенсибілізатор
фракціонуючий=фракціювальний
функціонуючий=що функціонує|функціонер|дійовий|активний|чинний|функціональний
хвастливий=хвалькуватий|хвастовитий|чванливий|загонистий|заносистий|задавакуватий
хвилюючий=що хвилює|хвильний; бентежний|бентежливий|зворушливий
хитаючий=що хитає|хитальний|гойдальний
хникати=скигляти|скімлити|скавуліти|рюмсати|пхикати
холочка=чубок|пахолок
хранителька=хоронителька|охоронниця|берегиня
худосочний=щуплий|щуплявий|хирлявий|худорлявий
царапати=дряпати|шкрябати|дерти|скромадити
царапатися=дряпатися|шкрябатися|дертися|скромадитися
царствувати=царювати
царствуючий=що царює|царський|цар
царюючий=що царює|царський|цар
цементуючий=що цементує|цементувальний
централізуючий=що централізує|покликаний централізувати|для централізації|зайнятий централізацією|централізаційний
центробіжний=відцентровий
центруючий=що центрує|центрувальний
циркулюючий=що циркулює|циркуляційний|циркулівний|циркуляційний
цікавлячий=що цікавить|цікавий (для кого)
цільнометалічний=цільнометалевий
чаруючий=що чарує|чарівний|чарівкий|чарівничий|чарівливий|обворожливий|чародійний
чеканити=карбувати|бити|рубати
чеканитися=карбуватися|битися|рубатися
чекаючий=що очікує|очікувальний|очікувач
червоточний=червотокий|червивий
черпалка=черпальниця|черпачка
чехарда=довга лоза|цап|плутаниця|розгардіяш|шарварок|катавасія
числений=чисельний|числовий
числитися=бути|бути зазначеним|бути вписаним
#читабельний/V    #> виразний|зрозумілий|читний|прочитний
читаючий=що читає|читальний|читач|читальник|читець|читайло
чокатися=цокатися|здоровкатися|з'їхати з глузду|збожеволіти|здуріти|стукнутися|тюкнутися
чолобитна=супліка
чолобитник=жалобник|позовник|позивач|чоломбитько
чтиво=читво
чудачка=дивачка|химерниця
чуть-чуть=ледве-ледве|ледь-ледь|трохи|трішки|трошечки
шаленіючий=що шаленіє|шалений|несамовитий|скажений|нестямний|оскаженілий
шалий=шаленистий|шалений|ошалений|ошелемонілий|ошаленілий|навісний|оглашенний|навіжений|дикий|скажений|біснуватий|нестримний|нарваний|безладний|випадковий
шарик=кулька|бульбашка|балабушка|галка|галочка|болюс
шаровидний=кулястий
шароподібний=кулястий
шатер=намет|шатро|таш|таша
швидкоплаваючий=швидкоплавний
шестидесятник=шістдесятник
шиповник=шипшина
шліфовка=шліфування|шліфовання|вигладжування
шляпка=капелюшок|брилик|головка|шапка
шокіруваний=шокований|вражений
шокуючий=що шокує|шокувальний|разючий|приголомшливий|неймовірний|нечуваний|моторошний
штриховка=штрихування|штриховання|рискування|рисковання
штукатурений=вапнований|тинькований|мазаний
штурмуючий=що штурмує|штурмовий|штурмовик
шукаючий=хто шукає|шукач|шукальник|шукайло|запобігач
шумуючий=що шумує|розшумований|шумлявий|спінений
шунтуючий=що шунтує|шунтувальний
щедрота=щедрість|гойність|щедриня
щепка=тріска|скалка|оскалок|задера|цурпалка|цурпалок|шкаберка
щитовидий=щитуватий
щитовидка=борлакова (щитувата) залоза|щитівка
щитовидний=щитуватий
юстуючий=що юстує|юстувальний|юстувальник
яйник=яєчник
