# Simple replace table for Arabic dialects العامية والدارجة
# Format: word=suggestion1|suggestion2|suggestion3...
# This is only for words that are not caught by spell checker
طرشي=فلفل حلو
فايدة=فائدة
راديو=مذياع
سكانر=ماسح ضوئي
سبيطار=مستشفى
ساندوتش=شطيرة
ماركة=علامة
دفاية=مدفأة
ريجيم=حمية
الريجيم=الحمية
الكورة الأرضية=الكرة الأرضية
البرواز=الإطار
برواز=إطار
أجندة=مُذَكِّرَة|مُفَكِّرَة
إستاد=ملعب
استوديو=مَرْسَمْ
إسفلت=زفت
أكي=مُوَافِقٌ
ألبوم=سِجِلُّ الصور
أنترنت=الشَّابِكة، (وهو المصطلح المعتَمَدُ مِن طرف مكتب تنسيق التعريب عِوَضَ لَفْظَة انترنت).
إنسكلوبيديا=موسوعة|دائرة معارف
انفلونزا=رَشْحَة برد|نزلة برد
أوبرا=مسرحية غنائية
أوتوبيس=حافلة
أوتوماتيكي=تلقائي
باراشوت=مِظَلة الهبوط
بارتاج=مُشاركة
باص=حافلة
بالطو=مِعْطف
بالون=مِنْطاد
بترول=نَفْط
برشامة=مُسْوَدَّة|مُسَوَّدة|كبسولة دواء
بلكون|بلكونة=شُرْفَة
بلكونة|بلكون=شُرفة
بنج=مُخدّر للجراحة
بورتريه=بطاقة فنية|لوحة فنية
بيجامة=مَنَامَة
بيجامة=منامة
ترمس=الزجاجة العازلة (تستعمل لحفظ المشروبات ساخنة أو باردة)
تكاية=مِخَدَّة|وِسادة
تلفون=هاتِف
جيم=إعجاب
خان=فُندق
دوخة=دُوَّار
ديبلوم=شهادة
ديلايت=حذفْ
راديو=مِذياع
رتوش=لَمَسَات
روبرتاج=استطلاع
روتين=رَتَابَة
روكورد=جهاز التسجيل
رومانسية=شاعريَّة
سندويتش=شَطِيرَة
سوبر=عِملاق|خارق
سيناريو=النص السينمائي
شرشف=غِطاء
شلة=ثُلَّة
شهادة الباكالوريوس=شهادة الإجازة
شير=مُشارَكَة
صالة=بَهْو
صالونات=مَجالِس|نَوادي
طابور=زُمْرَة|جماعة|ثُلَّة|طائِفة|حِزْب
طابوهات=محظورات|مُحرمات|مَمنوعات
طاسة=وِعَاء|إنَاء
طبنجة=مُسَدَّسْ
فاتورة=وَرقة الحساب|بَيَانُ الحساب
فحص إكلينيكي=فَحْصٌ سَرِيرِيّ
فلاشة=شَريحة إلكترونية
فيتو=نَقْض
فيش=قَابِس كهربائي|مِشْبَكْ كهربائي
فيلا=دَارَة
كارت=بِطاقة
كرونومتر=مِيقاتة
كشكول=كُرَّاسَة
كلاسيكي=عَتِيق|قديم|بدائي
كنبة=أريكة
كورس=مَطبوع|مُلخص
كومبيوتر=حاسوب
كومنت=تَعْلِيق
لايك=إعجاب
لمبة=مِصباح
ماركة=عَلامَة
مخدة=وِسادة
موديل=نَوْع|نَموذج
هيلكوبتر=طائرة عمودية|مِروحية
ولاعة=قَدَّاحَة
يافطة=لافِتَةُ إِعْلان|لوحة إشهار
البنك=المصرف	كلمة إيطالية عربيها المصرف
بنك=مصرف	كلمة إيطالية عربيها المصرف
الكوبري=الجسر|القنطرة	كوبري كلمة غير عربية، عربيها الجسر أو القنطرة
كوبري=جسر|قنطرة	كوبري كلمة غير عربية، عربيها الجسر أو القنطرة
الفاكس=الناسخ|الناسوخ	الفاكس كلمة أنجليزية، تعريبها الناسوخ
فاكس=ناسخ|ناسوخ	الفاكس كلمة أنجليزية، تعريبها الناسوخ
البنسل=القلم|قلم الرصاص	كلمة إنجليزية Pencil، وعربيها القلم أو قلم الرصاص
بنسل=قلم	كلمة إنجليزية Pencil، وعربيها القلم أو قلم الرصاص
النوتة=المذكرة|المفكرة	كلمة إنجليزية NOTE ، Notebook
النوت بك=المذكرة|المفكرة	كلمة إنجليزية NOTE ، Notebook
نوتة=مذكرة|مفكرة	كلمة إنجليزية NOTE ، Notebook
نوت بك=مذكرة|مفكرة	كلمة إنجليزية NOTE ، Notebook
الديسك=القرص	كلمة إنجليزية Disc
ديسك=قرص	كلمة إنجليزية Disc
الأتوبيس=الحافلة	كلمة إنجليزية Bus
الباص=الحافلة	كلمة إنجليزية Bus
أتوبيس=حافلة	
باص=حافلة	كلمة إنجليزية Bus
الأطلنطي=الأطلسي	فالأطلسي هو الاسم الذي أطلقه عليه العرب، نسبة إلى سلسلة الجبال في شمال إفريقيا
أطلنطي=أطلسي	فالأطلسي هو الاسم الذي أطلقه عليه العرب، نسبة إلى سلسلة الجبال في شمال إفريقيا
الأبلة=المعلمة|المُدَرِّسَة	لأن الأبلة كلمة تركية معناها المعلمة والمدرسة، وهي في اللغة العربية تدل على الثقل والوخامة في الطعام
أبلة=معلمة|مُدَرِّسَة	لأن الأبلة كلمة تركية معناها المعلمة والمدرسة، وهي في اللغة العربية تدل على الثقل والوخامة في الطعام
اليانسون=الأنيسون|الآنسون	كلمة "اليانسون" عامية غير واردة في كتب اللغة
يانسون=أنيسون|آنسون	كلمة "اليانسون" عامية غير واردة في كتب اللغة
المذهب الرومانسي=المذهب الابتداعي	رومانس كلمة غربية، والصواب ما أقره المجمع، فهو عربي
رومانسية=شاعرية	
رومانسي=شاعري	
البيجامة=المنامة	لأن البجامة أو البيجامة كلمة ليست عربية
البجامة=المنامة	لأن البجامة أو البيجامة كلمة ليست عربية
بيجامة=منامة	لأن البجامة أو البيجامة كلمة ليست عربية
بجامة=منامة	لأن البجامة أو البيجامة كلمة ليست عربية
البوفيه=المَقْصِف	لأن "بوفيه" كلمة إنجليزية: Buffet وقد وضع لها كلمة "مَقْصِف"
بوفيه=مَقْصِف	لأن "بوفيه" كلمة إنجليزية: Buffet وقد وضع لها كلمة "مَقْصِف"
البوليس=الشُرَطَة|الشُرَطي|الشُرْطي	إذ كلمة "بوليس" كلمة إنجليزية: Police 
بوليس=شُرَطَة|شُرَطي|شُرْطي	إذ كلمة "بوليس" كلمة إنجليزية: Police 
الدكتاتور=الطاغية|المستبد	فكلمة "دكتاتور" لاتينية الأصل، تطلق على الحكام في الحالات العصيبة 
دكتاتور=طاغية|مستبد	فكلمة "دكتاتور" لاتينية الأصل، تطلق على الحكام في الحالات العصيبة 
الكنبة=الأريكة	فالكنبة أخذتها الفرنسية عن اللاتينية واليونانية، يقول تعالى: "هم وأزواجهم على الأرائك"
كنبة=أريكة	فالكنبة أخذتها الفرنسية عن اللاتينية واليونانية، يقول تعالى: "هم وأزواجهم على الأرائك"
أبجورة=ظُلّة	أبجورة أجنبية والعربي ظُلّة
الأتيكيت=اللصيقة|البطاقة	الأتيكيت فرنسية، واللصيقة أو البطاقة عربي
أتيكيت=لصيقة|بطاقة	الأتيكيت فرنسية، واللصيقة أو البطاقة عربي
الإشارب=الوِشاح|الوُشاح|الإِشاح	فالإشارب هو الاسم الفرنسي المعرب
إشارب=وِشاح|وُشاح|إِشاح	فالإشارب هو الاسم الفرنسي المعرب
ألبوم=مجموعة الصور	فالألبوم اسم معرّب من اللغات الإنجليزية والفرنسية والألمانية
أوتوماتيك=تلقائية|آلي	تلقائي، آلي
البدروم=السرداب	بدرون وبدروم اسمان فارسيان معربان من "بيدون"
البدرون=السرداب	بدرون وبدروم اسمان فارسيان معربان من "بيدون"
بدروم=سرداب	بدرون وبدروم اسمان فارسيان معربان من "بيدون"
بدرون=سرداب	بدرون وبدروم اسمان فارسيان معربان من "بيدون"
الباروكة=الشعر المستعار	فالباروكة اسم فرنسي معرّب: Perruque
باروكة=شعر المستعار	فالباروكة اسم فرنسي معرّب: Perruque
البروتوكول=العرف|المراسم	لأن البروتوكول كلمة إغريقية
بروتوكول=عرف|مراسم	لأن البروتوكول كلمة إغريقية
بروفات=تجربة|تجارب	فالبروفة كلمة أعجمية
بروفة=تجربة|تجارب	فالبروفة كلمة أعجمية
بس=حسبك|اكففْ|مَهْ	فكلمة "بَسْ" فارسية الأصل
البلكون=الشُّرْفَة	الاسم المعرّب
بلكون=شُرْفَة	الاسم المعرّب
البند=المادة|الفقرة	لأن كلمة "بند" فارسية معربة
بند=مادة|فقرة	لأن كلمة "بند" فارسية معربة
البنوار=المقصورة الأولى	بَنوار اسم فرنسي معرّب
بنوار=مقصورة الأولى	بَنوار اسم فرنسي معرّب
البيبرون=الرضّاعة	البيبرون اسم فرنسي معرّب
بيبرون=رضّاعة	البيبرون اسم فرنسي معرّب
البيسين=مسبح	البيسين الاسم الفرنسي المعرّب
بيسين=مسبح	البيسين الاسم الفرنسي المعرّب
التراتوار=الرَّصِيف	التراتوار الاسم الفرنسي المعرّب
تراتوار=رَصِيف	التراتوار الاسم الفرنسي المعرّب
الترموس=الزجاجة العازلة|كاظمة|كظيمة	اسم أجنبي معرّب
الترمس=الزجاجة العازلة|كاظمة|كظيمة	اسم أجنبي معرّب
ترموس=زجاجة العازلة	اسم أجنبي معرّب
ترمس=زجاجة العازلة	اسم أجنبي معرّب
الترمومتر=ميزان الحرارة|مِحْرَار	الترمومتر اسم معرّب
ترمومتر=ميزان الحرارة|مِحْرَار	الترمومتر اسم معرّب
التلسكوب=مِرْقَب|مِنْظار|مقراب	الاسم الذي أطلقه مجمع اللغة العربية بالقاهرة
تلسكوب=مِرْقَب|مِنْظار|مقراب	الاسم الذي أطلقه مجمع اللغة العربية بالقاهرة
الجاكيت=الرِّدَاء|السُّتْرَة	الجاكيت هو الاسم المعرب عن اللغة الفرنسية
جاكيت=رِدَاء|سُتْرَة	الجاكيت هو الاسم المعرب عن اللغة الفرنسية
دبلوم=شهادة|إجازة	حيث إن الدبلوم كلمة من الدخيل
الدسك=الطَّبَق	طَبَق" الغضروف بين كل فقرتين من فقار الظهر
الدسك=طَبَق	"طَبَق" الغضروف بين كل فقرتين من فقار الظهر
الدوبلاج=دبلجة	دبلجة أو ازدواج
دوبلاج=دبلجة	دبلجة أو ازدواج
الفايل=الملف|الإضبارة	لأن الدوسييه اسم فرنسي "dossier" والفايل كلمة إنجليزية "file
الدوسييه=الملف|الإضبارة	لأن الدوسييه اسم فرنسي "dossier" والفايل كلمة إنجليزية "file"
فايل=ملف|إضبارة	لأن الدوسييه اسم فرنسي "dossier" والفايل كلمة إنجليزية "file"
دوسييه=ملف|إضبارة	لأن الدوسييه اسم فرنسي "dossier" والفايل كلمة إنجليزية "file"
دولاب=خِزانة	الخزانة أفضل
رجيم=حِمْيَة	
الروتين=الرَّتابَة	
روتين=رَتابَة	
الريبورتاج=التحقيق الصُّحُفي|التقرير الصحفي	
ربورتاج=التحقيق الصُّحُفي|التقرير الصحفي|الاستطلاع	
ريبورتاج=تحقيق صُحُفي|تقرير صحفي|استطلاع	
السرفيس=الطَّقْم	
سرفيس=طَقْم	
سراي=دار	فأصل كلمة "سراي" من سرايا جمع سرية، وهي قطعة من الجيش
السكرتير=الأمين|أمين السر|كاتب السر	فكلمة سكرتير كلمة معرّبة
سكرتير=أمين	فكلمة سكرتير كلمة معرّبة
السيفون=صُنْدُوق الطَّرْد	
سيفون=صُنْدُوق الطَّرْد	
الطربيد=النَّسِيفَة	كلمة "الطُّربيد" من أصل لاتيني
طربيد=نَسِيفَة	كلمة "الطُّربيد" من أصل لاتيني
الكباريه=الملهى الليلي	اسم فرنسي معرّب
كباريه=ملهى الليلي	اسم فرنسي معرّب
القاشاني=الخزف المصقول	
القيشاني=الخزف المصقول	
قاشاني=خزف المصقول	
قيشاني=خزف المصقول	
الكابين=المقصورة	اسم فرنسي وإنجليزي معرّب
كابين=مقصورة	اسم فرنسي وإنجليزي معرّب
كرباج=سوط	كلمة دخيلة على اللغة العربية
الكراج=حظيرة السيارات|المِرْأَب	اسم إنجليزي وفرنسي معرّب
كراج=مِرْأَب	اسم إنجليزي وفرنسي معرّب
مرجيحة=أًرْجُوحَة	
الكازينو=النادي	
كازينو=نادي	
الكلوروفيل=اليَخْضُور	
كلوروفيل=يَخْضُور	
الكمبارس=ممثل ثانوي	اسم فرنسي معرّب
كمبارس=ممثل ثانوي	اسم فرنسي معرّب
الكومودينو=الصِّوانة	
كومودينو=صِوانة	
اللوج=المقصورة الثانية	
لوج=مقصورة ثانية	
الماكيت=نموذج|مُجَسَّم	اسم فرنسي معرّب
ماكيت=نموذج|مُجَسَّم	اسم فرنسي معرّب
المانشيت=العنوان الرئيس	اسم فرنسي معرّب
مانشيت=عنوان الرئيس	اسم فرنسي معرّب
المايسترو=قائد الجوق	اسم أعجمي معرّب
مايسترو=قائد الجوق	اسم أعجمي معرّب
الميلودراما=المَشْجَاة	
الميلودرام=المَشْجَاة	
ميلودراما=مَشْجَاة	
ميلودرام=مَشْجَاة	
الجرسون=النّادل	لأنه اسم فرنسي معرّب
جرسون=نادل	لأنه اسم فرنسي معرّب
النقانق=السُّجُق	
نقانق=سُجُق	
النوتة=النصّ الموسيقيّ	
نوتة=نصّ الموسيقيّ	
النيجاتيف=السَّلْبِيَّة	الصورة السلبية
نيجاتيف=سَلْبِيَّة	الصورة السلبية
ولاعة=قدّاحة	
الأرشيف=المحفوظات	أصل الكلمة إنجليزي هو Archive
أرشيف=محفوظات	أصل الكلمة إنجليزي هو Archive
الروتين=الرتابة|التكرار	أصل الكلمة إنجليزي هو Routine
روتين=رتابة|تكرار	أصل الكلمة إنجليزي هو Routine
الكمبيوتر=الحاسوب	أصل الكلمة إنجليزي هو Computer
كمبيوتر=حاسوب	أصل الكلمة إنجليزي هو Computer
السمنار=حلقة البحث|يوم دراسي|لقاء علمي|ندوة	السمنار كلمة غير عربية، اسم علم
سمنار=حلقة البحث|يوم دراسي|لقاء علمي|ندوة	السمنار كلمة غير عربية، اسم علم
كوادر=إطار|أُطُر	ف "كادر" كلمة فرنسية، عربيها الإطار، جمعه أطر
كادر=إطار|أُطُر	ف "كادر" كلمة فرنسية، عربيها الإطار، جمعه أطر
دكتاتور=جبّار|حكم جباريّ	دكتاتور كلمة غير عربية، عربيها المستبد أو الجبار
دكتاتوري=جبّار|حكم جباريّ	دكتاتور كلمة غير عربية، عربيها المستبد أو الجبار
فيزا=تأشيرة|إذن دخول	لأن كلمة "فيزا: Visa" كلمة إنجليزية
التكنولوجيا=التِقَانَة	كلمة "تكنولوجيا كلمة إنجليزية، يقابلها في العربية تِقانة على وزن "فِعالة"، و"التِّقني، التِّقنية".من "تِقْن" أي حاذق 
تكنولوجيا=تِقَانَة	كلمة "تكنولوجيا كلمة إنجليزية، يقابلها في العربية تِقانة على وزن "فِعالة"، و"التِّقني، التِّقنية".من "تِقْن" أي حاذق 
