# @author Susana Sotelo
#
# Replace incorrect words
# Format:
#
# incorrect=correct

achádego=achado
achádegos=achados
aeroxenerador=aeroxerador
aeroxeneradores=aeroxeradores
alexada=afastada
alexadas=afastadas
alexado=afastado
alexados=afastados
alomenos=polo menos
ambente=ambiente
ambentes=ambientes
andacio=andazo
andacios=andazos
anque=aínda que
asimesmo=así mesmo
asinatura=sinatura
asinaturas=sinaturas
bacherelato=bacharelato
bacherelatos=bacharelatos
callejero=rueiro
callejeros=rueiros
caluroso=caloroso
calurosa=calorosa
calurosos=calorosos
calurosas=calorosas
carátula=cuberta
carátulas=cubertas
caxeado=encaixamento
caxeados=encaixamentos
cofeitos=subornos
cofeito=suborno
convinte=conveniente
convintes=convenientes
entonces=entón
estreñimento=estrinximento
estreñimentos=estrinximentos
lexanía=distancia
lexanías=distancias
lexía=lixivia
lexías=lixivias
maiordomo=mordomo
maiordomos=mordomos
malhumor=mal humor
malhumores=malos humores
mediciña=medicina
mediciñas=medicinas
mentras=mentres
partixa=partilla
partixas=partillas
soxa=soia
soxas=soias
varnices=vernices
varniz=verniz
vasixas=vasillas
vasixa=vasilla
verquidos=verteduras
verquido=vertedura
xaula=gaiola
xaulas=gaiolas
