# A part-of-speech dictionary that's used additionally to the binary dictionary (*.dict).
# This does not add words to the spell checker, see hunspell/spelling.txt for that.
# File Encoding: UTF-8
# Format: three tab-separated fields: fullform baseform postags
Aba	Aba	NNP
Aguilar	Aguilar	NNP
Aguirre	Aguirre	NNP
Ally	Ally	NNP
Automattic	Automattic	NNP
Baines	Baines	NNP
Barrera	Barrera	NNP
Bash	Bash	NNP
Bellarmine	Bellarmine	NNP
Belzoni	Belzoni	NNP
Bergren	Bergren	NNP
Bevington	Bevington	NNP
Boas	Boas	NNP
Boasson	Boasson	NNP
Bollman	Bollman	NNP
Bourke	Bourke	NNP
Brampton	Brampton	NNP
Brand	Brand	NNP
Burnet	Burnet	NNP
CAPEX	CAPEX	NN:U
Caplan	Caplan	NNP
Cardona	Cardona	NNP
Clarendon	Clarendon	NNP
Coen	Coen	NNP
Crombie	Crombie	NNP
Culley	Culley	NNP
Eckmann	Eckmann	NNP
Elson	Elson	NNP
Equifax	Equifax	NNP
Equilar	Equilar	NNP
Erlenmeyer	Erlenmeyer	NNP
Experian	Experian	NNP
Feeley	Feeley	NNP
Fisch	Fisch	NNP
Fischer-Dieskau	Fischer-Dieskau	NNP
Francia	Francia	NNP
Francian	Francian	JJ
Francian	Francian	NN
Francians	Francian	NNS
Funston	Funston	NNP
Guerin	Guerin	NNP
Guérin	Guérin	NNP
Harkins	Harkins	NNP
Healthline	Healthline	NNP
Heinsius	Heinsius	NNP
Henn	Henn	NNP
Henton	Henton	NNP
Hole	Hole	NNP
Hoopes	Hoopes	NNP
Hornick	Hornick	NNP
Huck	Huck	NNP
Huckabee	Huckabee	NNP
Jade	Jade	NNP
Kang	Kang	NNP
Karlin	Karlin	NNP
Kasper	Kasper	NNP
Keeley	Keeley	NNP
Keyser	Keyser	NNP
Klinger	Klinger	NNP
Koren	Koren	NNP
Leavitt	Leavitt	NNP
Levenson	Levenson	NNP
MacKay	MacKay	NNP
Malina	Malina	NNP
Mar	Mar	NNP
Marcelino	Marcelino	NNP
Marcionism	Marcionism	NN:U
Marcionite	Marcionite	NN
Marcionites	Marcionite	NNS
Maslin	Maslin	NNP
Maxima	Maxima	NNP
McGinty	McGinty	NNP
Meador	Meador	NNP
Mercutio	Mercutio	NNP
Mosier	Mosier	NNP
Myer	Myer	NNP
Norm	Norm	NNP
O'Sullivan	O'Sullivan	NNP
Occitan	Occitan	JJ
Ohlone	Ohlone	NN
Ohlone	Ohlone	NNP
Ohlones	Ohlone	NNS
Ortega	Ortega	NNP
Padilla	Padilla	NNP
Parra	Parra	NNP
Patel	Patel	NNP
Pearse	Pearse	NNP
Pendragon	Pendragon	NNP
Peoples	Peoples	NNP
Perizzite	Perizzite	NN
Perizzites	Perizzite	NNS
Punxsutawney	Punxsutawney	NNP
Ravens	Ravens	NNPS
Romero	Romero	NNP
Scheel	Scheel	NNP
Schein	Schein	NNP
Schengen	Schengen	NNP
Scherman	Scherman	NNP
Shaner	Shaner	NNP
Shimoni	Shimoni	NNP
Shulman	Shulman	NNP
Siebert	Siebert	NNP
Silber	Silber	NNP
Splunk	Splunk	NNP
Trumpian	Trumpian	JJ
Trumpist	Trumpist	JJ
Trumpist	Trumpist	NN
Trumpists	Trumpist	NNS
Tufts	Tufts	NNP
Tuskegee	Tuskegee	NNP
U	U	NN
Wallick	Wallick	NNP
Wasson	Wasson	NNP
Wehner	Wehner	NNP
Wiesel	Wiesel	NNP
Wiesenthal	Wiesenthal	NNP
Wilkison	Wilkison	NNP
Willison	Willison	NNP
YoY	YoY	RB
alpha-ketoglutarate	alpha-ketoglutarate	NN
alpha-ketoglutarates	alpha-ketoglutarate	NNS
alpha-ketoglutaric	alpha-ketoglutaric	JJ
alphaketoglutarate	alphaketoglutarate	NN
alphaketoglutarates	alphaketoglutarate	NNS
antiblackness	antiblackness	NN:U
antiwhiteness	antiwhiteness	NN:U
apostille	apostille	NN
apostilles	apostille	NNS
approximant	approximant	NN
approximants	approximant	NNS
backdown	backdown	NN
backdowns	backdown	NNS
bas-reliefs	bas-relief	NNS
beta-lactamases	beta-lactamase	NNS
bispecific	bispecific	NN
bispecifics	bispecific	NNS
boondoggle	boondoggle	NN
boondoggles	boondoggle	NNS
burnet	burnet	NN
burnets	burnet	NNS
caesian	caesian	JJ
camlet	camlet	NN
camlets	camlet	NNS
capex	capex	NN:U
cardiometabolic	cardiometabolic	JJ
cesian	cesian	JJ
client-server	client-server	JJ
client-side	client-side	JJ
climbdown	climbdown	NN
climbdowns	climbdown	NNS
commentariat	commentariat	NN
commentariats	commentariat	NNS
consuetudinaries	consuetudinary	NNS
consuetudinary	consuetudinary	NN
coproduction	coproduction	NN
coproductions	coproduction	NNS
counsel	counsel	NNS
court-martial	court-martial	NN
court-martials	court-martial	NNS
cowpat	cowpat	NN
cowpats	cowpat	NNS
crisscross	crisscross	NN:UN
crisscrosses	crisscross	NNS
cushion	cushion	NN:UN
cut-throat	cut-throat	JJ
cut-throat	cut-throat	NN
cut-throats	cut-throat	NNS
cutthroat	cutthroat	JJ
de-risk	de-risk	VB
de-risk	de-risk	VBP
de-risked	de-risk	VBD
de-risked	de-risk	VBN
de-risking	de-risk	VBG
de-risks	de-risk	VBZ
decarboxylation	decarboxylation	NN:UN
decarboxylations	decarboxylation	NNS
deoxyribonucleic	deoxyribonucleic	JJ
diethyl	diethyl	NN:UN
diethylamide	diethylamide	NN
diethylamides	diethylamide	NNS
diethylethanolamine	diethylethanolamine	NN
diethylethanolamines	diethylethanolamine	NNS
diethylpropion	diethylpropion	NN:U
diethyls	diethyl	NNS
diethylstilbestrol	diethylstilbestrol	NN:UN
diethylstilbestrols	diethylstilbestrol	NNS
diethylstilboestrol	diethylstilboestrol	NN:UN
diethylstilboestrols	diethylstilboestrol	NNS
diffusional	diffusional	JJ
dimethylacetal	dimethylacetal	NN
dimethylacetals	dimethylacetal	NNS
diss	diss	NN
disses	diss	NNS
disulfide	disulfide	NN
disulfides	disulfide	NNS
dog-teeth	dog-tooth	NNS
dog-tooth	dog-tooth	NN
dogtooth	dogtooth	NN
dogtooths	dogtooth	NNS
donationware	donationware	NN:U
doom-scrolling	doom-scrolling	NN:U
doomscrolling	doomscrolling	NN:U
drool	drool	NN:UN
dropkick	dropkick	NN
dropkicker	dropkicker	NN
dropkickers	dropkicker	NNS
dropkicks	dropkick	NNS
dysmorphia	dysmorphia	NN:UN
dysmorphias	dysmorphia	NNS
elasticated	elasticated	JJ
emphasis	emphasis	NN:UN
eyrie	eyrie	JJ
feel-good	feel-good	JJ
feelgood	feelgood	JJ
financials	financials	NNS
finetune	finetune	VB
finetune	finetune	VBP
finetuned	finetune	VBD
finetuned	finetune	VBN
finetunes	finetune	VBZ
finetuning	finetune	VBG
first-hand	first-hand	JJ
four-limbed	four-limbed	JJ
gendering	gendering	NN
genderings	gendering	NNS
go-around	go-around	NN
go-arounds	go-around	NNS
high-five	high-five	NN
high-fives	high-five	NNS
hydrolysis	hydrolysis	NN:UN
hypoechoic	hypoechoic	JJ
hypoglycaemic	hypoglycaemic	NN
hypoglycaemics	hypoglycaemic	NNS
hypoglycemic	hypoglycemic	NN
hypoglycemics	hypoglycemic	NNS
isocitrate	isocitrate	NN
isocitrates	isocitrate	NNS
ketoglutarate	ketoglutarate	NN
ketoglutarates	ketoglutarate	NNS
ketoglutaric	ketoglutaric	JJ
kludge	kludge	NN
kludges	kludge	NNS
lockup	lockup	NN
lockups	lockup	NNS
mIRC	mIRC	NNP
malus	malus	NN
maluses	malus	NNS
marathoning	marathoning	NN:U
metadescription	metadescription	NN
metadescriptions	metadescription	NNS
metadescriptive	metadescriptive	JJ
microtrauma	microtrauma	NN
microtraumas	microtrauma	NNS
moissanite	moissanite	NN
moissanites	moissanite	NNS
morganite	morganite	NN:UN
morganites	morganite	NNS
multimode	multimode	JJ
neurodevelopment	neurodevelopment	NN:U
neurodivergent	neurodivergent	JJ
neurodivergent	neurodivergent	NN
neurodivergents	neurodivergent	NNS
non-disclosure	non-disclosure	NN
non-disclosures	non-disclosure	NNS
non-exempt	non-exempt	JJ
non-fulfillment	non-fulfillment	NN:U
non-fulfilment	non-fulfilment	NN:U
non-fulfilments	non-fulfilment	NNS
non-integer	non-integer	NN
non-integers	non-integer	NNS
non-local	non-local	JJ
non-polluting	non-polluting	JJ
noncapitalisable	noncapitalisable	JJ
noncapitalizable	noncapitalizable	JJ
nondisclosure	nondisclosure	NN
nondisclosures	nondisclosure	NNS
nonexempt	nonexempt	JJ
nonfulfillment	nonfulfillment	NN:U
nonfulfilment	nonfulfilment	NN:U
nonfulfilments	nonfulfilment	NNS
noninteger	noninteger	NN
nonintegers	noninteger	NNS
nonpartisan	nonpartisan	JJ
nonpolluting	nonpolluting	JJ
nonwhite	nonwhite	JJ
nuptialities	nuptiality	NNS
nuptiality	nuptiality	NN:UN
off-hand	off-hand	JJ
outclimb	outclimb	VB
outclimb	outclimb	VBP
outclimbed	outclimb	VBD
outclimbed	outclimb	VBN
outclimbing	outclimb	VBG
outclimbs	outclimb	VBZ
outdrive	outdrive	NN
outdrives	outdrive	NNS
overvote	overvote	NN
overvotes	overvote	NNS
parenchyma	parenchyma	NN:UN
parenchymas	parenchyma	NNS
parenchymata	parenchyma	NNS
pentasulphide	pentasulphide	NN
pentasulphides	pentasulphide	NNS
photosynthesis	photosynthesis	NN:UN
polysulphide	polysulphide	NN
polysulphides	polysulphide	NNS
preorder	preorder	NN
preorder	preorder	VB
preorder	preorder	VBP
preordered	preorder	VBD
preordered	preorder	VBN
preordering	preorder	VBG
preorders	preorder	NNS
preorders	preorder	VBZ
prepetition	prepetition	JJ
prosopographical	prosopographical	JJ
prosopographically	prosopographically	RB
prosopographies	prosopography	NNS
prosopography	prosopography	NN
psychoeducation	psychoeducation	NN:U
punditocracies	punditocracy	NNS
punditocracy	punditocracy	NN
radiotelephone	radiotelephone	NN
radiotelephones	radiotelephone	NNS
radiotelephony	radiotelephony	NN:U
re-emphasis	re-emphasis	NN:UN
religious	religious	NN
religious	religious	NNS
resource	resource	VB
resource	resource	VBP
resourced	resource	VBD
resourced	resource	VBN
resources	resource	VBZ
resourcing	resource	VBG
riff-raff	riff-raff	NN
riff-raffs	riff-raff	NNS
riffraff	riffraff	NN
riffraffs	riffraff	NNS
ring-fence	ring-fence	VB
ring-fence	ring-fence	VBP
ring-fenced	ring-fence	VBD
ring-fenced	ring-fence	VBN
ring-fences	ring-fence	VBZ
ring-fencing	ring-fence	VBG
ringfence	ringfence	NN
ringfence	ringfence	VB
ringfence	ringfence	VBP
ringfenced	ringfence	VBD
ringfenced	ringfence	VBN
ringfences	ringfence	NNS
ringfences	ringfence	VBZ
ringfencing	ringfence	VBG
server-side	server-side	JJ
serverless	serverless	JJ
shinbone	shinbone	NN
shinbones	shinbone	NNS
singlehanded	singlehanded	JJ
singlehanded	singlehanded	RB
singlehandedly	singlehandedly	RB
singlehandedness	singlehandedness	NN:U
sit-down	sit-down	NN
sit-downs	sit-down	NNS
sizzle	sizzle	NN:UN
smarty-pants	smarty-pants	NN
smarty-pants	smarty-pants	NNS
smartypants	smartypants	NN
smartypants	smartypants	NNS
staff	staff	NNS
stilbestrol	stilbestrol	NN:UN
stilbestrols	stilbestrol	NNS
stilboestrol	stilboestrol	NN:UN
stilboestrols	stilboestrol	NNS
strong-limbed	strong-limbed	JJ
subbranch	subbranch	NN
subbranches	subbranch	NNS
submachine	submachine	NN
submachines	submachine	NNS
sulfapyridine	sulfapyridine	NN:UN
sulfapyridines	sulfapyridine	NNS
sulfide	sulfide	NN:UN
sulfides	sulfide	NNS
tetrasulphide	tetrasulphide	NN
tetrasulphides	tetrasulphide	NNS
thighbone	thighbone	NN
thighbones	thighbone	NNS
ticktock	ticktock	NN
ticktocks	ticktock	NNS
time-server	time-server	NN
time-servers	time-server	NNS
timeserver	timeserver	NN
timeservers	timeserver	NNS
torr	torr	NNS
transgender	transgender	NN
transgender	transgender	VB
transgender	transgender	VBP
transgendered	transgender	VBD
transgendered	transgender	VBN
transgendering	transgender	VBG
transgenderist	transgenderist	NN
transgenderists	transgenderist	NNS
transgenders	transgender	NNS
transgenders	transgender	VBZ
transmembrane	transmembrane	JJ
twice-weekly	twice-weekly	JJ
two-time	two-time	JJ
uncapitalisable	uncapitalisable	JJ
uncapitalizable	uncapitalizable	JJ
uncommittable	uncommittable	JJ
under-represent	under-represent	VB
under-represent	under-represent	VBP
under-representation	under-representation	NN:UN
under-representations	under-representation	NNS
under-represented	under-represent	VBD
under-represented	under-represent	VBN
under-representing	under-represent	VBG
under-represents	under-represent	VBZ
underrepresent	underrepresent	VB
underrepresent	underrepresent	VBP
underrepresentation	underrepresentation	NN:UN
underrepresentations	underrepresentation	NNS
underrepresented	underrepresent	VBD
underrepresented	underrepresent	VBN
underrepresenting	underrepresent	VBG
underrepresents	underrepresent	VBZ
undervote	undervote	NN
undervotes	undervote	NNS
uroepithelia	uroepithelium	NNS
uroepithelial	uroepithelial	JJ
uroepithelium	uroepithelium	NN
white-out	white-out	NN:UN
white-outs	white-out	NNS
whiteout	whiteout	NN:UN
whiteouts	whiteout	NNS
zander	zander	NN
zander	zander	NNS
zanders	zander	NNS
