# added postag entries
#-------------------------------------------------------------------------------
# Do not add words here, but report them to languagetool@taaltik.nl
#-------------------------------------------------------------------------------
aanvalsvaardigheden	aanvalsvaardigheden	ZNW:MRV:DE_
adviseursvaardigheden	adviseursvaardigheden	ZNW:MRV:DE_
altaarbenodigdheden	altaarbenodigdheden	ZNW:MRV:DE_
aquariumbenodigdheden	aquariumbenodigdheden	ZNW:MRV:DE_
assertiviteitsvaardigheden	assertiviteitsvaardigheden	ZNW:MRV:DE_
auditvaardigheden	auditvaardigheden	ZNW:MRV:DE_
autokrik	autokrik	ZNW:EKV:DE_
badkamerbenodigdheden	badkamerbenodigdheden	ZNW:MRV:DE_
bakkerijbenodigdheden	bakkerijbenodigdheden	ZNW:MRV:DE_
bakkersbenodigdheden	bakkersbenodigdheden	ZNW:MRV:DE_
baltovenaar	baltovenaar	ZNW:EKV:DE_
banketbakkersbenodigdheden	banketbakkersbenodigdheden	ZNW:MRV:DE_
basisauditvaardigheden	basisauditvaardigheden	ZNW:MRV:DE_
basketbalvaardigheden	basketbalvaardigheden	ZNW:MRV:DE_
bedrijfsbenodigdheden	bedrijfsbenodigdheden	ZNW:MRV:DE_
behangbenodigdheden	behangbenodigdheden	ZNW:MRV:DE_
beleidsvaardigheden	beleidsvaardigheden	ZNW:MRV:DE_
bijhorigheden	bijhorigheden	ZNW:MRV:DE_
bladvoeding	bladvoeding	ZNW:EKV:DE_
boerderijbenodigdheden	boerderijbenodigdheden	ZNW:MRV:DE_
boerenvaardigheden	boerenvaardigheden	ZNW:MRV:DE_
boomkwekerijbenodigdheden	boomkwekerijbenodigdheden	ZNW:MRV:DE_
boordbenodigdheden	boordbenodigdheden	ZNW:MRV:DE_
borduurbenodigdheden	borduurbenodigdheden	ZNW:MRV:DE_
bov	bov	ZNW:EKV:DE_
bovengang	bovengang	ZNW:EKV:DE_
brandweerbenodigdheden	brandweerbenodigdheden	ZNW:MRV:DE_
brouwvaardigheden	brouwvaardigheden	ZNW:MRV:DE_
bruidssluiertjes	bruidssluier	ZNW:MRV:VRK:DE_
budgetvaardigheden	budgetvaardigheden	ZNW:MRV:DE_
bureaubenodigdheden	bureaubenodigdheden	ZNW:MRV:DE_
burgervaardigheden	burgervaardigheden	ZNW:MRV:DE_
businesspark	businesspark	ZNW:EKV:HET
campingbenodigdheden	campingbenodigdheden	ZNW:MRV:DE_
candela	candela	ZNW:EKV:DE_
cateringbenodigdheden	cateringbenodigdheden	ZNW:MRV:DE_
circusvaardigheden	circusvaardigheden	ZNW:MRV:DE_
clownsneus	clownsneus	ZNW:EKV:DE_
commandovaardigheden	commandovaardigheden	ZNW:MRV:DE_
computerbenodigdheden	computerbenodigdheden	ZNW:MRV:DE_
conflicthanteringsvaardigheden	conflicthanteringsvaardigheden	ZNW:MRV:DE_
counselingvaardigheden	counselingvaardigheden	ZNW:MRV:DE_
cursusbenodigdheden	cursusbenodigdheden	ZNW:MRV:DE_
dataoverdracht	dataoverdracht	ZNW:EKV:DE_
deponie	deponie	ZNW:EKV:DE_
derboeka	derboeka	ZNW:EKV:DE_
designvaardigheden	designvaardigheden	ZNW:MRV:DE_
diabetesbenodigdheden	diabetesbenodigdheden	ZNW:MRV:DE_
dialectband	dialectband	ZNW:EKV:DE_
dialoogvaardigheden	dialoogvaardigheden	ZNW:MRV:DE_
dierenbenodigdheden	dierenbenodigdheden	ZNW:MRV:DE_
docentenvaardigheden	docentenvaardigheden	ZNW:MRV:DE_
douchebenodigdheden	douchebenodigdheden	ZNW:MRV:DE_
draagolie	draagolie	ZNW:EKV:DE_
drukkerijbenodigdheden	drukkerijbenodigdheden	ZNW:MRV:DE_
duovoorzitterschap	duovoorzitterschap	ZNW:EKV:HET
dysfemisme	dysfemisme	ZNW:EKV:HET
engineeringvaardigheden	engineeringvaardigheden	ZNW:MRV:DE_
ervaringsvaardigheden	ervaringsvaardigheden	ZNW:MRV:DE_
escrow	escrow	ZNW:EKV:DE_
etenswaardigheden	etenswaardigheden	ZNW:MRV:DE_
examenvaardigheden	examenvaardigheden	ZNW:MRV:DE_
experimenteervaardigheden	experimenteervaardigheden	ZNW:MRV:DE_
feedbackvaardigheden	feedbackvaardigheden	ZNW:MRV:DE_
feestbenodigdheden	feestbenodigdheden	ZNW:MRV:DE_
fietsbenodigdheden	fietsbenodigdheden	ZNW:MRV:DE_
fotografiebenodigdheden	fotografiebenodigdheden	ZNW:MRV:DE_
functievaardigheden	functievaardigheden	ZNW:MRV:DE_
garagebenodigdheden	garagebenodigdheden	ZNW:MRV:DE_
geheugenvaardigheden	geheugenvaardigheden	ZNW:MRV:DE_
gehoorvaardigheden	gehoorvaardigheden	ZNW:MRV:DE_
grammaticavaardigheden	grammaticavaardigheden	ZNW:MRV:DE_
grassoort	grassoort	ZNW:EKV:DE_
handbalvaardigheden	handbalvaardigheden	ZNW:MRV:DE_
handelsminderheden	handelsminderheden	ZNW:MRV:DE_
handwerkbenodigdheden	handwerkbenodigdheden	ZNW:MRV:DE_
handwerkvaardigheden	handwerkvaardigheden	ZNW:MRV:DE_
handycam	handycam	ZNW:EKV:DE_
havenmuur	havenmuur	ZNW:EKV:DE_
hengelbenodigdheden	hengelbenodigdheden	ZNW:MRV:DE_
hondenbenodigdheden	hondenbenodigdheden	ZNW:MRV:DE_
honkbalvaardigheden	honkbalvaardigheden	ZNW:MRV:DE_
horecabenodigdheden	horecabenodigdheden	ZNW:MRV:DE_
horecavaardigheden	horecavaardigheden	ZNW:MRV:DE_
hotelbenodigdheden	hotelbenodigdheden	ZNW:MRV:DE_
houdingsvaardigheden	houdingsvaardigheden	ZNW:MRV:DE_
huisdierbenodigdheden	huisdierbenodigdheden	ZNW:MRV:DE_
huishoudbenodigdheden	huishoudbenodigdheden	ZNW:MRV:DE_
iedereen	iedereen	VNW:OBP:EKV
iemand	iemand	VNW:OBP:EKV
iets	iets	VNW:OBP:EKV
imkerbenodigdheden	imkerbenodigdheden	ZNW:MRV:DE_
immigrantenminderheden	immigrantenminderheden	ZNW:MRV:DE_
inkoopvaardigheden	inkoopvaardigheden	ZNW:MRV:DE_
innovatievaardigheden	innovatievaardigheden	ZNW:MRV:DE_
inspectievaardigheden	inspectievaardigheden	ZNW:MRV:DE_
installatiebenodigdheden	installatiebenodigdheden	ZNW:MRV:DE_
instructeursvaardigheden	instructeursvaardigheden	ZNW:MRV:DE_
integratievaardigheden	integratievaardigheden	ZNW:MRV:DE_
interactievaardigheden	interactievaardigheden	ZNW:MRV:DE_
interieurbenodigdheden	interieurbenodigdheden	ZNW:MRV:DE_
internetbenodigdheden	internetbenodigdheden	ZNW:MRV:DE_
internethit	internethit	ZNW:EKV:DE_
isolatieband	isolatieband	ZNW:EKV
juweliersbenodigdheden	juweliersbenodigdheden	ZNW:MRV:DE_
kabelbenodigdheden	kabelbenodigdheden	ZNW:MRV:DE_
kalfshaas	kalfshaas	ZNW:EKV:DE_
kampeerbenodigdheden	kampeerbenodigdheden	ZNW:MRV:DE_
kantinebenodigdheden	kantinebenodigdheden	ZNW:MRV:DE_
kantoorbenodigdheden	kantoorbenodigdheden	ZNW:MRV:DE_
kapitaalbenodigdheden	kapitaalbenodigdheden	ZNW:MRV:DE_
kappersbenodigdheden	kappersbenodigdheden	ZNW:MRV:DE_
kappersvaardigheden	kappersvaardigheden	ZNW:MRV:DE_
kattenbenodigdheden	kattenbenodigdheden	ZNW:MRV:DE_
kerkbrand	kerkbrand	ZNW:EKV:DE_
keukenbenodigdheden	keukenbenodigdheden	ZNW:MRV:DE_
klantvaardigheden	klantvaardigheden	ZNW:MRV:DE_
klassenmap	klassenmap	ZNW:EKV:DE_
klautervaardigheden	klautervaardigheden	ZNW:MRV:DE_
kleurbenodigdheden	kleurbenodigdheden	ZNW:MRV:DE_
knutselbenodigdheden	knutselbenodigdheden	ZNW:MRV:DE_
knutselvaardigheden	knutselvaardigheden	ZNW:MRV:DE_
koffiebenodigdheden	koffiebenodigdheden	ZNW:MRV:DE_
korfbalvaardigheden	korfbalvaardigheden	ZNW:MRV:DE_
krabbenmand	krabbenmand	ZNW:EKV:DE_
kunstenaarsvaardigheden	kunstenaarsvaardigheden	ZNW:MRV:DE_
kweekbenodigdheden	kweekbenodigdheden	ZNW:MRV:DE_
kwekerijbenodigdheden	kwekerijbenodigdheden	ZNW:MRV:DE_
landbouwbenodigdheden	landbouwbenodigdheden	ZNW:MRV:DE_
landbouwvaardigheden	landbouwvaardigheden	ZNW:MRV:DE_
landschap	landschap	ZNW:EKV:HET
legionella	legionella	ZNW:EKV:DE_
leidersvaardigheden	leidersvaardigheden	ZNW:MRV:DE_
levensbenodigdheden	levensbenodigdheden	ZNW:MRV:DE_
loopbaanvaardigheden	loopbaanvaardigheden	ZNW:MRV:DE_
lunchbenodigdheden	lunchbenodigdheden	ZNW:MRV:DE_
machinebenodigdheden	machinebenodigdheden	ZNW:MRV:DE_
magazijnbenodigdheden	magazijnbenodigdheden	ZNW:MRV:DE_
marshal	marshal	ZNW:EKV:DE_
massagebenodigdheden	massagebenodigdheden	ZNW:MRV:DE_
massagevaardigheden	massagevaardigheden	ZNW:MRV:DE_
menigeen	menigeen	VNW:OBP:EKV
mijnbouwvaardigheden	mijnbouwvaardigheden	ZNW:MRV:DE_
mijnwerkersbenodigdheden	mijnwerkersbenodigdheden	ZNW:MRV:DE_
militia	militia	ZNW:EKV:DE_
modelleervaardigheden	modelleervaardigheden	ZNW:MRV:DE_
montagebenodigdheden	montagebenodigdheden	ZNW:MRV:DE_
mouwinzet	mouwinzet	ZNW:EKV:DE_
muizengif	muizengif	ZNW:EKV:HET
muziekbenodigdheden	muziekbenodigdheden	ZNW:MRV:DE_
natuurvaardigheden	natuurvaardigheden	ZNW:MRV:DE_
navigatievaardigheden	navigatievaardigheden	ZNW:MRV:DE_
niemand	niemand	VNW:OBP:EKV
observatievaardigheden	observatievaardigheden	ZNW:MRV:DE_
omzethuur	omzethuur	ZNW:EKV:DE_
onderhoudsvaardigheden	onderhoudsvaardigheden	ZNW:MRV:DE_
onderwatervaardigheden	onderwatervaardigheden	ZNW:MRV:DE_
onderwijsbenodigdheden	onderwijsbenodigdheden	ZNW:MRV:DE_
onderzoeksbenodigdheden	onderzoeksbenodigdheden	ZNW:MRV:DE_
onderzoeksvaardigheden	onderzoeksvaardigheden	ZNW:MRV:DE_
ontspanningsvaardigheden	ontspanningsvaardigheden	ZNW:MRV:DE_
ontwikkelvaardigheden	ontwikkelvaardigheden	ZNW:MRV:DE_
oorlogsbenodigdheden	oorlogsbenodigdheden	ZNW:MRV:DE_
oorlogsvaardigheden	oorlogsvaardigheden	ZNW:MRV:DE_
paardenbenodigdheden	paardenbenodigdheden	ZNW:MRV:DE_
paardenbeul	paardenbeul	ZNW:EKV:DE_
papierbenodigdheden	papierbenodigdheden	ZNW:MRV:DE_
parketbenodigdheden	parketbenodigdheden	ZNW:MRV:DE_
partybenodigdheden	partybenodigdheden	ZNW:MRV:DE_
pengreep	pengreep	ZNW:EKV:DE_
persbabbel	persbabbel	ZNW:EKV:DE_
picknickbenodigdheden	picknickbenodigdheden	ZNW:MRV:DE_
plaatsingsbenodigdheden	plaatsingsbenodigdheden	ZNW:MRV:DE_
podiumvaardigheden	podiumvaardigheden	ZNW:MRV:DE_
politievaardigheden	politievaardigheden	ZNW:MRV:DE_
postzegelbenodigdheden	postzegelbenodigdheden	ZNW:MRV:DE_
presenteervaardigheden	presenteervaardigheden	ZNW:MRV:DE_
prestatievaardigheden	prestatievaardigheden	ZNW:MRV:DE_
printerbenodigdheden	printerbenodigdheden	ZNW:MRV:DE_
productiebenodigdheden	productiebenodigdheden	ZNW:MRV:DE_
puzzelvaardigheden	puzzelvaardigheden	ZNW:MRV:DE_
queer	queer	ZNW:EKV:DE_
quiltbenodigdheden	quiltbenodigdheden	ZNW:MRV:DE_
recherchevaardigheden	recherchevaardigheden	ZNW:MRV:DE_
rekenbasisvaardigheden	rekenbasisvaardigheden	ZNW:MRV:DE_
revisievaardigheden	revisievaardigheden	ZNW:MRV:DE_
riemclip	riemclip	ZNW:EKV:DE_
rokersbenodigdheden	rokersbenodigdheden	ZNW:MRV:DE_
ruiterbenodigdheden	ruiterbenodigdheden	ZNW:MRV:DE_
samenlevingsvaardigheden	samenlevingsvaardigheden	ZNW:MRV:DE_
sanitairbenodigdheden	sanitairbenodigdheden	ZNW:MRV:DE_
schaakvaardigheden	schaakvaardigheden	ZNW:MRV:DE_
schapenbenodigdheden	schapenbenodigdheden	ZNW:MRV:DE_
scheepsbenodigdheden	scheepsbenodigdheden	ZNW:MRV:DE_
scheepvaartbenodigdheden	scheepvaartbenodigdheden	ZNW:MRV:DE_
scheerbenodigdheden	scheerbenodigdheden	ZNW:MRV:DE_
schietbenodigdheden	schietbenodigdheden	ZNW:MRV:DE_
schildersbenodigdheden	schildersbenodigdheden	ZNW:MRV:DE_
schildersvaardigheden	schildersvaardigheden	ZNW:MRV:DE_
schoolbenodigdheden	schoolbenodigdheden	ZNW:MRV:DE_
schotklok	schotklok	ZNW:EKV:DE_
schrijfbenodigdheden	schrijfbenodigdheden	ZNW:MRV:DE_
scoutingvaardigheden	scoutingvaardigheden	ZNW:MRV:DE_
scriptieonderwerp	scriptieonderwerp	ZNW:EKV:HET
seksstaking	seksstaking	ZNW:EKV:DE_
selectievaardigheden	selectievaardigheden	ZNW:MRV:DE_
servicemanagementvaardigheden	servicemanagementvaardigheden	ZNW:MRV:DE_
slaapbenodigdheden	slaapbenodigdheden	ZNW:MRV:DE_
slagersbenodigdheden	slagersbenodigdheden	ZNW:MRV:DE_
snorkelbenodigdheden	snorkelbenodigdheden	ZNW:MRV:DE_
snorkelvaardigheden	snorkelvaardigheden	ZNW:MRV:DE_
softwarevaardigheden	softwarevaardigheden	ZNW:MRV:DE_
soldeervaardigheden	soldeervaardigheden	ZNW:MRV:DE_
sorteervaardigheden	sorteervaardigheden	ZNW:MRV:DE_
speurvaardigheden	speurvaardigheden	ZNW:MRV:DE_
spiervaardigheden	spiervaardigheden	ZNW:MRV:DE_
splintervaardigheden	splintervaardigheden	ZNW:MRV:DE_
sprekersvaardigheden	sprekersvaardigheden	ZNW:MRV:DE_
straatkant	straatkant	ZNW:EKV:DE_
strandbenodigdheden	strandbenodigdheden	ZNW:MRV:DE_
strijkbenodigdheden	strijkbenodigdheden	ZNW:MRV:DE_
strijkvaardigheden	strijkvaardigheden	ZNW:MRV:DE_
stroombenodigdheden	stroombenodigdheden	ZNW:MRV:DE_
studeervaardigheden	studeervaardigheden	ZNW:MRV:DE_
studiebenodigdheden	studiebenodigdheden	ZNW:MRV:DE_
sturingsvaardigheden	sturingsvaardigheden	ZNW:MRV:DE_
survivalbenodigdheden	survivalbenodigdheden	ZNW:MRV:DE_
systeemvaardigheden	systeemvaardigheden	ZNW:MRV:DE_
tandartsbenodigdheden	tandartsbenodigdheden	ZNW:MRV:DE_
tempelbenodigdheden	tempelbenodigdheden	ZNW:MRV:DE_
tennisbenodigdheden	tennisbenodigdheden	ZNW:MRV:DE_
terrariumbenodigdheden	terrariumbenodigdheden	ZNW:MRV:DE_
terrasbenodigdheden	terrasbenodigdheden	ZNW:MRV:DE_
tesla	tesla	ZNW:EKV:DE_
textielbenodigdheden	textielbenodigdheden	ZNW:MRV:DE_
theatervaardigheden	theatervaardigheden	ZNW:MRV:DE_
toervaart	toervaart	ZNW:EKV:DE_
toezichtvaardigheden	toezichtvaardigheden	ZNW:MRV:DE_
toiletbenodigdheden	toiletbenodigdheden	ZNW:MRV:DE_
toneelbenodigdheden	toneelbenodigdheden	ZNW:MRV:DE_
toneelvaardigheden	toneelvaardigheden	ZNW:MRV:DE_
toparbiter	toparbiter	ZNW:EKV:DE_
topselectie	topselectie	ZNW:EKV:DE_
topweekend	topweekend	ZNW:EKV:HET
trainingsbenodigdheden	trainingsbenodigdheden	ZNW:MRV:DE_
transportbenodigdheden	transportbenodigdheden	ZNW:MRV:DE_
tuinbouwbenodigdheden	tuinbouwbenodigdheden	ZNW:MRV:DE_
uitspraakvaardigheden	uitspraakvaardigheden	ZNW:MRV:DE_
uitvaartbenodigdheden	uitvaartbenodigdheden	ZNW:MRV:DE_
vakantiebenodigdheden	vakantiebenodigdheden	ZNW:MRV:DE_
valentijn	valentijn	ZNW:EKV:DE_
valkerijbenodigdheden	valkerijbenodigdheden	ZNW:MRV:DE_
veehouderijbenodigdheden	veehouderijbenodigdheden	ZNW:MRV:DE_
vergadervaardigheden	vergadervaardigheden	ZNW:MRV:DE_
verhoorvaardigheden	verhoorvaardigheden	ZNW:MRV:DE_
vervoersbenodigdheden	vervoersbenodigdheden	ZNW:MRV:DE_
verwaaiing	verwaaiing	ZNW:EKV:DE_
verzamelbenodigdheden	verzamelbenodigdheden	ZNW:MRV:DE_
verzorgingsvaardigheden	verzorgingsvaardigheden	ZNW:MRV:DE_
vierdaagse	vierdaagse	ZNW:EKV:DE_
vijverbenodigdheden	vijverbenodigdheden	ZNW:MRV:DE_
visserijbenodigdheden	visserijbenodigdheden	ZNW:MRV:DE_
vissersbenodigdheden	vissersbenodigdheden	ZNW:MRV:DE_
vluchtbenodigdheden	vluchtbenodigdheden	ZNW:MRV:DE_
voedingsbenodigdheden	voedingsbenodigdheden	ZNW:MRV:DE_
voetbalbenodigdheden	voetbalbenodigdheden	ZNW:MRV:DE_
vogelbenodigdheden	vogelbenodigdheden	ZNW:MRV:DE_
volleybalvaardigheden	volleybalvaardigheden	ZNW:MRV:DE_
voorjaarswind	voorjaarswind	ZNW:EKV:DE_
voorraadbenodigdheden	voorraadbenodigdheden	ZNW:MRV:DE_
voorzittersvaardigheden	voorzittersvaardigheden	ZNW:MRV:DE_
wandelvierdaagse	wandelvierdaagse	ZNW:EKV:DE_
wat	wat	VNW:OBP:EKV
webenquête	webenquête	ZNW:EKV:DE_
wedstrijdbenodigdheden	wedstrijdbenodigdheden	ZNW:MRV:DE_
weekeditie	weekeditie	ZNW:EKV:DE_
werfbaas	werfbaas	ZNW:EKV:DE_
werkkoffer	werkkoffer	ZNW:EKV:DE_
werknemersvaardigheden	werknemersvaardigheden	ZNW:MRV:DE_
winkelbenodigdheden	winkelbenodigdheden	ZNW:MRV:DE_
winkelvaardigheden	winkelvaardigheden	ZNW:MRV:DE_
wolfspoot	wolfspoot	ZNW:EKV:DE_
woordenschatvaardigheden	woordenschatvaardigheden	ZNW:MRV:DE_
worstelvaardigheden	worstelvaardigheden	ZNW:MRV:DE_
zachtroze	zachtroze	ZNW:EKV:HET
zeemansvaardigheden	zeemansvaardigheden	ZNW:MRV:DE_
zelfhulpvaardigheden	zelfhulpvaardigheden	ZNW:MRV:DE_
zittingsvaardigheden	zittingsvaardigheden	ZNW:MRV:DE_
zwembadbenodigdheden	zwembadbenodigdheden	ZNW:MRV:DE_
Joys	Joys	ENM:PER:LST
Noordzee	Noordzee	ZNW:EKV:DE_
pterodactylus	pterodactylus	ZNW:EKV:DE_
gumbo	gumbo	ZNW:EKV:DE_
kwis	kwis	ZNW:EKV:DE_
reserva	reserva	ZNW:EKV:DE_
soapie	soapie	ZNW:EKV:DE_
barolo	barolo	ZNW:EKV:DE_
lesidee	lesidee	ZNW:EKV
verhoorning	verhoorning	ZNW:EKV:DE_
rammer	rammer	ZNW:EKV:DE_
kretek	kretek	ZNW:EKV:DE_
post-it	post-it	ZNW:EKV:DE_
wende	wende	ZNW:EKV:DE_
Korangeleerde	Korangeleerde	ZNW:EKV:DE_
Landbouwschap	Landbouwschap	ZNW:EKV:HET
Twittervolger	Twittervolger	ZNW:EKV:DE_
afgrijslijkheden	afgrijslijkheden	ZNW:MRV:DE_
Woutertje	Woutertje	ENM:PER:FST
beuzelachtigheden	beuzelachtigheden	ZNW:MRV:DE_
schurftigheden	schurftigheden	ZNW:MRV:DE_
basis-arbeidsvaardigheden	basis-arbeidsvaardigheden	ZNW:MRV:DE_
grampositief	grampositief	BNW:STL:ONV
atoomboot	atoomboot	ZNW:EKV:DE_
amberbruin	amberbruin	BNW:STL:ONV
resultaatverantwoordelijkheden	resultaatverantwoordelijkheden	ZNW:MRV:DE_
railklem	railklem	ZNW:EKV:DE_
budgetverantwoordelijkheden	budgetverantwoordelijkheden	ZNW:MRV:DE_
kernvrijheden	kernvrijheden	ZNW:MRV:DE_
hoogmogendheden	hoogmogendheden	ZNW:MRV:DE_
daadwerkelijkheden	daadwerkelijkheden	ZNW:MRV:DE_
kindervaardigheden	kindervaardigheden	ZNW:MRV:DE_
tijdafhankelijkheden	tijdafhankelijkheden	ZNW:MRV:DE_
grafdichtheden	grafdichtheden	ZNW:MRV:DE_
datawetenschapsvaardigheden	datawetenschapsvaardigheden	ZNW:MRV:DE_
waterafhankelijkheden	waterafhankelijkheden	ZNW:MRV:DE_
kroonknutselvaardigheden	kroonknutselvaardigheden	ZNW:MRV:DE_
wapenvrijheden	wapenvrijheden	ZNW:MRV:DE_
luchtvrijheden	luchtvrijheden	ZNW:MRV:DE_
data-afhankelijkheden	data-afhankelijkheden	ZNW:MRV:DE_
hooggeleerdheden	hooggeleerdheden	ZNW:MRV:DE_
rondheden	rondheden	ZNW:MRV:DE_
dier-onvriendelijkheden	dier-onvriendelijkheden	ZNW:MRV:DE_
sommige	sommige	VNW:OBP:MRV
derde-medeplichtige	derde-medeplichtige	ZNW:EKV:DE_
niets	niets	VNW:OBP:EKV
fin-de-sièclegevoel	fin-de-sièclegevoel	ZNW:EKV:HET
do's-and-don'ts	do's-and-don'ts	ZNW:MRV:DE_
promo-exemplaar	promo-exemplaar	ZNW:EKV:HET
G-wedstrijd	G-wedstrijd	ZNW:EKV:DE_
g-voetbal	g-voetbal	ZNW:EKV:HET
AJC'er	AJC'er	ZNW:EKV:DE_
radio-omroepster	radio-omroepster	ZNW:EKV:DE_
tv-omroepster	tv-omroepster	ZNW:EKV:DE_
panaché	panaché	ZNW:EKV:DE_
ex-rookster	ex-rookster	ZNW:EKV:DE_
niet-rookster	niet-rookster	ZNW:EKV:DE_
ex-soapie	ex-soapie	ZNW:EKV:DE_
anabolicum	anabolicum	ZNW:EKV:HET
dolfijnachtig	dolfijnachtig	BNW:STL:ONV
knieperd	knieperd	ZNW:EKV:DE_
stobá	stobá	ZNW:EKV:DE_
Nisskakam	Nisskakam	ZNW:EKV:DE_
cessantia-uitkering	cessantia-uitkering	ZNW:EKV:DE_
niet-accountant	niet-accountant	ZNW:EKV:DE_
middle-of-the-road	middle-of-the-road	BNW:STL:ONV
middle-of-the-roadmuziek	middle-of-the-roadmuziek	ZNW:EKV:DE_
Samen-op-Wegkerk	Samen-op-Wegkerk	ZNW:EKV:DE_
box-to-boxspeler	box-to-boxspeler	ZNW:EKV:DE_
business-to-consumer	business-to-consumer	BNW:STL:ONV
ad-liminabezoek	ad-liminabezoek	ZNW:EKV:HET
4D-printen	4D-printen	WKW:TGW:INF
anti-Palestijns	anti-Palestijns	BNW:STL:ONV
anti-europartij	anti-europartij	ZNW:EKV:DE_
anti-individualistisch	anti-individualistisch	BNW:STL:ONV
tv-foon	tv-foon	ZNW:EKV:DE_
bewonderingswaardig	bewonderingswaardig	BNW:STL:ONV
Canadees-Engels	Canadees-Engels	BNW:STL:ONV
goedeavond	goedeavond	TSW
goeieavond	goeieavond	TSW
Holocaustontkenner	Holocaustontkenner	ZNW:EKV:DE_
Laagland-Schots	Laagland-Schots	ZNW:EKV:HET
liefdebrief	liefdebrief	ZNW:EKV:DE_
lno	lno	ZNW:EKV:HET
luchtmachtpiloot	luchtmachtpiloot	ZNW:EKV:DE_
missie-ijver	missie-ijver	ZNW:EKV:DE_
oppervlakteactief	oppervlakteactief	BNW:STL:ONV
sf-achtig	sf-achtig	BNW:STL:ONV
Sovjetmacht	Sovjetmacht	ZNW:EKV:DE_
trippelpas	trippelpas	ZNW:EKV:DE_
zekeraar	zekeraar	ZNW:EKV:DE_
inbetonneren	inbetonneren	WKW:TGW:INF
de-ioniseren	de-ioniseren	WKW:TGW:INF
Equatoriaal-Guinees	Equatoriaal-Guinees	BNW:STL:ONV
oud-voetbalster	oud-voetbalster	ZNW:EKV:DE_
losheden	losheden	ZNW:MRV:DE_
overdrukker	overdrukker	ZNW:EKV:DE_
celdoden	celdoden	ZNW:MRV:DE_
oud-parlementsvoorzitter	oud-parlementsvoorzitter	ZNW:EKV:DE_
bedrijfsuur	bedrijfsuur	ZNW:EKV:HET
keel-neus-oorarts	keel-neus-oorarts	ZNW:EKV:DE_
neus-keel-oorarts	neus-keel-oorarts	ZNW:EKV:DE_
temperatuurscontrole	temperatuurscontrole	ZNW:EKV:DE_
coca-colafles	coca-colafles	ZNW:EKV:DE_
tevredenheidenquête	tevredenheidenquête	ZNW:EKV:DE_
werkeloosheidswet	werkeloosheidswet	ZNW:EKV:DE_
niet-winkeldag	niet-winkeldag	ZNW:EKV:DE_
bel-etagewoning	bel-etagewoning	ZNW:EKV:DE_
naasthoger	naasthoger	BNW:STL:ONV
doodsprent	doodsprent	ZNW:EKV:DE_
jeugdkeet	jeugdkeet	ZNW:EKV:DE_
televisiekwis	televisiekwis	ZNW:EKV:DE_
ex-profspeler	ex-profspeler	ZNW:EKV:DE_
oud-profspeler	oud-profspeler	ZNW:EKV:DE_
premiebetalend	premiebetalend	BNW:STL:ONV
tevredenheidmeting	tevredenheidmeting	ZNW:EKV:DE_
supportersrel	supportersrel	ZNW:EKV:DE_
oorflap	oorflap	ZNW:EKV:DE_
olie-en-azijnstel	olie-en-azijnstel	ZNW:EKV:HET
ex-sektelid	ex-sektelid	ZNW:EKV:HET
ruitersvereniging	ruitersvereniging	ZNW:EKV:DE_
niet-taalgebonden	niet-taalgebonden	BNW:STL:ONV
mantelzorgend	mantelzorgend	BNW:STL:ONV
onheilszwanger	onheilszwanger	BNW:STL:ONV
havikneus	havikneus	ZNW:EKV:DE_
4x4-auto	4x4-auto	ZNW:EKV:DE_
topo-isomerase	topo-isomerase	ZNW:EKV:DE_
sf-schrijver	sf-schrijver	ZNW:EKV:DE_
rock-'n-rollplaat	rock-'n-rollplaat	ZNW:EKV:DE_
rock-'n-rollzanger	rock-'n-rollzanger	ZNW:EKV:DE_
slaap-T-shirt	slaap-T-shirt	ZNW:EKV:HET
niet-alfabetisch	niet-alfabetisch	BNW:STL:ONV
niet-algemeen	niet-algemeen	BNW:STL:ONV
niet-arbeidsgebonden	niet-arbeidsgebonden	BNW:STL:ONV
niet-ariër	niet-ariër	ZNW:EKV:DE_
châteauneuf-du-pape	châteauneuf-du-pape	ZNW:EKV:DE_
COVID-19-epidemie	COVID-19-epidemie	ZNW:EKV:DE_
horeca-benodigdheden	horeca-benodigdheden	ZNW:MRV:DE_
lng-tanker	lng-tanker	ZNW:EKV:DE_
substituut-krijgsauditeur	substituut-krijgsauditeur	ZNW:EKV:DE_
hulpontvangend	hulpontvangend	BNW:STL:ONV
naziuniform	naziuniform	ZNW:EKV:HET
multicultuur	multicultuur	ZNW:EKV:DE_
Koranvers	Koranvers	ZNW:EKV:HET
beeldkwaliteitplan	beeldkwaliteitplan	ZNW:EKV:HET
langstudeerboete	langstudeerboete	ZNW:EKV:DE_
middenpunt	middenpunt	ZNW:EKV:HET
rechtermuur	rechtermuur	ZNW:EKV:DE_
contractor	contractor	ZNW:EKV:DE_
appstore	appstore	ZNW:EKV:DE_
wetvoorstel	wetvoorstel	ZNW:EKV:HET
masterbedroom	masterbedroom	ZNW:EKV:DE_
kortverblijf	kortverblijf	ZNW:EKV:HET
zelforganiserend	zelforganiserend	BNW:STL:ONV
funpark	funpark	ZNW:EKV:HET
disrespect	disrespect	ZNW:EKV:HET
echocardiografie	echocardiografie	ZNW:EKV:DE_
centraalbouw	centraalbouw	ZNW:EKV:DE_
driedimensioneel	driedimensioneel	BNW:STL:ONV
standstill	standstill	ZNW:EKV:DE_
zelfverantwoordelijkheid	zelfverantwoordelijkheid	ZNW:EKV:DE_
steilrand	steilrand	ZNW:EKV:DE_
kentekencard	kentekencard	ZNW:EKV:DE_
ambachtschool	ambachtschool	ZNW:EKV:DE_
alarmisme	alarmisme	ZNW:EKV:HET
zachthout	zachthout	ZNW:EKV:HET
parkinsonisme	parkinsonisme	ZNW:EKV:HET
grootadmiraal	grootadmiraal	ZNW:EKV:DE_
showdown	showdown	ZNW:EKV:DE_
rechtermuis	rechtermuis	ZNW:EKV:DE_
tractuur	tractuur	ZNW:EKV:DE_
dierexperimenteel	dierexperimenteel	BNW:STL:ONV
multiprobleemgezin	multiprobleemgezin	ZNW:EKV:HET
blogging	blogging	ZNW:EKV:DE_
wildzwijn	wildzwijn	ZNW:EKV:HET
allesdoordringend	allesdoordringend	BNW:STL:ONV
vliegvlug	vliegvlug	BNW:STL:ONV
memoryspel	memoryspel	ZNW:EKV:HET
gatekeeper	gatekeeper	ZNW:EKV:DE_
buzzword	buzzword	ZNW:EKV:HET
winterbij	winterbij	ZNW:EKV:DE_
visserschip	visserschip	ZNW:EKV:HET
minibike	minibike	ZNW:EKV:DE_
stervensdruk	stervensdruk	BNW:STL:ONV
onderschoeiing	onderschoeiing	ZNW:EKV:DE_
kandidatuurstelling	kandidatuurstelling	ZNW:EKV:DE_
eerststervende	eerststervende	ZNW:EKV:DE_
omhooggericht	omhooggericht	BNW:STL:ONV
comfortfood	comfortfood	ZNW:EKV
scartkabel	scartkabel	ZNW:EKV:DE_
weerssituatie	weerssituatie	ZNW:EKV:DE_
elektronvolt	elektronvolt	MEH
wijdgeopend	wijdgeopend	BNW:STL:ONV
wederbeleggingsvergoeding	wederbeleggingsvergoeding	ZNW:EKV:DE_
landcommanderij	landcommanderij	ZNW:EKV:DE_
slowfood	slowfood	ZNW:EKV
oberkelner	oberkelner	ZNW:EKV:DE_
westzuidwesten	westzuidwesten	ZNW:EKV:HET
starring	starring	BNW:STL:ONV
partnering	partnering	ZNW:EKV:DE_
omzetplus	omzetplus	ZNW:EKV:DE_
bodyscrub	bodyscrub	ZNW:EKV:DE_
zelfgave	zelfgave	ZNW:EKV:DE_
vijfpuntsschaal	vijfpuntsschaal	ZNW:EKV:DE_
nauwverholen	nauwverholen	BNW:STL:ONV
levenbedrijf	levenbedrijf	ZNW:EKV:HET
salesorganisatie	salesorganisatie	ZNW:EKV:DE_
postchristelijk	postchristelijk	BNW:STL:ONV
reuzenschip	reuzenschip	ZNW:EKV:HET
senaatsverkiezing	senaatsverkiezing	ZNW:EKV:DE_
eigenbeweging	eigenbeweging	ZNW:EKV:DE_
driekwartbroek	driekwartbroek	ZNW:EKV:DE_
jumpstyle	jumpstyle	ZNW:EKV:DE_
eropvolgend	eropvolgend	BNW:STL:ONV
hippogrief	hippogrief	ZNW:EKV:DE_
flipchart	flipchart	ZNW:EKV:DE_
beterkoop	beterkoop	BNW:STL:ONV
vouwstep	vouwstep	ZNW:EKV:DE_
screendump	screendump	ZNW:EKV:DE_
hotshot	hotshot	ZNW:EKV:DE_
schoenerbrik	schoenerbrik	ZNW:EKV:DE_
gevaarzettend	gevaarzettend	BNW:STL:ONV
gezichtveld	gezichtveld	ZNW:EKV:HET
vroegdetectie	vroegdetectie	ZNW:EKV:DE_
ladylike	ladylike	BNW:STL:ONV
weersvoorspeller	weersvoorspeller	ZNW:EKV:DE_
vijfjaarstermijn	vijfjaarstermijn	ZNW:EKV:DE_
opendeurweekend	opendeurweekend	ZNW:EKV:HET
luxeverzuim	luxeverzuim	ZNW:EKV:HET
integriteitschending	integriteitschending	ZNW:EKV:DE_
goedgemanierd	goedgemanierd	BNW:STL:ONV
wrapper	wrapper	ZNW:EKV:DE_
postimpressionisme	postimpressionisme	ZNW:EKV:HET
zelfopenbaring	zelfopenbaring	ZNW:EKV:DE_
troephuis	troephuis	ZNW:EKV:HET
zelfonthulling	zelfonthulling	ZNW:EKV:DE_
medeonderzoeker	medeonderzoeker	ZNW:EKV:DE_
brugger	brugger	ZNW:EKV:DE_
verwijlinterest	verwijlinterest	ZNW:EKV:DE_
kwantor	kwantor	ZNW:EKV:DE_
hogerberoepschrift	hogerberoepschrift	ZNW:EKV:HET
tijdruimtelijk	tijdruimtelijk	BNW:STL:ONV
cisterciënzerklooster	cisterciënzerklooster	ZNW:EKV:HET
andersglobaliseringsbeweging	andersglobaliseringsbeweging	ZNW:EKV:DE_
spoorboekloos	spoorboekloos	BNW:STL:ONV
onderdirectrice	onderdirectrice	ZNW:EKV:DE_
onderconsumptie	onderconsumptie	ZNW:EKV:DE_
driedimensionaliteit	driedimensionaliteit	ZNW:EKV:DE_
stentplaatsing	stentplaatsing	ZNW:EKV:DE_
policier	policier	ZNW:EKV:DE_
sweepstake	sweepstake	ZNW:EKV:DE_
brandstofcelauto	brandstofcelauto	ZNW:EKV:DE_
verblijfvergunning	verblijfvergunning	ZNW:EKV:DE_
tjongejonge	tjongejonge	TSW
ontstekingremmend	ontstekingremmend	BNW:STL:ONV
ondervoorzitster	ondervoorzitster	ZNW:EKV:DE_
keizerstroon	keizerstroon	ZNW:EKV:DE_
eilandsbesluit	eilandsbesluit	ZNW:EKV:HET
zelfactualisatie	zelfactualisatie	ZNW:EKV:DE_
vlogster	vlogster	ZNW:EKV:DE_
ondergefinancierd	ondergefinancierd	BNW:STL:ONV
metacommunicatie	metacommunicatie	ZNW:EKV:DE_
herroepingrecht	herroepingrecht	ZNW:EKV:HET
freelancewerk	freelancewerk	ZNW:EKV:HET
sleeper	sleeper	ZNW:EKV:DE_
erevoorzitterschap	erevoorzitterschap	ZNW:EKV:HET
sherryglas	sherryglas	ZNW:EKV:HET
refugehuis	refugehuis	ZNW:EKV:HET
krijgsgehuil	krijgsgehuil	ZNW:EKV:HET
benedictijnerabdij	benedictijnerabdij	ZNW:EKV:DE_
mijngemeente	mijngemeente	ZNW:EKV:DE_
zelfidentificatie	zelfidentificatie	ZNW:EKV:DE_
wederbelegging	wederbelegging	ZNW:EKV:DE_
voordrachtsakte	voordrachtsakte	ZNW:EKV:DE_
grootmeesterschap	grootmeesterschap	ZNW:EKV:HET
geelkuifkaketoe	geelkuifkaketoe	ZNW:EKV:DE_
petroleumether	petroleumether	ZNW:EKV
wapendropping	wapendropping	ZNW:EKV:DE_
senaatslijst	senaatslijst	ZNW:EKV:DE_
dichtgeplamuurd	dichtplamuren	WKW:VTD:ONV
verkoopsteam	verkoopsteam	ZNW:EKV:HET
oranjegekleurd	oranjegekleurd	BNW:STL:ONV
marktimperfectie	marktimperfectie	ZNW:EKV:DE_
inburgeringexamen	inburgeringexamen	ZNW:EKV:HET
vierwielbesturing	vierwielbesturing	ZNW:EKV:DE_
vierkamerwoning	vierkamerwoning	ZNW:EKV:DE_
reuzebenieuwd	reuzebenieuwd	BNW:STL:ONV
meester-timmerman	meester-timmerman	ZNW:EKV:DE_
jaarswisseling	jaarswisseling	ZNW:EKV:DE_
weigeringgrond	weigeringgrond	ZNW:EKV:DE_
zegezeker	zegezeker	BNW:STL:ONV
antiwitwaswet	antiwitwaswet	ZNW:EKV:DE_
antiburgerlijk	antiburgerlijk	BNW:STL:ONV
rechterhartkamer	rechterhartkamer	ZNW:EKV:DE_
oudervervreemding	oudervervreemding	ZNW:EKV:DE_
transpallet	transpallet	ZNW:EKV:DE_
riviergrondel	riviergrondel	ZNW:EKV:DE_
kopschopper	kopschopper	ZNW:EKV:DE_
kamerbezetting	kamerbezetting	ZNW:EKV:DE_
overfinanciering	overfinanciering	ZNW:EKV:DE_
onderdeelcommissie	onderdeelcommissie	ZNW:EKV:DE_
naamsverklaring	naamsverklaring	ZNW:EKV:DE_
goedbewapend	goedbewapend	BNW:STL:ONV
studentstage	studentstage	ZNW:EKV:DE_
stadwandeling	stadwandeling	ZNW:EKV:DE_
minestronesoep	minestronesoep	ZNW:EKV:DE_
hoogperformant	hoogperformant	BNW:STL:ONV
halfwakker	halfwakker	BNW:STL:ONV
verstripping	verstripping	ZNW:EKV:DE_
rouwstand	rouwstand	ZNW:EKV:DE_
ruimtevarend	ruimtevarend	BNW:STL:ONV
legerimam	legerimam	ZNW:EKV:DE_
onderwerpsregel	onderwerpsregel	ZNW:EKV:DE_
langstudeerdersboete	langstudeerdersboete	ZNW:EKV:DE_
kunstsecundair	kunstsecundair	BNW:STL:ONV
subhoofdstuk	subhoofdstuk	ZNW:EKV:HET
meestbezocht	meestbezocht	BNW:STL:ONV
zelfbestemming	zelfbestemming	ZNW:EKV:DE_
contacttaal	contacttaal	ZNW:EKV:DE_
personeelbeleid	personeelbeleid	ZNW:EKV:HET
linkerhemisfeer	linkerhemisfeer	ZNW:EKV:DE_
allesverhullend	allesverhullend	BNW:STL:ONV
zwaargehavend	zwaargehavend	BNW:STL:ONV
realitycheck	realitycheck	ZNW:EKV:DE_
blitzstart	blitzstart	ZNW:EKV:DE_
teambuildingactiviteit	teambuildingactiviteit	ZNW:EKV:DE_
sportverdwazing	sportverdwazing	ZNW:EKV:DE_
reuzenvogel	reuzenvogel	ZNW:EKV:DE_
intelligentiepeil	intelligentiepeil	ZNW:EKV:HET
hoogrenaissance	hoogrenaissance	ZNW:EKV:DE_
doodstijding	doodstijding	ZNW:EKV:DE_
diepreligieus	diepreligieus	BNW:STL:ONV
beschermenswaardig	beschermenswaardig	BNW:STL:ONV
autorodeo	autorodeo	ZNW:EKV:DE_
achtertros	achtertros	ZNW:EKV:DE_
meerpuntssluiting	meerpuntssluiting	ZNW:EKV:DE_
clearinghouse	clearinghouse	ZNW:EKV:HET
openzakken	openzakken	WKW:TGW:INF
waaromheen	waaromheen	BYW
cloudgebaseerd	cloudgebaseerd	BNW:STL:ONV
waarvandaan	waarvandaan	BYW
rechtovereind	rechtovereind	BYW
ertegenover	ertegenover	BYW
kopje-onder	kopje-onder	BYW
vanbinnen	vanbinnen	BYW
ertussen	ertussen	BYW
inkomensonafhankelijk	inkomensonafhankelijk	BNW:STL:ONV
geluidabsorberend	geluidabsorberend	BNW:STL:ONV
handenklappend	handenklappend	BNW:STL:ONV
derde-belanghebbende	derde-belanghebbende	ZNW:EKV:DE_
klimaatadaptief	klimaatadaptief	BNW:STL:ONV
Bijbelcursus	Bijbelcursus	ZNW:EKV:DE_
scanstraat	scanstraat	ZNW:EKV:DE_
erheen	erheen	BYW
Facebookprofielen	Facebookprofiel	ZNW:MRV:DE_
Facebookprofieltje	Facebookprofiel	ZNW:EKV:VRK:HET
Facebookprofieltjes	Facebookprofiel	ZNW:MRV:VRK:DE_
bewonderingswaardige	bewonderingswaardig	BNW:STL:VRB
bewonderingswaardigst	bewonderingswaardig	BNW:OVR:ONV
bewonderingswaardigste	bewonderingswaardig	BNW:OVR:VRB
bewonderingswaardigs	bewonderingswaardig	BNW:STL:IET
bewonderingswaardiger	bewonderingswaardig	BNW:VGR:ONV
bewonderingswaardigen	bewonderingswaardig	BNW:STL:MRV:DE_
misrekend	misrekenen	WKW:VTD:ONV
misrekende	misrekenen	WKW:VTD:VRB
probleemgestuurd	probleemgestuurd	BNW:STL:ONV
probleemgestuurde	probleemgestuurd	BNW:STL:VRB
zekeraar	zekeraar	ZNW:MRV:DE_
supergemotiveerd	supergemotiveerd	BNW:STL:ONV
supergemotiveerde	supergemotiveerd	BNW:STL:VRB
Sovjetmachten	Sovjetmacht	ZNW:MRV:DE_
inkomensonafhankelijke	inkomensonafhankelijk	BNW:STL:VRB
luchtmachtpiloten	luchtmachtpiloot	ZNW:MRV:DE_
Holocaustontkenners	Holocaustontkenner	ZNW:MRV:DE_
Postbankrekeningen	Postbankrekening	ZNW:MRV:DE_
zaaktypes	zaaktype	ZNW:MRV:DE_
militia's	militia	ZNW:MRV:DE_
rêverieën	rêverie	ZNW:MRV:DE_
sorteersters	sorteerster	ZNW:MRV:DE_
pinkstieren	pinkstier	ZNW:MRV:DE_
fruitslaatjes	fruitslaatje	ZNW:MRV:VRK:DE_
niet-winkeldagen	niet-winkeldag	ZNW:MRV:DE_
onheilszwangere	onheilszwanger	BNW:STL:VRB
oorflapje	oorflap	ZNW:EKV:VRK:HET
oorflapjes	oorflap	ZNW:MRV:VRK:DE_
oorflappen	oorflap	ZNW:MRV:DE_
neus-keel-oorartsen	neus-keel-oorarts	ZNW:MRV:DE_
marshals	marshal	ZNW:MRV:DE_
enzovoorts	enzovoorts	BYW
eromheen	eromheen	BYW
Elburger	Elburger	BNW:STL:ONV
Elburger	Elburger	BNW:STL:VRB
Elburger	Elburger	ZNW:EKV:DE_
Elburgers	Elburger	ZNW:MRV:DE_
waarachter	waarachter	BYW
daarbinnen	daarbinnen	BYW
Bunschoter	Bunschoter	ZNW:EKV:DE_
Bunschoters	Bunschoter	ZNW:MRV:DE_
Bunschoter	Bunschoter	BNW:STL:ONV
Bunschoter	Bunschoter	BNW:STL:VRB
Diemense	Diemense	ZNW:EKV:DE_
Diemens	Diemens	BNW:STL:ONV
Diemense	Diemens	BNW:STL:VRB
Londense	Londense	ZNW:EKV:DE_
Londens	Londens	BNW:STL:ONV
Londense	Londens	BNW:STL:VRB
Bretons	Bretons	BNW:STL:ONV
Bretonse	Bretons	BNW:STL:VRB
Engelssprekend	Engelssprekend	BNW:STL:ONV
Engelssprekende	Engelssprekend	BNW:STL:VRB
Kretenzisch	Kretenzisch	BNW:STL:ONV
Kretenzische	Kretenzisch	BNW:STL:VRB
Joys	Joy	ENM:BEZ
Lommelse	Lommelse	ZNW:EKV:DE_
Lommels	Lommels	BNW:STL:ONV
Lommelse	Lommels	BNW:STL:VRB
Guinees	Guinees	BNW:STL:ONV
Guineese	Guinees	BNW:STL:VRB
Guineese	Guineese	ZNW:EKV:DE_
Guinees	Guinees	ZNW:EKV:DE_
Guinezen	Guinees	ZNW:MRV:DE_
Hongkongs	Hongkongs	BNW:STL:ONV
Hongkongse	Hongkongs	BNW:STL:VRB
Hongkongse	Hongkongse	ZNW:EKV:DE_
Genkse	Genkse	ZNW:EKV:DE_
Genks	Genks	BNW:STL:ONV
Genkse	Genks	BNW:STL:VRB
Burundese	Burundese	ZNW:EKV:DE_
Burundees	Burundees	BNW:STL:ONV
Burundese	Burundees	BNW:STL:VRB
Libische	Libische	ZNW:EKV:DE_
Libisch	Libisch	BNW:STL:ONV
Libische	Libisch	BNW:STL:VRB
Luiks	Luiks	BNW:STL:ONV
Luikse	Luiks	BNW:STL:VRB
Luikse	Luikse	ZNW:EKV:DE_
Ethiopische	Ethiopische	ZNW:EKV:DE_
Ethiopisch	Ethiopisch	BNW:STL:ONV
Ethiopische	Ethiopisch	BNW:STL:VRB
Henegouwse	Henegouwse	ZNW:EKV:DE_
Henegouws	Henegouws	BNW:STL:ONV
Henegouwse	Henegouws	BNW:STL:VRB
Egeïsch	Egeïsch	BNW:STL:ONV
Egeïsche	Egeïsch	BNW:STL:VRB
Doetinchems	Doetinchems	BNW:STL:ONV
Doetinchemse	Doetinchems	BNW:STL:VRB
Doetinchemse	Doetinchemse	ZNW:EKV:DE_
Ests	Ests	BNW:STL:ONV
Estse	Ests	BNW:STL:VRB
Cypriotische	Cypriotische	ZNW:EKV:DE_
Cypriotisch	Cypriotisch	BNW:STL:ONV
Cypriotische	Cypriotisch	BNW:STL:VRB
Kortrijkse	Kortrijkse	ZNW:EKV:DE_
Kortrijks	Kortrijks	BNW:STL:ONV
Kortrijkse	Kortrijks	BNW:STL:VRB
Litouwse	Litouwse	ZNW:EKV:DE_
Litouws	Litouws	BNW:STL:ONV
Litouwse	Litouws	BNW:STL:VRB
Comorese	Comorees	BNW:STL:VRB
Kempisch	Kempisch	BNW:STL:ONV
Kempische	Kempisch	BNW:STL:VRB
Enschedese	Enschedese	ZNW:EKV:DE_
Enschedees	Enschedees	BNW:STL:ONV
Enschedese	Enschedees	BNW:STL:VRB
maandagavond	maandagavond	BYW
dinsdagavond	dinsdagavond	BYW
woensdagavond	woensdagavond	BYW
donderdagavond	donderdagavond	BYW
vrijdagavond	vrijdagavond	BYW
zaterdagavond	zaterdagavond	BYW
zondagavond	zondagavond	BYW
zaterdagnamiddag	zaterdagnamiddag	BYW
maandag	maandag	BYW
dinsdag	dinsdag	BYW
woensdag	woensdag	BYW
donderdag	donderdag	BYW
vrijdag	vrijdag	BYW
zaterdag	zaterdag	BYW
zondag	zondag	BYW
maandagochtend	maandagochtend	BYW
dinsdagochtend	dinsdagochtend	BYW
woensdagochtend	woensdagochtend	BYW
donderdagochtend	donderdagochtend	BYW
vrijdagochtend	vrijdagochtend	BYW
zaterdagochtend	zaterdagochtend	BYW
zondagochtend	zondagochtend	BYW
queer	queer	BNW:STL:ONV
queer	queer	BNW:STL:VRB
queers	queer	BNW:STL:IET
zachtroze	zachtroze	BNW:STL:ONV
zachtroze	zachtroze	BNW:STL:VRB
Sovjetregering	Sovjetregering	ZNW:EKV:DE_
Spakenburger	Spakenburger	ZNW:EKV:DE_
Spakenburger	Spakenburger	BNW:STL:ONV
Spakenburger	Spakenburger	BNW:STL:VRB
tantes	tante	ZNW:BEZ
ooms	oom	ZNW:BEZ
opa's	opa	ZNW:BEZ
oma's	oma	ZNW:BEZ
mama's	mama	ENM:BEZ
vaders	vader	ZNW:BEZ
mede	mede	BYW
ervandoor	ervandoor	BYW
honderduit	honderduit	BYW
binnendoor	binnendoor	BYW
vandaar	vandaar	BYW
sluipenderwijs	sluipenderwijs	BYW
amberbruine	amberbruin	BNW:STL:VRB
lichtjes	lichtjes	BYW:JES
moeders	moeder	ZNW:BEZ
Poetin	Poetin	ENM:PER:LST
Iberisch	Iberisch	BNW:STL:ONV
Iberische	Iberisch	BNW:STL:VRB
Jemenitisch	Jemenitisch	BNW:STL:ONV
Jemenitische	Jemenitisch	BNW:STL:VRB
Kempens	Kempens	BNW:STL:ONV
Kempense	Kempens	BNW:STL:VRB
zuurstokroze	zuurstokroze	BNW:STL:ONV
zuurstokroze	zuurstokroze	BNW:STL:VRB
transgender	transgender	BNW:STL:ONV
transgender	transgender	BNW:STL:VRB
suède	suède	BNW:STL:ONV
suède	suède	BNW:STL:VRB
handenvol	handenvol	BYW
felgroen	felgroen	BNW:STL:ONV
felgroene	felgroen	BNW:STL:VRB
alias	alias	BYW
berkenbasten	berkenbasten	BNW:STF
blankhouten	blankhouten	BNW:STF
pal	pal	BYW
pal	pal	TSW
hierbinnen	hierbinnen	BYW
hierbuiten	hierbuiten	BYW
ouders	ouder	ZNW:BEZ
uptempo	uptempo	BYW
subprimehypotheek	subprimehypotheek	ZNW:EKV:DE_
Litouwer	Litouwer	ZNW:EKV:DE_
Litouwers	Litouwer	ZNW:MRV:DE_
Hyvespagina	Hyvespagina	ZNW:EKV:DE_
estateplanning	estateplanning	ZNW:EKV:DE_
doormigratie	doormigratie	ZNW:EKV:DE_
bottom-upbenadering	bottom-upbenadering	ZNW:EKV:DE_
aanzitjacht	aanzitjacht	ZNW:EKV:HET
aanrijbeveiliging	aanrijbeveiliging	ZNW:EKV:DE_
aanrijbeveiligingen	aanrijbeveiliging	ZNW:MRV:DE_
subprimehypotheken	subprimehypotheek	ZNW:MRV:DE_
barolo's	barolo	ZNW:MRV:DE_
dialectbandje	dialectband	ZNW:EKV:VRK:HET
dialectbands	dialectband	ZNW:MRV:DE_
dialectbandjes	dialectband	ZNW:MRV:VRK:DE_
piaffes	piaffe	ZNW:MRV:DE_
pterodactylussen	pterodactylus	ZNW:MRV:DE_
blode	blo	BNW:STL:VRB
bloste	blo	BNW:OVR:VRB
blo's	blo	BNW:STL:IET
bloder	blo	BNW:VGR:ONV
bloden	blo	BNW:STL:MRV:DE_
radio-omroepsters	radio-omroepster	ZNW:MRV:DE_
tv-omroepsters	tv-omroepster	ZNW:MRV:DE_
calculi	calculus	ZNW:MRV:DE_
scriptieonderwerpen	scriptieonderwerp	ZNW:MRV:DE_
keel-neus-oorartsen	keel-neus-oorarts	ZNW:MRV:DE_
Equatoriaal-Guinese	Equatoriaal-Guinees	BNW:STL:VRB
privéchats	privéchat	ZNW:MRV:DE_
shisha's	shisha	ZNW:MRV:DE_
agapanthussen	agapanthus	ZNW:MRV:DE_
stobá's	stobá	ZNW:MRV:DE_
t'tje	t	ZNW:EKV:VRK:HET
t'tjes	t	ZNW:MRV:VRK:DE_
niet-marxistische	niet-marxistisch	BNW:STL:VRB
bovengangen	bovengang	ZNW:MRV:DE_
bovengangetje	bovengang	ZNW:EKV:VRK:HET
cambia	cambium	ZNW:MRV:DE_
baltovenaars	baltovenaar	ZNW:MRV:DE_
Wereldschaakbond	Wereldschaakbond	ZNW:EKV:DE_
jeugdketen	jeugdkeet	ZNW:MRV:DE_
leer-werkplaatsen	leer-werkplaats	ZNW:MRV:DE_
bel-etagewoningen	bel-etagewoning	ZNW:MRV:DE_
knieperds	knieperd	ZNW:MRV:DE_
reserva's	reserva	ZNW:MRV:DE_
bridgespelletje	bridgespel	ZNW:EKV:VRK:HET
bridgespelletjes	bridgespel	ZNW:MRV:VRK:DE_
bridgespellen	bridgespel	ZNW:MRV:DE_
bedrijfsuren	bedrijfsuur	ZNW:MRV:DE_
intendances	intendance	ZNW:MRV:DE_
middenvoors	middenvoor	ZNW:MRV:DE_
onafweerbare	onafweerbaar	BNW:STL:VRB
werfbaasje	werfbaas	ZNW:EKV:VRK:HET
werfbazen	werfbaas	ZNW:MRV:DE_
panachés	panaché	ZNW:MRV:DE_
clearinghouses	clearinghouse	ZNW:MRV:DE_
baklava's	baklava	ZNW:MRV:DE_
korbeels	korbeel	ZNW:MRV:DE_
inchoatief	inchoatief	BNW:STL:ONV
inchoatieve	inchoatief	BNW:STL:VRB
toparbiters	toparbiter	ZNW:MRV:DE_
letter-cijfercombinaties	letter-cijfercombinatie	ZNW:MRV:DE_
webplatformen	webplatform	ZNW:MRV:DE_
webplatforms	webplatform	ZNW:MRV:DE_
erkentenissen	erkentenis	ZNW:MRV:DE_
fladderend	fladderend	BNW:STL:ONV
fladderende	fladderend	BNW:STL:VRB
fladderends	fladderend	BNW:STL:IET
fladderender	fladderend	BNW:VGR:ONV
fladderenden	fladderend	BNW:STL:MRV:DE_
becquerels	becquerel	ZNW:MRV:DE_
kleptocratieën	kleptocratie	ZNW:MRV:DE_
klavichorden	klavichord	ZNW:MRV:DE_
dysfemismen	dysfemisme	ZNW:MRV:DE_
kersteningen	kerstening	ZNW:MRV:DE_
atoombootje	atoomboot	ZNW:EKV:VRK:HET
atoomboten	atoomboot	ZNW:MRV:DE_
webenquêtes	webenquête	ZNW:MRV:DE_
liefdebriefjes	liefdebrief	ZNW:MRV:VRK:DE_
liefdebrieven	liefdebrief	ZNW:MRV:DE_
armagnacs	armagnac	ZNW:MRV:DE_
gumbo's	gumbo	ZNW:MRV:DE_
businessparken	businesspark	ZNW:MRV:DE_
verhoorningen	verhoorning	ZNW:MRV:DE_
onbevarenst	onbevaren	BNW:OVR:ONV
onbevarenste	onbevaren	BNW:OVR:VRB
onbevarener	onbevaren	BNW:VGR:ONV
onbevarene	onbevaren	BNW:STL:EKV
onbevarenen	onbevaren	BNW:STL:MRV:DE_
peptonen	pepton	ZNW:MRV:DE_
ruby's	ruby	ZNW:MRV:DE_
brouilles	brouille	ZNW:MRV:DE_
ex-dwangarbeider	ex-dwangarbeider	ZNW:EKV:DE_
ex-dwangarbeiders	ex-dwangarbeider	ZNW:MRV:DE_
mouwinzetten	mouwinzet	ZNW:MRV:DE_
autogek	autogek	BNW:STL:ONV
autogekke	autogek	BNW:STL:VRB
autogekken	autogek	BNW:STL:MRV:DE_
irrelevanties	irrelevantie	ZNW:MRV:DE_
springbanen	springbaan	ZNW:MRV:DE_
art-decohuizen	art-decohuis	ZNW:MRV:DE_
oliemeren	oliemeer	ZNW:MRV:DE_
hijgend	hijgend	BNW:STL:ONV
hijgende	hijgend	BNW:STL:VRB
hijgends	hijgend	BNW:STL:IET
hijgender	hijgend	BNW:VGR:ONV
hijgenden	hijgend	BNW:STL:MRV:DE_
afgepeigerd	afgepeigerd	BNW:STL:ONV
afgepeigerde	afgepeigerd	BNW:STL:VRB
afgepeigerds	afgepeigerd	BNW:STL:IET
afgepeigerder	afgepeigerd	BNW:VGR:ONV
tesla's	tesla	ZNW:MRV:DE_
ex-rooksters	ex-rookster	ZNW:MRV:DE_
tangrams	tangram	ZNW:MRV:DE_
fantasmata	fantasma	ZNW:MRV:DE_
ad-liminabezoeken	ad-liminabezoek	ZNW:MRV:DE_
oppervlakteactieve	oppervlakteactief	BNW:STL:VRB
internethitje	internethit	ZNW:EKV:VRK:HET
internethits	internethit	ZNW:MRV:DE_
lng-tankers	lng-tanker	ZNW:MRV:DE_
knuttels	knuttel	ZNW:MRV:DE_
niet-socialistische	niet-socialistisch	BNW:STL:VRB
academicae	academica	ZNW:MRV:DE_
handycams	handycam	ZNW:MRV:DE_
anabolica	anabolicum	ZNW:MRV:DE_
excasso's	excasso	ZNW:MRV:DE_
volksgericht	volksgericht	BNW:STL:ONV
volksgerichte	volksgericht	BNW:STL:VRB
paardengek	paardengek	BNW:STL:ONV
paardengekke	paardengek	BNW:STL:VRB
winkel-wandelstraatjes	winkel-wandelstraat	ZNW:MRV:VRK:DE_
winkel-wandelstraten	winkel-wandelstraat	ZNW:MRV:DE_
werkkoffers	werkkoffer	ZNW:MRV:DE_
werkkoffertje	werkkoffer	ZNW:EKV:VRK:HET
4x4-auto's	4x4-auto	ZNW:MRV:DE_
scanstraatje	scanstraat	ZNW:EKV:VRK:HET
scanstraten	scanstraat	ZNW:MRV:DE_
premiebetalende	premiebetalend	BNW:STL:VRB
administratiegebouwtje	administratiegebouw	ZNW:EKV:VRK:HET
administratiegebouwtjes	administratiegebouw	ZNW:MRV:VRK:DE_
paardenbeulen	paardenbeul	ZNW:MRV:DE_
hotmails	hotmail	ZNW:MRV:DE_
lambieken	lambiek	ZNW:MRV:DE_
handenklappende	handenklappend	BNW:STL:VRB
technobeurs	technobeurs	ZNW:EKV:DE_
bustijden	bustijd	ZNW:MRV:DE_
etnografieën	etnografie	ZNW:MRV:DE_
pastisje	pastis	ZNW:EKV:VRK:HET
pastisjes	pastis	ZNW:MRV:VRK:DE_
ontkennend	ontkennend	BNW:STL:ONV
ontkennende	ontkennend	BNW:STL:VRB
ontkennends	ontkennend	BNW:STL:IET
ontkennender	ontkennend	BNW:VGR:ONV
ontkennenden	ontkennend	BNW:STL:MRV:DE_
legionella's	legionella	ZNW:MRV:DE_
portatief	portatief	ZNW:EKV:HET
portatieven	portatief	ZNW:MRV:DE_
bergères	bergère	ZNW:MRV:DE_
deponieën	deponie	ZNW:MRV:DE_
achenebbis	achenebbis	ZNW:EKV:DE_
achenebbisje	achenebbis	ZNW:EKV:VRK:HET
achenebbissen	achenebbis	ZNW:MRV:DE_
achenebbisjes	achenebbis	ZNW:MRV:VRK:DE_
draagolies	draagolie	ZNW:MRV:DE_
draagoliën	draagolie	ZNW:MRV:DE_
ongelijkwaardiger	ongelijkwaardig	BNW:VGR:ONV
ongelijkwaardigen	ongelijkwaardig	BNW:STL:MRV:DE_
pompernikkels	pompernikkel	ZNW:MRV:DE_
nijlreigers	nijlreiger	ZNW:MRV:DE_
Twittervolgers	Twittervolger	ZNW:MRV:DE_
art-nouveauhuizen	art-nouveauhuis	ZNW:MRV:DE_
opdringend	opdringend	BNW:STL:ONV
opdringende	opdringend	BNW:STL:VRB
opdringends	opdringend	BNW:STL:IET
opdringender	opdringend	BNW:VGR:ONV
opdringenden	opdringend	BNW:STL:MRV:DE_
ongekerstende	ongekerstend	BNW:STL:VRB
discretisaties	discretisatie	ZNW:MRV:DE_
AJC'ers	AJC'er	ZNW:MRV:DE_
eerstehands	eerstehands	BNW:STL:ONV
eerstehandse	eerstehands	BNW:STL:VRB
topweekenden	topweekend	ZNW:MRV:DE_
topweekendje	topweekend	ZNW:EKV:VRK:HET
topweekends	topweekend	ZNW:MRV:DE_
anti-europartijen	anti-europartij	ZNW:MRV:DE_
dolfijnachtige	dolfijnachtig	BNW:STL:VRB
hospites	hospes	ZNW:MRV:DE_
sf-schrijvers	sf-schrijver	ZNW:MRV:DE_
sf-schrijvertje	sf-schrijver	ZNW:EKV:VRK:HET
wolfspoten	wolfspoot	ZNW:MRV:DE_
slaap-T-shirts	slaap-T-shirt	ZNW:MRV:DE_
hulpontvangende	hulpontvangend	BNW:STL:VRB
moraliserend	moraliserend	BNW:STL:ONV
moraliserende	moraliserend	BNW:STL:VRB
moraliserends	moraliserend	BNW:STL:IET
moraliserender	moraliserend	BNW:VGR:ONV
moraliserenden	moraliserend	BNW:STL:MRV:DE_
candela's	candela	ZNW:MRV:DE_
clownsneusje	clownsneus	ZNW:EKV:VRK:HET
berenburgje	berenburg	ZNW:EKV:VRK:HET
berenburgjes	berenburg	ZNW:MRV:VRK:DE_
flambouwtje	flambouw	ZNW:EKV:VRK:HET
flambouwtjes	flambouw	ZNW:MRV:VRK:DE_
flambouwen	flambouw	ZNW:MRV:DE_
bladvoedingen	bladvoeding	ZNW:MRV:DE_
pantoffeldier	pantoffeldier	ZNW:EKV:HET
pantoffeldieren	pantoffeldier	ZNW:MRV:DE_
pantoffeldiertjes	pantoffeldier	ZNW:MRV:VRK:DE_
pantoffeldiertje	pantoffeldier	ZNW:EKV:VRK:HET
borrelend	borrelend	BNW:STL:ONV
borrelende	borrelend	BNW:STL:VRB
borrelendste	borrelend	BNW:OVR:VRB
borrelends	borrelend	BNW:STL:IET
borrelenden	borrelend	BNW:STL:MRV:DE_
psychologiseringen	psychologisering	ZNW:MRV:DE_
rammertje	rammer	ZNW:EKV:VRK:HET
rammertjes	rammer	ZNW:MRV:VRK:DE_
klokjesachtige	klokjesachtig	BNW:STL:VRB
voorjaarswinden	voorjaarswind	ZNW:MRV:DE_
voorjaarswindje	voorjaarswind	ZNW:EKV:VRK:HET
voorjaarswindjes	voorjaarswind	ZNW:MRV:VRK:DE_
ex-soapies	ex-soapie	ZNW:MRV:DE_
anti-Palestijnse	anti-Palestijns	BNW:STL:VRB
koketterieën	koketterie	ZNW:MRV:DE_
hertzen	hertz	ZNW:MRV:DE_
megahertzen	megahertz	ZNW:MRV:DE_
gigahertzen	gigahertz	ZNW:MRV:DE_
politiekertje	politieker	ZNW:EKV:VRK:HET
politiekertjes	politieker	ZNW:MRV:VRK:DE_
wegparcoursen	wegparcours	ZNW:MRV:DE_
terravorming	terravorming	ZNW:EKV:DE_
niet-rooksters	niet-rookster	ZNW:MRV:DE_
niet-rookstertje	niet-rookster	ZNW:EKV:VRK:HET
portatiefje	portatief	ZNW:EKV:VRK:HET
portatiefjes	portatief	ZNW:MRV:VRK:DE_
priemend	priemend	BNW:STL:ONV
priemende	priemend	BNW:STL:VRB
priemendste	priemend	BNW:OVR:VRB
priemends	priemend	BNW:STL:IET
priemender	priemend	BNW:VGR:ONV
beprijzingen	beprijzing	ZNW:MRV:DE_
sjoelbakken	sjoelbakken	WKW:TGW:INF
sjoelbak	sjoelbakken	WKW:TGW:1EP
sjoelbakte	sjoelbakken	WKW:VLT:1EP
gesjoelbakt	sjoelbakken	WKW:VTD:ONV
sjoelbakkend	sjoelbakken	WKW:ODW:ONV
sjoelbakt	sjoelbakken	WKW:TGW:3EP
sjoelbakten	sjoelbakken	WKW:VLT:INF
eggheads	egghead	ZNW:MRV:DE_
pengreepje	pengreep	ZNW:EKV:VRK:HET
pengrepen	pengreep	ZNW:MRV:DE_
kapitaalinbrengen	kapitaalinbreng	ZNW:MRV:DE_
omzethuren	omzethuur	ZNW:MRV:DE_
radionuclides	radionuclide	ZNW:MRV:DE_
nuclide	nuclide	ZNW:EKV
nucliden	nuclide	ZNW:MRV:DE_
nuclides	nuclide	ZNW:MRV:DE_
verwaaiingen	verwaaiing	ZNW:MRV:DE_
cretonnes	cretonne	ZNW:MRV:DE_
neutraliteitsverklaringen	neutraliteitsverklaring	ZNW:MRV:DE_
fietsvierdaagses	fietsvierdaagse	ZNW:MRV:DE_
wandelvierdaagses	wandelvierdaagse	ZNW:MRV:DE_
neuropeptides	neuropeptide	ZNW:MRV:DE_
coca-colaflesje	coca-colafles	ZNW:EKV:VRK:HET
coca-colaflesjes	coca-colafles	ZNW:MRV:VRK:DE_
coca-colaflessen	coca-colafles	ZNW:MRV:DE_
zelfbedieningsrestaurantje	zelfbedieningsrestaurant	ZNW:EKV:VRK:HET
nietsnuttende	nietsnuttend	BNW:STL:VRB
railklemmen	railklem	ZNW:MRV:DE_
muizengiffen	muizengif	ZNW:MRV:DE_
piepmuisje	piepmuis	ZNW:EKV:VRK:HET
piepmuizen	piepmuis	ZNW:MRV:DE_
politiekringen	politiekring	ZNW:MRV:DE_
opduvel	opduvel	ZNW:EKV:DE_
opduvels	opduvel	ZNW:MRV:DE_
vouwstepje	vouwstep	ZNW:EKV:VRK:HET
vouwstepjes	vouwstep	ZNW:MRV:VRK:DE_
vouwsteppen	vouwstep	ZNW:MRV:DE_
jeremiaden	jeremiade	ZNW:MRV:DE_
secondelang	secondelang	BNW:STL:ONV
secondelange	secondelang	BNW:STL:VRB
kerkbranden	kerkbrand	ZNW:MRV:DE_
schotklokken	schotklok	ZNW:MRV:DE_
wildzwijnen	wildzwijn	ZNW:MRV:DE_
wildzwijntje	wildzwijn	ZNW:EKV:VRK:HET
wildzwijntjes	wildzwijn	ZNW:MRV:VRK:DE_
zandvangen	zandvang	ZNW:MRV:DE_
referendabel	referendabel	BNW:STL:ONV
referendabele	referendabel	BNW:STL:VRB
piasserigst	piasserig	BNW:OVR:ONV
piasserigste	piasserig	BNW:OVR:VRB
piasseriger	piasserig	BNW:VGR:ONV
piasserigere	piasserig	BNW:VGR:VRB
tv-foons	tv-foon	ZNW:MRV:DE_
kreteks	kretek	ZNW:MRV:DE_
smachtend	smachtend	BNW:STL:ONV
smachtende	smachtend	BNW:STL:VRB
ex-sekteleden	ex-sektelid	ZNW:MRV:DE_
junctuurs	junctuur	ZNW:MRV:DE_
ontluisteringen	ontluistering	ZNW:MRV:DE_
mora's	mora	ZNW:MRV:DE_
grampositieve	grampositief	BNW:STL:VRB
Nisskakammen	Nisskakam	ZNW:MRV:DE_
lampetkommen	lampetkom	ZNW:MRV:DE_
censussen	census	ZNW:MRV:DE_
gelegenheidsgedichtjes	gelegenheidsgedicht	ZNW:MRV:VRK:DE_
supportersrellen	supportersrel	ZNW:MRV:DE_
supportersrelletjes	supportersrel	ZNW:MRV:VRK:DE_
topselecties	topselectie	ZNW:MRV:DE_
niet-ariërs	niet-ariër	ZNW:MRV:DE_
verplegingen	verpleging	ZNW:MRV:DE_
dagverplegingen	dagverpleging	ZNW:MRV:DE_
lesideetjes	lesidee	ZNW:MRV:VRK:DE_
lesideeën	lesidee	ZNW:MRV:DE_
rapsodies	rapsodie	ZNW:MRV:DE_
herverkiezingscampagnes	herverkiezingscampagne	ZNW:MRV:DE_
antisandinistische	antisandinistisch	BNW:STL:VRB
onaangediende	onaangediend	BNW:STL:VRB
anti-individualistische	anti-individualistisch	BNW:STL:VRB
anti-individualistisch	anti-individualistisch	BNW:STL:IET
anti-individualistischer	anti-individualistisch	BNW:VGR:ONV
niet-accountants	niet-accountant	ZNW:MRV:DE_
ablauten	ablaut	ZNW:MRV:DE_
autotypieën	autotypie	ZNW:MRV:DE_
primarii	primarius	ZNW:MRV:DE_
rozelaartje	rozelaar	ZNW:EKV:VRK:HET
rozelaartjes	rozelaar	ZNW:MRV:VRK:DE_
rozelaars	rozelaar	ZNW:MRV:DE_
rozelaren	rozelaar	ZNW:MRV:DE_
historiografieën	historiografie	ZNW:MRV:DE_
suffigheden	suffigheid	ZNW:MRV:DE_
eclairtje	eclair	ZNW:EKV:VRK:HET
eclairtjes	eclair	ZNW:MRV:VRK:DE_
warrigheden	warrigheid	ZNW:MRV:DE_
uitgezakt	uitgezakt	BNW:STL:ONV
uitgezakte	uitgezakt	BNW:STL:VRB
bewonderend	bewonderend	BNW:STL:ONV
bewonderende	bewonderend	BNW:STL:VRB
bewonderends	bewonderend	BNW:STL:IET
bewonderenden	bewonderend	BNW:STL:MRV:DE_
uitgezakts	uitgezakt	BNW:STL:IET
uitgezakter	uitgezakt	BNW:VGR:ONV
uitgezakten	uitgezakt	BNW:STL:MRV:DE_
seksstakingen	seksstaking	ZNW:MRV:DE_
riemclipje	riemclip	ZNW:EKV:VRK:HET
riemclips	riemclip	ZNW:MRV:DE_
krabbenmanden	krabbenmand	ZNW:MRV:DE_
krabbenmandje	krabbenmand	ZNW:EKV:VRK:HET
dataoverdrachten	dataoverdracht	ZNW:MRV:DE_
joego's	joego	ZNW:MRV:DE_
dolichocefaal	dolichocefaal	BNW:STL:ONV
dolichocefale	dolichocefaal	BNW:STL:VRB
passiefschool	passiefschool	ZNW:EKV:DE_
passiefscholen	passiefschool	ZNW:MRV:DE_
inplaatsstelling	inplaatsstelling	ZNW:EKV:DE_
ontsmettend	ontsmettend	BNW:STL:ONV
ontsmettende	ontsmettend	BNW:STL:ONV
ontsmettends	ontsmettend	BNW:STL:IET
zwoegend	zwoegend	BNW:STL:ONV
zwoegende	zwoegend	BNW:STL:VRB
zwoegender	zwoegend	BNW:VGR:ONV
zwoegenden	zwoegend	BNW:STL:MRV:DE_
promo-exemplaren	promo-exemplaar	ZNW:MRV:DE_
G-wedstrijden	G-wedstrijd	ZNW:MRV:DE_
sudoku'tje	sudoku	ZNW:EKV:VRK:HET
sudoku'tjes	sudoku	ZNW:MRV:VRK:DE_
roofings	roofing	ZNW:MRV:DE_
oligopoliën	oligopolie	ZNW:MRV:DE_
pacmannetje	pacman	ZNW:EKV:VRK:HET
pacmannetjes	pacman	ZNW:MRV:VRK:DE_
dagelijksheden	dagelijksheid	ZNW:MRV:DE_
trippelpasje	trippelpas	ZNW:EKV:VRK:HET
trippelpasjes	trippelpas	ZNW:MRV:VRK:DE_
trippelpassen	trippelpas	ZNW:MRV:DE_
niet-taalgebonden	niet-taalgebonden	BNW:STL:VRB
tweekamerappartementjes	tweekamerappartement	ZNW:MRV:VRK:DE_
antichristelijks	antichristelijk	BNW:STL:IET
antichristelijker	antichristelijk	BNW:VGR:ONV
antichristelijken	antichristelijk	BNW:STL:MRV:DE_
antioxidant	antioxidant	BNW:STL:ONV
antioxidante	antioxidant	BNW:STL:VRB
antioxidantste	antioxidant	BNW:OVR:VRB
antioxidants	antioxidant	BNW:STL:IET
antioxidanten	antioxidant	BNW:STL:MRV:DE_
kilohertzen	kilohertz	ZNW:MRV:DE_
oud-profspelers	oud-profspeler	ZNW:MRV:DE_
mantelzorgende	mantelzorgend	BNW:STL:VRB
autokrikje	autokrik	ZNW:EKV:VRK:HET
autokrikken	autokrik	ZNW:MRV:DE_
havikneuzen	havikneus	ZNW:MRV:DE_
rock-'n-rollplaten	rock-'n-rollplaat	ZNW:MRV:DE_
zelfmisleidingen	zelfmisleiding	ZNW:MRV:DE_
derboeka's	derboeka	ZNW:MRV:DE_
schijnheilen	schijnheil	ZNW:MRV:DE_
pulverachtige	pulverachtig	BNW:STL:VRB
snoeiwijzen	snoeiwijze	ZNW:MRV:DE_
olie-en-azijnstellen	olie-en-azijnstel	ZNW:MRV:DE_
olie-en-azijnstelletje	olie-en-azijnstel	ZNW:EKV:VRK:HET
olie-en-azijnstelletjes	olie-en-azijnstel	ZNW:MRV:VRK:DE_
verzettelijke	verzettelijk	BNW:STL:VRB
verzettelijkste	verzettelijk	BNW:OVR:VRB
verzettelijker	verzettelijk	BNW:VGR:ONV
verzettelijken	verzettelijk	BNW:STL:MRV:DE_
tevredenheidenquêtes	tevredenheidenquête	ZNW:MRV:DE_
schildwachts	schildwacht	ZNW:MRV:DE_
kittelachtigst	kittelachtig	BNW:OVR:ONV
kittelachtigste	kittelachtig	BNW:OVR:VRB
kittelachtiger	kittelachtig	BNW:VGR:ONV
kittelachtigere	kittelachtig	BNW:VGR:VRB
contacttalen	contacttaal	ZNW:MRV:DE_
rock-'n-rollzangers	rock-'n-rollzanger	ZNW:MRV:DE_
nietsnutten	nietsnutten	WKW:TGW:INF
nietsnut	nietsnutten	WKW:TGW:1EP
nietnutte	nietsnutten	WKW:VLT:1EP
genietsnut	nietsnutten	WKW:VTD:ONV
nietsnuttend	nietsnutten	WKW:ODW:ONV
nietsnutte	nietsnutten	WKW:AWS
nietsnut	nietsnutten	WKW:TGW:3EP
wegenissen	wegenis	ZNW:MRV:DE_
niet-algemene	niet-algemeen	BNW:STL:VRB
destabilisaties	destabilisatie	ZNW:MRV:DE_
molesten	molest	ZNW:MRV:DE_
sieverts	sievert	ZNW:MRV:DE_
escrows	escrow	ZNW:MRV:DE_
binnenhuisarchitecturen	binnenhuisarchitectuur	ZNW:MRV:DE_
middenleeftijden	middenleeftijd	ZNW:MRV:DE_
medeondertekenaren	medeondertekenaar	ZNW:MRV:DE_
geneesmiddelenindustrieën	geneesmiddelenindustrie	ZNW:MRV:DE_
startersaftrekken	startersaftrek	ZNW:MRV:DE_
informantes	informante	ZNW:MRV:DE_
linksbinnens	linksbinnen	ZNW:MRV:DE_
vexaties	vexatie	ZNW:MRV:DE_
kalfshaasje	kalfshaas	ZNW:EKV:VRK:HET
kalfshazen	kalfshaas	ZNW:MRV:DE_
niet-alfabetische	niet-alfabetisch	BNW:STL:VRB
crapuultje	crapuul	ZNW:EKV:VRK:HET
crapuultjes	crapuul	ZNW:MRV:VRK:DE_
crapulen	crapuul	ZNW:MRV:DE_
crapuuls	crapuul	ZNW:MRV:DE_
Canadees-Engelse	Canadees-Engels	BNW:STL:VRB
Canadees-Engels	Canadees-Engels	ZNW:EKV:HET
naasthogere	naasthoger	BNW:STL:VRB
Zuid-Afrikaans-Engels	Zuid-Afrikaans-Engels	ZNW:EKV:HET
euroloodvrij	euroloodvrij	BNW:STL:ONV
euroloodvrije	euroloodvrij	BNW:STL:VRB
euroloodvrij	euroloodvrij	ZNW:EKV
eindoverwinnaar	eindoverwinnaar	ZNW:EKV:DE_
eindoverwinnaars	eindoverwinnaar	ZNW:MRV:DE_
inplaatsstellingen	inplaatsstelling	ZNW:MRV:DE_
warmteterugwinunit	warmteterugwinunit	ZNW:EKV:DE_
ruitersverenigingen	ruitersvereniging	ZNW:MRV:DE_
boekentoptiens	boekentoptien	ZNW:MRV:DE_
samenzweringstheorietje	samenzweringstheorie	ZNW:EKV:VRK:HET
consumentgerichter	consumentgericht	BNW:VGR:ONV
doodsprenten	doodsprent	ZNW:MRV:DE_
doodsprentje	doodsprent	ZNW:EKV:VRK:HET
doodsprentjes	doodsprent	ZNW:MRV:VRK:DE_
toervaarten	toervaart	ZNW:MRV:DE_
bovs	bov	ZNW:MRV:DE_
relativiteitsprincipes	relativiteitsprincipe	ZNW:MRV:DE_
niet-arbeidsgebonden	niet-arbeidsgebonden	BNW:STL:VRB
menageries	menagerie	ZNW:MRV:DE_
afpoeieringen	afpoeiering	ZNW:MRV:DE_
zwaaiingen	zwaaiing	ZNW:MRV:DE_
antiwitwaswetten	antiwitwaswet	ZNW:MRV:DE_
rotisserieën	rotisserie	ZNW:MRV:DE_
naamgebonden	naamgebonden	BNW:STL:VRB
weekedities	weekeditie	ZNW:MRV:DE_
persbabbels	persbabbel	ZNW:MRV:DE_
persbabbeltjes	persbabbel	ZNW:MRV:VRK:DE_
sf-achtige	sf-achtig	BNW:STL:VRB
satellietcommunicaties	satellietcommunicatie	ZNW:MRV:DE_
verootmoedigingen	verootmoediging	ZNW:MRV:DE_
persoonsverheerlijkingen	persoonsverheerlijking	ZNW:MRV:DE_
poortaderen	poortader	ZNW:MRV:DE_
niet-christelijks	niet-christelijk	BNW:STL:IET
niet-christelijken	niet-christelijk	BNW:STL:MRV:DE_
astma's	astma	ZNW:MRV:DE_
fadings	fading	ZNW:MRV:DE_
lno's	lno	ZNW:MRV:DE_
warmteterugwinunits	warmteterugwinunit	ZNW:MRV:DE_
verwateringen	verwatering	ZNW:MRV:DE_
valentijnen	valentijn	ZNW:MRV:DE_
geseculariseerd	geseculariseerd	BNW:STL:ONV
geseculariseerde	geseculariseerd	BNW:STL:VRB
geseculariseerder	geseculariseerd	BNW:VGR:ONV
geseculariseerden	geseculariseerd	BNW:STL:MRV:DE_
luxaflexje	luxaflex	ZNW:EKV:VRK:HET
luxaflexjes	luxaflex	ZNW:MRV:VRK:DE_
afgetrapt	afgetrapt	BNW:STL:ONV
afgetrapte	afgetrapt	BNW:STL:VRB
afgetrapts	afgetrapt	BNW:STL:IET
afgetrapter	afgetrapt	BNW:VGR:ONV
afgetrapten	afgetrapt	BNW:STL:MRV:DE_
wankelend	wankelend	BNW:STL:ONV
wankelende	wankelend	BNW:STL:VRB
wankelendste	wankelend	BNW:OVR:VRB
wankelends	wankelend	BNW:STL:IET
wankelender	wankelend	BNW:VGR:ONV
wankelenden	wankelend	BNW:STL:MRV:DE_
pitaatje	pita	ZNW:EKV:VRK:HET
pitaatjes	pita	ZNW:MRV:VRK:DE_
hippodrooms	hippodroom	ZNW:MRV:DE_
kamelotten	kamelot	ZNW:MRV:DE_
pda'tje	pda	ZNW:EKV:VRK:HET
pda'tjes	pda	ZNW:MRV:VRK:DE_
Samen-op-Wegkerken	Samen-op-Wegkerk	ZNW:MRV:DE_
wateraanvoeren	wateraanvoer	ZNW:MRV:DE_
telluria	tellurium	ZNW:MRV:DE_
overspeligheden	overspeligheid	ZNW:MRV:DE_
pikanterietje	pikanterie	ZNW:EKV:VRK:HET
pikanterietjes	pikanterie	ZNW:MRV:VRK:DE_
kortaangebondener	kortaangebonden	BNW:VGR:ONV
vogelvluchtperspectieven	vogelvluchtperspectief	ZNW:MRV:DE_
klassenmappen	klassenmap	ZNW:MRV:DE_
inter-Amerikaanse	inter-Amerikaans	BNW:STL:VRB
facsimileetje	facsimile	ZNW:EKV:VRK:HET
facsimileetjes	facsimile	ZNW:MRV:VRK:DE_
ex-profspelers	ex-profspeler	ZNW:MRV:DE_
pertinenties	pertinentie	ZNW:MRV:DE_
isolatiebanden	isolatieband	ZNW:MRV:DE_
zweef-tv	zweef-tv	ZNW:EKV:DE_
brillendoek	brillendoek	ZNW:EKV
brillendoeken	brillendoek	ZNW:MRV:DE_
brillendoekje	brillendoek	ZNW:EKV:VRK:HET
brillendoekjes	brillendoek	ZNW:MRV:VRK:DE_
art-decowoningen	art-decowoning	ZNW:MRV:DE_
mol	mol	MEH
de-ioniseer	de-ioniseren	WKW:TGW:1EP
de-ioniseerde	de-ioniseren	WKW:VLT:1EP
gede-ioniseerd	de-ioniseren	WKW:VTD:ONV
werkgelegenheidsgraden	werkgelegenheidsgraad	ZNW:MRV:DE_
onnozelaartje	onnozelaar	ZNW:EKV:VRK:HET
onnozelaartjes	onnozelaar	ZNW:MRV:VRK:DE_
ziektebriefje	ziektebrief	ZNW:EKV:VRK:HET
ziektebriefjes	ziektebrief	ZNW:MRV:VRK:DE_
ziektebrieven	ziektebrief	ZNW:MRV:DE_
multisensorisch	multisensorisch	BNW:STL:ONV
Neutral	Neutral	ENM:PRD
Persil	Persil	ENM:PRD
menseigen	menseigen	BNW:STL:ONV
lighttrain	lighttrain	ZNW:EKV:DE_
klamvochtig	klamvochtig	BNW:STL:ONV
wendes	wende	ZNW:MRV:DE_
eeuwwenden	eeuwwende	ZNW:MRV:DE_
eeuwwendes	eeuwwende	ZNW:MRV:DE_
diminutiefje	diminutief	ZNW:EKV:VRK:HET
diminutiefjes	diminutief	ZNW:MRV:VRK:DE_
paroxismen	paroxisme	ZNW:MRV:DE_
paroxismes	paroxisme	ZNW:MRV:DE_
landvast	landvast	ZNW:EKV:DE_
landvasten	landvast	ZNW:MRV:DE_
landvastje	landvast	ZNW:EKV:VRK:HET
landvastjes	landvast	ZNW:MRV:VRK:DE_
klamvochtige	klamvochtig	BNW:STL:VRB
lighttrains	lighttrain	ZNW:MRV:DE_
menseigen	menseigen	BNW:STL:VRB
menseigens	menseigen	BNW:STL:IET
multisensorische	multisensorisch	BNW:STL:VRB
multisensorisch	multisensorisch	BNW:STL:IET
studieontwijkend	studieontwijkend	BNW:STL:ONV
struis	struis	ZNW:EKV:DE_
struisje	struis	ZNW:EKV:VRK:HET
struisjes	struis	ZNW:MRV:VRK:DE_
struisen	struis	ZNW:MRV:DE_
sodemietertje	sodemieter	ZNW:EKV:VRK:HET
sodemieters	sodemieter	ZNW:MRV:VRK:DE_
terrientje	terrine	ZNW:EKV:VRK:HET
terrientjes	terrine	ZNW:MRV:VRK:DE_
teleologieën	teleologie	ZNW:MRV:DE_
mythologiseringen	mythologisering	ZNW:MRV:DE_
nooddruften	nooddruft	ZNW:MRV:DE_
geraffineerdheden	geraffineerdheid	ZNW:MRV:DE_
flipflopje	flipflop	ZNW:EKV:VRK:HET
flipflops	flipflop	ZNW:MRV:VRK:DE_
studieontwijkende	studieontwijkend	BNW:STL:VRB
juniors	junior	ZNW:MRV:DE_
milieu-effecten	milieu-effect	ZNW:MRV:DE_
secretaris-directeuren	secretaris-directeur	ZNW:MRV:DE_
business-to-consumer	business-to-consumer	BNW:STL:VRB
overdrukkers	overdrukker	ZNW:MRV:DE_
priester-leraars	priester-leraar	ZNW:MRV:DE_
priester-leraren	priester-leraar	ZNW:MRV:DE_
knip-en-plakwerkje	knip-en-plakwerk	ZNW:EKV:VRK:HET
knip-en-plakwerkjes	knip-en-plakwerk	ZNW:MRV:VRK:DE_
alleeën	allee	ZNW:MRV:DE_
Korangeleerden	Korangeleerde	ZNW:MRV:DE_
hora's	hora	ZNW:MRV:DE_
starogen	starogen	WKW:TGW:INF
staroog	starogen	WKW:TGW:1EP
staroogde	starogen	WKW:VLT:1EP
gestaroogd	starogen	WKW:VTD:ONV
langstudeerboetes	langstudeerboete	ZNW:MRV:DE_
contractors	contractor	ZNW:MRV:DE_
wetvoorstellen	wetvoorstel	ZNW:MRV:DE_
zelforganiserende	zelforganiserend	BNW:STL:VRB
beeldkwaliteitplannen	beeldkwaliteitplan	ZNW:MRV:DE_
appstores	appstore	ZNW:MRV:DE_
masterbedrooms	masterbedrooms	ZNW:MRV:DE_
masterbedrooms	masterbedroom	ZNW:MRV:DE_
middenpunten	middenpunt	ZNW:MRV:DE_
middenpuntje	middenpunt	ZNW:EKV:VRK:HET
funparken	funpark	ZNW:MRV:DE_
funparkje	funpark	ZNW:EKV:VRK:HET
rechtermuurtje	rechtermuur	ZNW:EKV:VRK:HET
echocardiografieën	echocardiografie	ZNW:MRV:DE_
multiculturen	multicultuur	ZNW:MRV:DE_
cloudgebaseerde	cloudgebaseerd	BNW:STL:VRB
driedimensionele	driedimensioneel	BNW:STL:VRB
chickie	chick	ZNW:EKV:VRK:HET
chickies	chick	ZNW:MRV:VRK:DE_
kentekencards	kentekencard	ZNW:MRV:DE_
ambachtscholen	ambachtschool	ZNW:MRV:DE_
sleepers	sleeper	ZNW:MRV:DE_
wrappers	wrapper	ZNW:MRV:DE_
hiv-testen	hiv-test	ZNW:MRV:DE_
hiv-tests	hiv-test	ZNW:MRV:DE_
zachthouten	zachthout	ZNW:MRV:DE_
grootadmiraals	grootadmiraal	ZNW:MRV:DE_
showdowns	showdown	ZNW:MRV:DE_
rechtermuizen	rechtermuis	ZNW:MRV:DE_
dierexperimentele	dierexperimenteel	BNW:STL:VRB
multiprobleemgezinnen	multiprobleemgezin	ZNW:MRV:DE_
Sovjetregeringen	Sovjetregering	ZNW:MRV:DE_
flipcharts	flipchart	ZNW:MRV:DE_
eropvolgende	eropvolgend	BNW:STL:VRB
visserscheepje	visserschip	ZNW:EKV:VRK:HET
visserscheepjes	visserschip	ZNW:MRV:VRK:DE_
visserschepen	visserschip	ZNW:MRV:DE_
driekwartbroeken	driekwartbroek	ZNW:MRV:DE_
driekwartbroekje	driekwartbroek	ZNW:EKV:VRK:HET
senaatsverkiezingen	senaatsverkiezing	ZNW:MRV:DE_
eigenbewegingen	eigenbeweging	ZNW:MRV:DE_
reuzenschepen	reuzenschip	ZNW:MRV:DE_
meerpuntssluitingen	meerpuntssluiting	ZNW:MRV:DE_
salesorganisaties	salesorganisatie	ZNW:MRV:DE_
postchristelijke	postchristelijk	BNW:STL:VRB
nauwverholen	nauwverholen	BNW:STL:VRB
levenbedrijven	levenbedrijf	ZNW:MRV:DE_
zelfgaven	zelfgave	ZNW:MRV:DE_
zelfgaves	zelfgave	ZNW:MRV:DE_
vijfpuntsschaaltje	vijfpuntsschaal	ZNW:EKV:VRK:HET
vijfpuntsschaaltjes	vijfpuntsschaal	ZNW:MRV:VRK:DE_
vijfpuntsschalen	vijfpuntsschaal	ZNW:MRV:DE_
bodyscrubs	bodyscrub	ZNW:MRV:DE_
gatekeepers	gatekeeper	ZNW:MRV:DE_
persoongegeven	persoongegeven	ZNW:EKV:HET
persoongegevens	persoongegeven	ZNW:MRV:DE_
oberkelners	oberkelner	ZNW:MRV:DE_
wederbeleggingsvergoedingen	wederbeleggingsvergoeding	ZNW:MRV:DE_
landcommanderijen	landcommanderij	ZNW:MRV:DE_
derde-belanghebbenden	derde-belanghebbende	ZNW:MRV:DE_
wijdgeopende	wijdgeopend	BNW:STL:VRB
hotshots	hotshot	ZNW:MRV:DE_
weerssituaties	weerssituatie	ZNW:MRV:DE_
Koranverzen	Koranvers	ZNW:MRV:DE_
scartkabels	scartkabel	ZNW:MRV:DE_
scartkabeltje	scartkabel	ZNW:EKV:VRK:HET
buzzwords	buzzword	ZNW:MRV:DE_
kandidatuurstellingen	kandidatuurstelling	ZNW:MRV:DE_
eerststervenden	eerststervende	ZNW:MRV:DE_
stervensdrukke	stervensdruk	BNW:STL:VRB
onderschoeiingen	onderschoeiing	ZNW:MRV:DE_
minibikes	minibike	ZNW:MRV:DE_
winterbijen	winterbij	ZNW:MRV:DE_
winterbijtjes	winterbij	ZNW:MRV:VRK:DE_
memoryspelen	memoryspel	ZNW:MRV:DE_
memoryspelletje	memoryspel	ZNW:EKV:VRK:HET
memoryspelletjes	memoryspel	ZNW:MRV:VRK:DE_
memoryspellen	memoryspel	ZNW:MRV:DE_
refugehuizen	refugehuis	ZNW:MRV:DE_
erevoorzitterschappen	erevoorzitterschap	ZNW:MRV:DE_
vlogsters	vlogster	ZNW:MRV:DE_
ondergefinancierde	ondergefinancierd	BNW:STL:VRB
verblijfvergunningen	verblijfvergunning	ZNW:MRV:DE_
ontstekingremmende	ontstekingremmend	BNW:STL:VRB
keizerstronen	keizerstroon	ZNW:MRV:DE_
eilandsbesluiten	eilandsbesluit	ZNW:MRV:DE_
sweepstakes	sweepstake	ZNW:MRV:DE_
brandstofcelauto's	brandstofcelauto	ZNW:MRV:DE_
stentplaatsingen	stentplaatsing	ZNW:MRV:DE_
policiers	policier	ZNW:MRV:DE_
spoorboekloze	spoorboekloos	BNW:STL:VRB
cisterciënzerkloosters	cisterciënzerklooster	ZNW:MRV:DE_
andersglobaliseringsbewegingen	andersglobaliseringsbeweging	ZNW:MRV:DE_
tijdruimtelijke	tijdruimtelijk	BNW:STL:VRB
meester-timmerlieden	meester-timmerman	ZNW:MRV:DE_
meester-timmerlui	meester-timmerman	ZNW:MRV:DE_
verwijlinteresten	verwijlinterest	ZNW:MRV:DE_
kwantoren	kwantor	ZNW:MRV:DE_
hogerberoepschriften	hogerberoepschrift	ZNW:MRV:DE_
zelfonthullingen	zelfonthulling	ZNW:MRV:DE_
medeonderzoekers	medeonderzoeker	ZNW:MRV:DE_
bruggers	brugger	ZNW:MRV:DE_
zelfopenbaringen	zelfopenbaring	ZNW:MRV:DE_
troephuisje	troephuis	ZNW:EKV:VRK:HET
troephuisjes	troephuis	ZNW:MRV:VRK:DE_
troephuizen	troephuis	ZNW:MRV:DE_
integriteitschendingen	integriteitschending	ZNW:MRV:DE_
goedgemanierde	goedgemanierd	BNW:STL:VRB
weersvoorspellers	weersvoorspeller	ZNW:MRV:DE_
opendeurweekends	opendeurweekend	ZNW:MRV:DE_
postrevolutionair	postrevolutionair	BNW:STL:ONV
postrevolutionaire	postrevolutionair	BNW:STL:VRB
gevaarzettende	gevaarzettend	BNW:STL:VRB
gezichtvelden	gezichtveld	ZNW:MRV:DE_
schoenerbrikken	schoenerbrik	ZNW:MRV:DE_
Bijbelcursussen	Bijbelcursus	ZNW:MRV:DE_
studentstages	studentstage	ZNW:MRV:DE_
stadwandelingen	stadwandeling	ZNW:MRV:DE_
stadwandelingetje	stadwandeling	ZNW:EKV:VRK:HET
stadwandelingetjes	stadwandeling	ZNW:MRV:VRK:DE_
goedbewapende	goedbewapend	BNW:STL:VRB
overfinancieringen	overfinanciering	ZNW:MRV:DE_
onderdeelcommissies	onderdeelcommissie	ZNW:MRV:DE_
naamsverklaringen	naamsverklaring	ZNW:MRV:DE_
transpallets	transpallet	ZNW:MRV:DE_
transpalletten	transpallet	ZNW:MRV:DE_
riviergrondels	riviergrondel	ZNW:MRV:DE_
riviergrondeltjes	riviergrondel	ZNW:MRV:VRK:DE_
kopschoppers	kopschopper	ZNW:MRV:DE_
kopschoppertje	kopschopper	ZNW:EKV:VRK:HET
kopschoppertjes	kopschopper	ZNW:MRV:VRK:DE_
kamerbezettingen	kamerbezetting	ZNW:MRV:DE_
zegezekere	zegezeker	BNW:STL:VRB
antiburgerlijke	antiburgerlijk	BNW:STL:VRB
omhooggerichte	omhooggericht	BNW:STL:VRB
weigeringgronden	weigeringgrond	ZNW:MRV:DE_
vliegvlugge	vliegvlug	BNW:STL:VRB
vierkamerwoningen	vierkamerwoning	ZNW:MRV:DE_
reuzebenieuwde	reuzebenieuwd	BNW:STL:VRB
verkoopsteams	verkoopsteam	ZNW:MRV:DE_
oranjegekleurde	oranjegekleurd	BNW:STL:VRB
marktimperfecties	marktimperfectie	ZNW:MRV:DE_
inburgeringexamens	inburgeringexamen	ZNW:MRV:DE_
wapendroppingen	wapendropping	ZNW:MRV:DE_
wapendroppings	wapendropping	ZNW:MRV:DE_
senaatslijsten	senaatslijst	ZNW:MRV:DE_
wederbeleggingen	wederbelegging	ZNW:MRV:DE_
voordrachtsakten	voordrachtsakte	ZNW:MRV:DE_
voordrachtsaktes	voordrachtsakte	ZNW:MRV:DE_
hoogintelligente	hoogintelligent	BNW:STL:VRB
hoogintelligenten	hoogintelligent	BNW:STL:MRV:DE_
geelkuifkaketoes	geelkuifkaketoe	ZNW:MRV:DE_
zelfidentificaties	zelfidentificatie	ZNW:MRV:DE_
mijngemeenten	mijngemeente	ZNW:MRV:DE_
mijngemeentes	mijngemeente	ZNW:MRV:DE_
studiebelastingsuur	studiebelastingsuur	ZNW:EKV:HET
studiebelastingsuren	studiebelastingsuur	ZNW:MRV:DE_
sherryglaasje	sherryglas	ZNW:EKV:VRK:HET
sherryglaasjes	sherryglas	ZNW:MRV:VRK:DE_
sherryglazen	sherryglas	ZNW:MRV:DE_
benedictijnerabdijen	benedictijnerabdij	ZNW:MRV:DE_
screendumps	screendump	ZNW:MRV:DE_
geluidabsorberende	geluidabsorberend	BNW:STL:VRB
reuzenvogels	reuzenvogel	ZNW:MRV:DE_
halfwakkere	halfwakker	BNW:STL:VRB
hoogperformante	hoogperformant	BNW:STL:VRB
minestronesoepen	minestronesoep	ZNW:MRV:DE_
minestronesoepje	minestronesoep	ZNW:EKV:VRK:HET
Hyvespagina's	Hyvespagina	ZNW:MRV:DE_
legerimams	legerimam	ZNW:MRV:DE_
ruimtevarende	ruimtevarend	BNW:STL:VRB
allesdoordringende	allesdoordringend	BNW:STL:VRB
autorodeo's	autorodeo	ZNW:MRV:DE_
achtertrosje	achtertros	ZNW:EKV:VRK:HET
achtertrossen	achtertros	ZNW:MRV:DE_
teambuildingactiviteiten	teambuildingactiviteit	ZNW:MRV:DE_
jongensoog	jongensoog	ZNW:EKV:HET
jongensogen	jongensoog	ZNW:MRV:DE_
jongensoogjes	jongensoog	ZNW:MRV:VRK:DE_
doodstijdingen	doodstijding	ZNW:MRV:DE_
diepreligieuze	diepreligieus	BNW:STL:VRB
beschermenswaardige	beschermenswaardig	BNW:STL:VRB
beschermenswaardiger	beschermenswaardig	BNW:VGR:ONV
zwaargehavende	zwaargehavend	BNW:STL:VRB
realitychecks	realitycheck	ZNW:MRV:DE_
chapewerk	chapewerk	ZNW:EKV:HET
chapewerken	chapewerk	ZNW:MRV:DE_
postmaterialistische	postmaterialistisch	BNW:STL:VRB
allesverhullende	allesverhullend	BNW:STL:VRB
klimaatadaptieve	klimaatadaptief	BNW:STL:VRB
subhoofdstukje	subhoofdstuk	ZNW:EKV:VRK:HET
subhoofdstukjes	subhoofdstuk	ZNW:MRV:VRK:DE_
subhoofdstukken	subhoofdstuk	ZNW:MRV:DE_
kunstsecundaire	kunstsecundair	BNW:STL:VRB
meestbezochte	meestbezocht	BNW:STL:VRB
onderwerpsregels	onderwerpsregel	ZNW:MRV:DE_
langstudeerdersboetes	langstudeerdersboete	ZNW:MRV:DE_
