# deleted postag entries
#-------------------------------------------------------------------------------
# Do not add words here, but report them to languagetool@taaltik.nl
#-------------------------------------------------------------------------------
adviesonderwerp	adviesonderwerp	ZNW:EKV
agame	agame	ZNW:EKV
automaatbak	automaatbak	ZNW:EKV
bassiste	bassiste	ZNW:EKV
beaufort	beaufort	ZNW:EKV:HET
beenschild	beenschild	ZNW:EKV
bijstandgerechtigden	bijstandgerechtigden	ZNW:MRV:DE_
biocides	biocide	ZNW:MRV:DE_
blijde	blijde	ZNW:EKV
coschap	coschap	ZNW:EKV
democrate	democrate	ZNW:EKV
drieëndertigste	drieëndertigste	GET:RNG
eikenberkenbossen	eikenberkenbossen	ZNW:MRV:DE_
fibrose	fibrose	ZNW:EKV
fijnprak	fijnprak	ZNW:EKV:DE_
fijnprakken	fijnprak	ZNW:MRV:DE_
filigrein	filigrein	ZNW:EKV
forumonderwerp	forumonderwerp	ZNW:EKV
future	future	ZNW:EKV
glycogeen	glycogeen	ZNW:EKV
insjallah	insjallah	ZNW:EKV
kliko	kliko	ZNW:EKV
mede	mede	ZNW:EKV
meelzeef	meelzeef	ZNW:EKV
milieuschadelijke	milieuschadelijke	BNW:STL:VRB
mollusk	mollusk	ZNW:EKV
noor	noor	ZNW:EKV
orthese	orthese	ZNW:EKV
peristyles	peristyle	ZNW:MRV:DE_
polyester	polyester	ZNW:EKV:DE_
profiteur	profiteur	ZNW:EKV
profiteuren	profiteur	ZNW:MRV:DE_
ril	ril	ZNW:EKV
rivaal	rivaal	ZNW:EKV
rivale	rivale	ZNW:EKV
rondhol	rondhol	ZNW:EKV
rondhollen	rondholle	ZNW:MRV:DE_
scifi	scifi	ZNW:EKV
soca	soca	ZNW:EKV
speculum	speculum	ZNW:EKV
spierbonk	spierbonk	ZNW:EKV
stonde	stonde	ZNW:EKV
super-de-luxe	super-de-luxe	ZNW:EKV
teelbal	teelbal	ZNW:EKV
terroriste	terroriste	ZNW:EKV
thaiboksen	thaiboksen	WKW:INF:ZNW:HET
toptaak	toptaak	ZNW:EKV
tussenuit	tussenuit	ZNW:EKV:DE_
ulcus	ulcus	ZNW:EKV
verdiep	verdiep	ZNW:EKV
voorbezinktank	voorbezinktank	ZNW:EKV
voordeelset	voordeelset	ZNW:EKV
zelfvergoding	zelfvergoding	ZNW:EKV
zydeco	zydeco	ZNW:EKV
aangelijnden	aanlijnen	WKW:VTD:ZNW:MRV:DE_
getijde	getijde	ZNW:EKV
survey	survey	ZNW:EKV
jihadi	jihadi	ZNW:EKV
multiversum	multiversum	ZNW:EKV
anestheticum	anestheticum	ZNW:EKV
vendelier	vendelier	ZNW:EKV
rondholle	rondholle	ZNW:EKV
emulator	emulator	ZNW:EKV
kelkslipjes	kelkslip	ZNW:MRV:VRK:DE_
niet-mens	niet-mens	ZNW:EKV:DE_
VN-wapeninspecteur	VN-wapeninspecteur	ZNW:EKV:HET
ICT-leveranciers	ICT-leveranciers	ZNW:MRV:DE_
flitten	flitten	WKW:INF:ZNW:HET
aardingspennen	aardingspennen	ZNW:MRV:DE_
kalmeringspillen	kalmeringspillen	ZNW:MRV:DE_
milieuverontreinigende	milieuverontreinigende	BNW:STL:VRB
autopassen	autopassen	ZNW:MRV:DE_
facto	facto	DVW
energieprestatie-eisen	energieprestatie-eisen	ZNW:MRV:DE_
instellingswetten	instellingswetten	ZNW:MRV:DE_
verwerkingsstappen	verwerkingsstappen	ZNW:MRV:DE_
consensusrijkswetten	consensusrijkswetten	ZNW:MRV:DE_
rondebalenpersen	rondebalenpersen	ZNW:MRV:DE_
bezorgwijken	bezorgwijken	ZNW:MRV:DE_
krijgstribunen	krijgstribunen	ZNW:MRV:DE_
reinigingsstappen	reinigingsstappen	ZNW:MRV:DE_
veiligheidspakken	veiligheidspakken	ZNW:MRV:DE_
behangersbijtjes	behangersbijtjes	ZNW:MRV:VRK:DE_
proceduretalen	proceduretalen	ZNW:MRV:DE_
belastingboxen	belastingboxen	ZNW:MRV:DE_
hoofdwijken	hoofdwijken	ZNW:MRV:DE_
medewerkesters	medewerkester	ZNW:MRV:DE_
opvangtaken	opvangtaken	ZNW:MRV:DE_
permutatiegroepen	permutatiegroepen	ZNW:MRV:DE_
vriendenpassen	vriendenpassen	ZNW:MRV:DE_
strandwijken	strandwijken	ZNW:MRV:DE_
giechelbuien	giechelbuien	ZNW:MRV:DE_
restafvalbakken	restafvalbakken	ZNW:MRV:DE_
moerasmeren	moerasmeren	ZNW:MRV:DE_
deelpachters	deelpachters	ZNW:MRV:DE_
wegwerpmessen	wegwerpmessen	ZNW:MRV:DE_
moerasmeertje	moerasmeertje	ZNW:EKV:VRK:HET
aardschildpadden	aardschildpadden	ZNW:MRV:DE_
dorpskruideniers	dorpskruideniers	ZNW:MRV:DE_
regiotaxipassen	regiotaxipassen	ZNW:MRV:DE_
medewerkester	medewerkester	ZNW:EKV:DE_
rechtseenheidskamers	rechtseenheidskamers	ZNW:MRV:DE_
vruchtwaterzakken	vruchtwaterzakken	ZNW:MRV:DE_
beenschildje	beenschildje	ZNW:EKV:VRK:HET
watersluiers	watersluiers	ZNW:MRV:DE_
bintmiddel	bintmiddel	ZNW:EKV:HET
glioom	glioom	ZNW:EKV
rondholen	rondhol	ZNW:MRV:DE_
uitrolfases	uitrolfases	ZNW:MRV:DE_
appel-perenstroop	appel-perenstroop	ZNW:EKV
eiken-berkenbossen	eiken-berkenbossen	ZNW:MRV:DE_
ver-antwoord	ver-antwoord	BNW:STL:ONV
ver-antwoord	ver-antwoord	WKW:TGW:1EP
ver-antwoord	ver-antwoord	WKW:VTD:ONV
ravenbeksbeen	ravenbeksbeen	ZNW:EKV
blikbaar	blikbaar	BNW:STL:ONV
