cada vez	LOC_ADV
iPod touch	NPMNO00
iPod Touch	NPMNO00
Carles Puigdemont	NPMSSP0
Toni Comín	NPMSSP0
Clara Ponsatí	NPFSSP0
Beppe Grillo	NPMSSP0
Alí Babà	NPMSSP0
App Store	NPFSO00
Sinn Féin	NPMSO00
Tate Gallery	NPFSO00
Human Rights Watch	NPCSO00
Jeu de Paume	NPMSO00
Imperial College	NPMSO00
Galerías Preciados	NPCNO00
Pony Express	NPMSO00
ARN polimerasa	NCFS000
Las Condes	NPFPG00
Green Bay Packers	NPMPO00
Mies van der Rohe	NPMSSP0
van der Rohe	NPMSSP0
cinéma vérité	NCMS000
Abu Mazen	NPMSSP0
Riyad Mansur	NPMSSP0
Ahmed Yabari	NPMSSP0
Guilad Shalit	NPMSSP0
Ismail Haniye	NPMSSP0
Hisham Kandil	NPMSSP0
Jaled Mashal	NPMSSP0
Ezedin Al Kasem	NPCNO00
por fin	LOC_ADV
Septiembre Negro	NPMSO00
Setiembre Negro	NPMSO00
Microsoft Corporation	NPFSO00
Silicon Valley	NPMSG00
pro tempore	LOC_ADV
Aíd al Fitr	NCMS000
a largo plazo	LOC_ADV
a medio plazo	LOC_ADV
a corto plazo	LOC_ADV
Ricky Rubio	NPMS000
100 braza	NCMN000
van 't Hoff	NPMSSP0
rondó-sonata	NCMS000
rondó sonata	NCMS000
Force India	NPCNO00
Sahara Force India	NPCNO00
Champions League	NPFNO00
Europa League	NPFNO00
Microsoft Teams	NPCNO00
Marie Curie	NPFSSP0
Google Meet	NPCNO00
full time	LOC_ADV
full-time	LOC_ADV
part time	LOC_ADV
part-time	LOC_ADV
half time	LOC_ADV
half-time	LOC_ADV
Winona Ryder	NPFSSP0
Benjamin Netanyahu	NPMSSP0
Jair Bolsonaro	NPMSSP0
Nadia Boulanger	NPFSSP0
Jamal Khashoggi	NPMSSP0
Enzo Traverso	NPMSSP0
John Huston	NPMSSP0
Italo Calvino	NPMSSP0
Zsa Zsa Gabor	NPFSSP0
Min Aung Hlaing	NPMSSP0
Du Bois	NPCNSP0
Indiana Jones	NPMSSP0
Steve Bannon	NPMSSP0
Matteo Renzi	NPMSSP0
Giuseppe Conte	NPMSSP0
premio nobel	NCCS000
Super Smash Bros.	NPMNO00
presa canario	NCMS000
presas canarios	NCMP000
von Neumann	NPCNSP0
omega 3	AQ0CN0
omega-3	AQ0CN0
día y noche	LOC_ADV
Piero della Francesca	NPMSSP0
Banque Nationale de Paris	NPCSO00
BNP Paribas	NPCSO00
Banco Urquijo	NPMSO00
Marco Polo	NPMSSP0
Fosse Way	NPCSG00
Obrint Pas	NPMPO00
Hyde Park	NPMSG00
sobre monedero	NCMS000
sobres monedero	NCMP000
de una vez por todas	LOC_ADV
Leonard Bernstein	NPMSSP0
Adís Abeba	NPCSG00
University College	NCMS000
Ahora mismo	LOC_ADV
perro salsicha	NCMS000
perros salsicha	NCMP000
motor diésel	NCMS000
motores diésel	NCMP000
en buena medida	LOC_ADV
Walter Benjamin	NPMSSP0
boy band	NCFS000
boy bands	NCFP000
vía ferrata	NCFS000
vías ferratas	NCFP000
Agencia Independiente de Responsabilidad Fiscal	NPFSO00
Ernest Lluch	NPMSSP0
Chrome Store	NPFSO00
Italo Svevo	NPMSSP0
a continuación	LOC_ADV
Super League	NPFSO00
Grupo Zeta	NPMSO00
super a gusto	AQ0CN0
super de moda	AQ0CN0
super gran	AQ0CS0
Black Friday	NCMN000
Aung San Suu Kyi	NPFSSP0
Ramón y Cajal	NPCNSP0
a contrariis	LOC_ADV
a fortiori ratione	LOC_ADV
a pari	LOC_ADV
a quo	LOC_ADV
a simili	LOC_ADV
ad absurdum	LOC_ADV
ad extra	LOC_ADV
ad intra	LOC_ADV
ad kalendas graecas	LOC_ADV
ad nauseam	LOC_ADV
ad pedem litterae	LOC_ADV
ad personam	LOC_ADV
ad quem	LOC_ADV
affectio maritalis	LOC_ADV
animus iniuriandi	LOC_ADV
ante nuptias	LOC_ADV
bona fide	LOC_ADV
ceteris paribus	LOC_ADV
contra legem	LOC_ADV
corpus delicti	LOC_ADV
corpus iuris	LOC_ADV
cui prodest	LOC_ADV
cuique suum	LOC_ADV
cum grano salis	LOC_ADV
cum mica salis	LOC_ADV
de auditu	LOC_ADV
de cuius	LOC_ADV
de lege ferenda	LOC_ADV
de lege lata	LOC_ADV
de minimis	LOC_ADV
erga omnes	LOC_ADV
et seq.	LOC_ADV
et sequentes	LOC_ADV
et sequentia	LOC_ADV
ex lege	LOC_ADV
ex nunc	LOC_ADV
ex officio	LOC_ADV
ex professo	LOC_ADV
ex tunc	LOC_ADV
extra legem	LOC_ADV
extra tempora	LOC_ADV
facio ut des	LOC_ADV
facio ut facias	LOC_ADV
facta	LOC_ADV
non verba	LOC_ADV
favor filii	LOC_ADV
gratia et amore	LOC_ADV
i. a.	LOC_ADV
in absentia	LOC_ADV
in actu	LOC_ADV
in albis	LOC_ADV
in ambiguo	LOC_ADV
in diem	LOC_ADV
in dubio pro reo	LOC_ADV
in fine	LOC_ADV
in flagranti	LOC_ADV
in flagranti delicto	LOC_ADV
in itinere	LOC_ADV
in limine	LOC_ADV
in limine litis	LOC_ADV
in memoriam	LOC_ADV
in mente	LOC_ADV
in nuce	LOC_ADV
in perpetuum	LOC_ADV
in primis	LOC_ADV
in saecula saeculorum	LOC_ADV
in scriptis	LOC_ADV
in statu quo	LOC_ADV
in terminis	LOC_ADV
in voce	LOC_ADV
inaudita parte	LOC_ADV
inter alia	LOC_ADV
inter partes	LOC_ADV
intuitu personae	LOC_ADV
iuris continuatio	LOC_ADV
iuris tantum	LOC_ADV
ius cogens	LOC_ADV
ius in officium	LOC_ADV
ius sanguinis	LOC_ADV
ius soli	LOC_ADV
lex repetita	LOC_ADV
loco citato	LOC_ADV
locus standi	LOC_ADV
more uxorio	LOC_ADV
NB	LOC_ADV
ne bis in idem	LOC_ADV
onus probandi	LOC_ADV
op. cit.	LOC_ADV
ope legis	LOC_ADV
opere citato	LOC_ADV
opus citatum	LOC_ADV
rebus sic stantibus	LOC_ADV
reductio ad absurdum	NCCS000
reformatio in melius	NCFS000
reformatio in peius	NCFS000
salvo meliori	LOC_ADV
salvo meliori iudicio	LOC_ADV
solve et repete	LOC_ADV
sub conditione	LOC_ADV
ut infra	LOC_ADV
vacatio legis	LOC_ADV
verba volant, scripta manent	LOC_ADV
fake news	NCFP000
À Punt	NPCNO00
Georgie Dann	NPMSSP0
Creative Commons	NPCNO000
Lope de Aver	NPCNSP0
Green Mountains	NPFPG00
Cola Cao	NPMNO00
Ringo Starr	NPMSSP0
Tatxo Benet	NPMSSP0
Prosper Mérimée	NPMSSP00
veni, vidi, vici	LOC_ADV
Humpty Dumpty	NPMSSP00
Nancy Pelosi	NPFSSP00
Paul Celan	NPMSSP00
Super Mario Bros	NPMNO00
Super Mario Bros.	NPMNO00
Super Mario Brothers	NPMNO00
literatura beat	NCFS000
generación beat	NCFS000
herriko taberna	NCFS000
herriko tabernas	NCFP000
ora et labora	NCMS000
software espía	NCMS000
Luiz Inácio Lula	NPMSSP0
Lula da Silva	NPCNSP0
US-ASCII	NPCNO00
Red Hat	NPCNO00
Phoebe Waller-Bridge	NPFSSP0
Roberto Saviano	NPMSSP0
Thomas Piketty	NPMSSP0
Julien Sorel	NPMSSP0
Roald Dahl	NPMSSP0
Shimon Peres	NPMSSP0
nomina nuda	NCCP000
nomen nudum	NCCS000
nomina dubia	NCCP000
nomen dubium	NCCS000
DD. HH.	NCMP000
Satoshi Nakamoto	NPMSSP0
Charlie Hebdo	NPCSO00
cuarto de estar	NCMS000
cuartos de estar	NCMP000
hora punta	NCFS000
horas punta	NCFP000
hora valle	NCFS000
horas valle	NCFP000
start up	NCFS000
start ups	NCFP000
modelo T	NCMS000
boca abajo	LOC_ADV
boca arriba	LOC_ADV
perro policía	NCMS000
perros policía	NCMP000
en ayunas	LOC_ADV
The New Yorker	NPMSO00
The Atlantic	NPMSO00
Google Assistant	NCMS000
Pax Romana	NCFS000
Pax Americana	NCFS000
Bruce Lee	NPMSSP0
Unides Podem	NPCNO00
Theresa May	NPFSSP0
Angela Merkel	NPFSSP0
stop-motion	NCFS000
stop motion	NCFS000
Fabrizio del Dongo	NPMSSP0
la Caixa	NPFSO00
así mismo	LOC_ADV
centro derecha	NCCS000
centro izquierda	NCCS000
centro derechas	NCCP000
centro izquierdas	NCCP000
rebus sic stantibus	LOC_ADJ
pacta sunt servanda	LOC_ADJ
Ngũgĩ wa Thiong'o	NPMSSP0
Ngugi wa Thiong'o	NPMSSP0
Nyong'o	NPCNSP0
a fuego bajo	LOC_ADV
win-win	LOC_ADJ
win-lose	LOC_ADJ
lose-lose	LOC_ADJ
Viktor Orbán	NPMSSP0
Martin Luther King	NPMSSP0
Internet Explorer	NPMSO00
.NET	NPCNSP0
hit parade	NCMS000
prime time	NCMS000
dream team	NCMS000
ciudad estado	NCFS000
ciudades estado	NCFP000
Lluís Llach	NPMSO00
Der Spiegel	NPMSO00
Nagorno Karabaj	NPCSG00
Cola Cao	NPMNO00
toma y daca	NCMS000
Benjamin Franklin	NPMSO00
Nord Stream	NPMSO00
US Open	NPMSO00
Roland Garros	NPMSO00
Grand Slam	NPMSO00
Copa Davis	NPFSO00
Quim Torra	NPMSSP0
al por mayor	LOC_ADJ
oso panda	NCMS000
osos panda	NCMP000
AA. VV.	NCMP000
VV. AA.	NCMP000
CC. AA.	NCFP000
Western Electric	NPFSO00
Western Union	NPFSO00
Pink Floyd	NPMNO00
de noche	LOC_ADV
de día	LOC_ADV
a contrario sensu	LOC_ADV
a sensu contrario	LOC_ADV
Cannabis sativa	NCCS000
en la actualidad	LOC_ADV
a primera vista	LOC_ADV
rubio ceniza	NCMS000
Mahmud Abás	NPMSSP0
Ken Follet	NPMSSP0
Elena Ferrante	NPFSSP0
Blue Express	NPCSO00
Abu Dabi	NPCSG00
no agresión	NCFS000
no violencia	NCFS000
conjunto frontera	NCMS000
en menor medida	LOC_ADV
sin embargo	LOC_ADV
en cierta medida	LOC_ADV
hasta la actualidad	LOC_ADV
con frecuencia	LOC_ADV
hoy día	LOC_ADV
hoy en día	LOC_ADV
por mucho tiempo	LOC_ADV
en parte	LOC_ADV
en general	LOC_ADV
por defecto	LOC_ADV
Dagoll Dagom	NPCS
Charles Darwin	NPMSP00
Alfred R. Wallace	NPMSP00
Penguin Random House	NPCNO00
Gavrilo Princip	NPMSSP0
Conan Doyle	NPCNSP0
clic farm	NCFS000
clic farms	NCFP000
green card	NCFS000
green cards	NCFP000
LanguageTool Premium	NPMSO00
Corriere della Sera	NPMSO00
Pina de Ebro	NPCSG00
Sabino Arana	NPMSSP0
el acabose	NCMS000
data center	NCMS000
data centre	NCMS000
data centers	NCMP000
data centres	NCMP000
sing.	AQ0CN0
pl.	AQ0CN0
masc.	AQ0CN0
fem.	AQ0CN0
Lula da Silva	NPMSO00
Amazon Prime	NPMSO00
Amazon prime	NPMSO00
Boca Juniors	NPMSO00
E. coli	NCFS000
Escherichia coli	NCFS000
haute cuisine	NCFS000
copia y pega	NCMS000
La La Land	NPCNO00
The Daily Telegraph	NPMSO00
The Economist	NPMSO00
The Guardian	NPMSO00
The New York Times	NPMSO00
The Telegraph	NPMSO00
The Times	NPMSO00
The Wall Street Journal	NPMSO00
The Washington Post	NPMSO00
Huffington Post	NPMSO00
The Huffington Post	NPMSO00
Wall Street Journal	NPMSO00
Washington Post	NPMSO00
New York Times	NPMSO00
Wall Street	NPCSG00
Rolls Royce	NPCNSP0
São Paulo	NPCSG00
Downin Street	NPCSG00
quítame allá estas pajas	NCMS000
quítame allá esas pajas	NCMS000
quítame allá	NCMS000
sálvese quien pueda	NCMS000
Benjamin Constant	NPMSSP0
Luo Guanzhong	NPMSSP0
Frank Capra	NPMSSP0
Buster Keaton	NPMSSP0
mago de Oz	NCMS000
Stabat Mater	NCMN000
Giovanni Battista	NPMSSP0
Johann Sebastian	NPMSSP0
Le Pen	NPCNSP0
I+D	NCFS000
Río de la Plata	NPMSG00
Río Negro	NPMSG00
Río Grande	NPMSG00
Viña del Mar	NPFSG00
Roquetas de Mar	NPFPG00
de buena tinta	LOC_ADV
New Deal	NCMS000
Os Lusíadas	NPMPO00
Te Deum	NCMS000
Le Corbusier	NPCNSP0
dale que te dale	LOC_ADV
dale que dale	LOC_ADV
dale que le das	LOC_ADV
dale que le darás	LOC_ADV
dale que te pego	LOC_ADV
Le Monde	NPMSO00
Le Soir	NPMSO00
Le Mans	NPCSG00
Europa Press	NPCSO00
Ortega y Gasset	NPMSSP0
Primavera Sound	NPMSO00
día a día	LOC_ADV
hip hop	NCMS000
San Silvestre	NPCSO00
San Silvestres	NPCPO00
Guardamar del Segura	NPCSG00
de a pie	LOC_ADJ
#de pie	LOC_ADV
a pie juntillas	LOC_ADV
a pies juntillas	LOC_ADV
drag queen	NCFS000
drag queens	NCFP000
drag king	NCMS000
drag kings	NCMP000
Mona Lisa	NPFSSP0
al dente	LOC_ADJ
después de Cristo	LOC_ADV
antes de Cristo	LOC_ADV
Steven Spielberg	NPMSSP0
Immanuel Kant	NPMSSP0
Robin Hood	NPMSSP0
Golden Gate	NPMSG00
de verdad	LOC_ADV
bajo custodia	LOC_ADV
boa constrictor	NCFS000
boas constrictor	NCFP000
azul oscuro	AQ0CN0
azul marino	AQ0CN0
sin duda	LOC_ADV
a su vez	LOC_ADV
al mismo tiempo	LOC_ADV
un poco	LOC_ADV
un poquito	LOC_ADV
un tanto	LOC_ADV
paso a paso	LOC_ADV
peso mosca	NCMS000
pesos mosca	NCMP000
peso pluma	NCMS000
pesos pluma	NCMP000
música dance	NCFS000
música trance	NCFS000
penalti remate	NCMS000
gotelé temple	NCMS000
tecla escape	NCFS000
placa base	NCFS000
placas base	NCFP000
datos serie	NCMP000
buses serie	NCMP000
bus serie	NCMS000
puertos serie	NCMP000
puerto serie	NCMS000
bajo mínimos	LOC_ADV
uva pasa	NCFS000
uvas pasas	NCFP000
higos pasos	NCMP000
higo paso	NCMS000
zona centro	NCFS000
carta documento	NCFS000
operación triunfo	NCFS000
Operación Triunfo	NPFSO00
dieta paleo	NCFS000
cuello pico	NCMS000
foto archivo	NCFS000
contorno de ojos	NCMS000
master class	NCFN000
niño soldado	NCMS000
niños soldado	NCMP000
niña soldado	NCFS000
niñas soldado	NCFP000
fecha tope	NCFS000
bono transporte	NCMS000
bonos transporte	NCMP000
abono transporte	NCMS000
abonos transporte	NCMP000
Oscar Wilde	NPMSSP0
Far West	NPMSG00
Lucky Luke	NPMSSP0
Brad Pitt	NPMSSP0
Beverly Hills	NPCSG00
Emilia Romaña	NPFSG00
Washington DC	NPCSG00
Open Arms	NPCSO00
III Reich	NPMSO00
Tercer Reich	NPMSO00
ex ante	LOC_ADV
ex post	LOC_ADV
ex-ante	LOC_ADV
ex-post	LOC_ADV
Library of Congress Online Catalog	NPFSO00
Library of Congress	NPFSO00
Futbol Club	NPMSO00
Sport Club	NPMSO00
acqua alta	NCFS000
CC BY	LOC_ADJ
CC BY-SA	LOC_ADJ
CC BY-NC	LOC_ADJ
CC BY-NC-SA	LOC_ADJ
CC BY-ND	LOC_ADJ
CC BY-NC-ND	LOC_ADJ
CC0	LOC_ADJ
ex nihilo	LOC_ADV
volens nolens	LOC_ADV
Mª	NPCNSP0
M.ª	NPCNSP0
tex-mex	AQ0CN0
Tex-Mex	AQ0CN0
cara dura	NPCS000
caras duras	NPCP000
Tel Aviv	NPCS000
Pearl Harbor	NPCS000
Torrejón de Ardoz	NPCS000
tour operador	NCMS000
tour operator	NCMS000
tour operadores	NCMP000
tour operators	NCMP000
a lo menos	LOC_ADV
gallo pinto	NCMS000
alto el fuego	NCMN000
alto al fuego	NCMN000
Echo Park	NPMSG00
corre que te pillo	NCMS000
al pairo	LOC_ADV
par de apriete	NCMS000
de veras	LOC_ADV
casa de Tócame Roque	NCFS000
ex novo	LOC_ADV
de novo	LOC_ADV
justicia mayor	NCMS000
justicias mayores	NCMP000
Justicia Mayor	NCMS000
data mart	NCMS000
data marts	NCMP000
piel roja	NCCS000
pieles rojas	NCCP000
Países Bajos	NPMPG00
Estados Unidos	NPMPG00
Rand Corporation	NCFSO00
RAND Corporation	NCFSO00
know-how	NCMN000
know how	NCMN000
res publica	NCFS000
a la carbonara	AQ0CN0
L'Équipe	NPMSO00
L’Équipe	NPMSO00
esfera armilar	NCFS000
dance pop	AQ0CN0
dance electrónico	NCMS000
Super Bowl	NPCNO00
Super Nintendo	NPFNO00
World Trade Center	NPMSG00
Santa Coloma	NPFSG00
Theresa May	NPFSSP0
Star Wars	NPCNO00
corta-pega	NPMN000
corta y pega	NPMN000
moto club	NPMS000
moto clubs	NPMP000
call center	NPMS000
call centers	NPMP000
call centre	NPMS000
call centres	NPMP000
déjà vu	NPMNO00
ménage à trois	NPMNO00
prêt-à-porter	AQ0CN0
D'Hondt	NPCNSP0
D’Hondt	NPCNSP0
City Bank	NPMSO00
Pol Pot	NPCNSP0
New Jersey	NPCSG00
New York	NPCSG00
New England	NPCSG00
New Mexico	NPCSG00
New Orleans	NPCSG00
New Hampshire	NPCSG00
New Providence	NPCSG00
alto cargo	NCCSO00
ex alto cargo	NCCSO00
ex altos cargos	NCCPO00
ex primer ministro	NCMSO00
ex primera ministra	NCFSO00
La Poste	NPCSO00
Santa Cruz	NPCSO00
Mar del Plata	NPCSO00
il prete rosso	NCMS000
Red Bull	NPCNO00
Johann Sebastian	NPMSSP0
La Salle	NPCNO00
cargue y descargue	NCMN000
ida y vuelta	NCCN000
paz y salvo	NCMN000
pop-up	AQ0CN0
pop up	AQ0CN0
New Deal	NCMS000
del mismo modo	LOC_ADV
ultima ratio	NCFS000
## to avoid undesired suggestions in other rules
#corona virus	NCMN000
#salva conducto	NCMS000
#pilla-pilla	NCMS000
#taca-taca	NCMS000
#salva conductos	NCMP000
#salvo conducto	NCMS000
#salvo conductos	NCMP000
#tele trabajo	NCMS000
#tele trabajos	NCMP000
##
de la Puente	NPCNSP0
Carmina Burana	NCCN000
El Abra	NPCSG00
Quintana Roo	NPCSG00
Nuevo León	NPMSG00
tira y afloja	NCMN000
Santa Claus	NPMNSP0
ceda el paso	NCMN000
Nueva York	NPFSG00
euro-zona	NCFS000
taca-taca	NCMS000
el más allá	NCMS000
boca a boca	NCMS000
voz a voz	NCMS000
boca a oreja	NCMS000
boca oreja	NCMS000
piedra-papel-tijera	NCMS000
un boca sucia	NCMS000
La Haya	NPFSG00
punto y coma	NCMN000
Mato Grosso	NPMSG00
largo y tendido	LOC_ADV
Santo Domingo	NPMSG00
del todo	LOC_ADV
piruvato deshidrogenasa	NCFS000
CIA World Factbook	NPMSO00
CIA Factbook	NPMSO00
Luz de Gas	NPCSO00
ADN polimerasa	NCFS000
ADN polimerasas	NCFP000
María del Carmen	NPFSSP0
Royal Society	NPFSO00
Royal Academy	NPFSO00
homo sapiens	NCMN000
homo habilis	NCMN000
homo erectus	NCMN000
homo antecessor	NCMN000
homo rudolfensis	NCMN000
homo ergaster	NCMN000
homo heidelbergensis	NCMN000
homo neanderthalensis	NCMN000
homo rhodesiensis	NCMN000
homo sapiens idaltu	NCMN000
homo sapiens sapiens	NCMN000
a anequín	LOC_ADV
a asentadillas	LOC_ADV
a barlovento	LOC_ADV
a barrisco	LOC_ADV
a base de	LOC_PREP
a base de bien	LOC_ADV
a boca de cañón	LOC_ADV
a bocajarro	LOC_ADV
a bombo y platillo	LOC_ADV
a borbollones	LOC_ADV
a borbotones	LOC_ADV
a bordo	LOC_ADV
a bote pronto	LOC_ADV
a brazo partido	LOC_ADV
a bruces	LOC_ADV
a buen recaudo	LOC_ADV
a buen seguro	LOC_ADV
a buen tino	LOC_ADV
a buena cuenta	LOC_ADV
a buena fe	LOC_ADV
a buena luz	LOC_ADV
a buena vista	LOC_ADV
a buenas horas	LOC_ADV
a buenas noches	LOC_ADV
a bulto	LOC_ADV
a cada instante	LOC_ADV
a cada momento	LOC_ADV
a cada paso	LOC_ADV
a cada rato	LOC_ADV
a cada trique	LOC_ADV
a cada triquitraque	LOC_ADV
a caja y espiga	LOC_ADV
a cal y canto	LOC_ADV
a caliche	LOC_ADV
a cambio	LOC_ADV
a cambio de	LOC_PREP
a campo raso	LOC_ADV
a campo traviesa	LOC_ADV
a campo travieso	LOC_ADV
a campo través	LOC_ADV
campo a través	LOC_ADV
campo a traviesa	LOC_ADV
a capela	LOC_ADJ
a cappella	LOC_ADJ
a cara de perro	LOC_ADV
a cara descubierta	LOC_ADV
a carcajada limpia	LOC_ADV
a cargo de	LOC_PREP
a carretadas	LOC_ADV
a carta cabal	LOC_ADV
a casquete quitado	LOC_ADV
a causa de	LOC_PREP
a causa de que	LOC_CS
a centenares	LOC_ADV
a cepillo	LOC_ADV
a cerca de	LOC_PREP
a cercen	LOC_ADV
a cercén	LOC_ADV
a chorros	LOC_ADV
a cielo descubierto	LOC_ADV
a ciencia cierta	LOC_ADV
a codazo limpio	LOC_ADV
a comisión	LOC_ADV
a como de lugar	LOC_ADV
a condición de	LOC_PREP
a condición de que	LOC_CS
a consecuencia de	LOC_PREP
a continuación de	LOC_PREP
a contra reloj	LOC_ADV
a contrahílo	LOC_ADV
a contralecho	LOC_ADV
a contramano	LOC_ADV
a contrapelo	LOC_ADV
a contrapié	LOC_ADV
a corazón abierto	LOC_ADV
a cordel	LOC_ADV
a coro	LOC_ADV
a costillas	LOC_ADV
a coxcojilla	LOC_ADV
a cruz y escuadra	LOC_ADV
a cuatro patas	LOC_ADV
a cuatro pies	LOC_ADV
a cubos	LOC_ADV
a cuenta de	LOC_PREP
a cuerpo de rey	LOC_ADV
a cuerpo descubierto	LOC_ADV
#a cuál más	LOC_ADV
a cántaros	LOC_ADV
a D. g.	Y
a dentelladas	LOC_ADV
a dentro	LOC_ADV
a desmano	LOC_ADV
a despecho	LOC_ADV
a despecho de	LOC_PREP
a destajo	LOC_ADV
a destiempo	LOC_ADV
a diario	LOC_ADV
a dicho efecto	LOC_ADV
a diferencia de	LOC_PREP
a disgusto	LOC_ADV
a distinción de	LOC_PREP
a dos dedos de	LOC_PREP
a dos haces	LOC_ADV
a dos manos	LOC_ADV
a duras penas	LOC_ADV
a dúo	LOC_ADV
a efecto de que	LOC_CS
a efectos de	LOC_PREP
a empellones	LOC_ADV
a escape	LOC_ADV
a escondidas	LOC_ADV
a escondidillas	LOC_ADV
a escote	LOC_ADV
a escuadra	LOC_ADV
a escusa	LOC_ADV
a escusas	LOC_ADV
a eso de	LOC_PREP
a espaldas de	LOC_PREP
a espeta perro	LOC_ADV
a espinapez	LOC_ADV
a espuertas	LOC_ADV
a este lado de	LOC_PREP
a excepción de	LOC_PREP
a expensas	LOC_ADV
a expensas de	LOC_PREP
a fanegadas	LOC_ADV
a favor de	LOC_PREP
a fin de	LOC_PREP
a fin de cuentas	LOC_ADV
a fin de que	LOC_CS
a fines de	LOC_PREP
a flor de agua	LOC_ADV
a flor de piel	LOC_ADV
a flote	LOC_ADV
a fortiori	LOC_ADV
a fuego lento	LOC_ADV
a fuerza de	LOC_PREP
a fuerza de que	LOC_CS
a gachas	LOC_ADV
a gatas	LOC_ADV
a gogó	LOC_ADV
a grandes rasgos	LOC_ADV
a granel	LOC_ADV
a graves penas	LOC_ADV
a guisa de	LOC_PREP
a hito	LOC_ADV
a horcajadas	LOC_ADV
a hurtadillas	LOC_ADV
a jarros	LOC_ADV
a jornal	LOC_ADV
a junta continua	LOC_ADV
a juzgar como	LOC_ADV
a juzgar por	LOC_PREP
a la bartola	LOC_ADV
a la buena ventura	LOC_ADV
a la busca de	LOC_PREP
a la chita callando	LOC_ADV
a la cola	LOC_ADV
a la espera de	LOC_PREP
a la funerala	LOC_ADV
a la inversa	LOC_ADV
a la manera de	LOC_PREP
a la mano de Dios	LOC_ADV
a la mitad de	LOC_PREP
a la morisma	LOC_ADV
a la mujeriega	LOC_ADV
a la papillote	LOC_ADV
a la par	LOC_ADV
a la parrilla	LOC_ADV
a la pata coja	LOC_ADV
a la pata llana	LOC_ADV
a la paz de Dios	LOC_ADV
a la pendura	LOC_ADV
a la perfección	LOC_ADV
a la postre	LOC_ADV
a la primera de cambio	LOC_ADV
a la ronza	LOC_ADV
a la siga de	LOC_PREP
a la sirga	LOC_ADV
a la sopa boba	LOC_ADV
a la tentaruja	LOC_ADV
a la tirolesa	LOC_ADV
a la usanza de	LOC_PREP
a la vez	LOC_ADV
a la vez que	LOC_CS
a la vuelta de	LOC_PREP
a la zona de	LOC_PREP
a largas marchas	LOC_ADV
a las calladas	LOC_ADV
a las mil maravillas	LOC_ADV
a las primeras de cambio	LOC_ADV
a las puertas de la muerte	LOC_ADV
a las veces	LOC_ADV
a lata por canal	LOC_ADV
a legua	LOC_ADV
a leguas	LOC_ADV
a libre plática	LOC_ADV
a lo ancho de	LOC_PREP
a lo bestia	LOC_ADV
a lo discreto	LOC_ADV
a lo garçon	LOC_ADV
a lo grande	LOC_ADV
a lo largo y a lo ancho	LOC_ADV
a lo largo y ancho de	LOC_PREP
a lo lejos	LOC_ADV
a lo loco	LOC_ADV
a lo moderno	LOC_ADV
a lo más	LOC_ADV
a lo que parece	LOC_ADV
a lo que salga	LOC_ADV
a lo sumo	LOC_ADV
a lo tonto	LOC_ADV
a lomo	LOC_ADV
a lomos	LOC_ADV
a los cuatro vientos	LOC_ADV
a los piques	LOC_ADV
a lumbre de pajas	LOC_ADV
a lumbre mansa	LOC_ADV
a lápiz	LOC_ADV
a línea tirada	LOC_ADV
a machamartillo	LOC_ADV
a machote	LOC_ADV
a mal dar	LOC_ADV
a malas penas	LOC_ADV
a manadas	LOC_ADV
a manera de	LOC_PREP
a mano airada	LOC_ADV
a mano armada	LOC_ADV
a manos llenas	LOC_ADV
a mansalva	LOC_ADV
a mares	LOC_ADV
a mata caballo	LOC_ADV
a matacaballo	LOC_ADV
a mayor abundamiento	LOC_ADV
a mazo y escoplo	LOC_ADV
a media ladera	LOC_ADV
a media madera	LOC_ADV
a media margen	LOC_ADV
a media rienda	LOC_ADV
a media rodilla	LOC_ADV
a media voz	LOC_ADV
a mediados de	LOC_PREP
a medias palabras	LOC_ADV
a medida que	LOC_CS
a medio hacer	LOC_ADV
a medio plazo	LOC_ADV
a mediodía	LOC_ADV
a medios pelos	LOC_ADV
a menos que	LOC_CS
a menudo	LOC_ADV
a mesa puesta	LOC_ADV
a millaradas	LOC_ADV
a mis anchas	LOC_ADV
a mitad de	LOC_PREP
a modo de	LOC_PREP
a montón	LOC_ADV
a mucha honra	LOC_ADV
a muerte	LOC_ADV
a muerte o vida	LOC_ADV
a mujeriega	LOC_ADV
a más andar	LOC_ADV
a más correr	LOC_ADV
a más ganar	LOC_ADV
a más mejor	LOC_ADV
a más no poder	LOC_ADV
a más tardar	LOC_ADV
a más ver	LOC_ADV
a más y mejor	LOC_ADV
a nado	LOC_ADV
de nado	LOC_ADJ
a no ser que	LOC_CS
a nombre de	LOC_PREP
a ojo de buen cubero	LOC_ADV
a ojos vistas	LOC_ADV
a pan y cuchillo	LOC_ADV
a partir de	LOC_PREP
a pasatoro	LOC_ADV
a paseo	LOC_ADV
a paso de tortuga	LOC_ADV
a paso largo	LOC_ADV
a pasto	LOC_ADV
a pesar de	LOC_PREP
a pesar de que	LOC_CS
a pesar de todo	LOC_ADV
a peso de oro	LOC_ADV
a petición de	LOC_PREP
a peón	LOC_ADV
a pica suelta	LOC_ADV
a pico	LOC_ADV
a pico de jarro	LOC_ADV
a pie firme	LOC_ADV
a pie llano	LOC_ADV
a pierna suelta	LOC_ADV
a pipiricojo	LOC_ADV
a pique de maceta	LOC_ADV
a plazo fijo	LOC_ADV
a plazos	LOC_ADV
a plomo	LOC_ADV
a poco que	LOC_CS
a poco rato	LOC_ADV
a pocos pasos	LOC_ADV
a porfía	LOC_ADV
a porrillo	LOC_ADV
a pospelo	LOC_ADV
a posteriori	LOC_ADV
a pote	LOC_ADV
a precio de coste	LOC_ADV
a primera sangre	LOC_ADV
a principios de	LOC_PREP
a priori	LOC_ADV
a prisa	LOC_ADV
a propósito de	LOC_PREP
a prorrata	LOC_ADV
a prueba de	LOC_PREP
a puchos	LOC_ADV
a puerta cerrada	LOC_ADV
a puestas	LOC_ADV
a punta de lanza	LOC_ADV
a punta de pistola	LOC_ADV
a punta pala	LOC_ADV
a puntapiés	LOC_ADV
a punto de	LOC_PREP
a punto de caramelo	LOC_ADV
a punto de que	LOC_CS
a punto de solfa	LOC_ADV
a punto fijo	LOC_ADV
a punto largo	LOC_ADV
a pupilo	LOC_ADV
a puñados	LOC_ADV
a puño cerrado	LOC_ADV
a quema ropa	LOC_ADV
a quemarropa	LOC_ADV
a rachas	LOC_ADV
a raja tabla	LOC_ADV
a rajatabla	LOC_ADV
a ras de	LOC_PREP
a ras de tierra	LOC_ADV
a ras del suelo	LOC_ADV
a rastras	LOC_ADV
a ratos perdidos	LOC_ADV
a raudales	LOC_ADV
a razón de	LOC_PREP
a raíz de	LOC_PREP
a reculones	LOC_ADV
a regaña dientes	LOC_ADV
a regañadientes	LOC_ADV
a rehala	LOC_ADV
a rembolso	LOC_ADV
a remiendos	LOC_ADV
a remo	LOC_ADV
a remojo	LOC_ADV
a renglón seguido	LOC_ADV
a reo	LOC_ADV
a repecho	LOC_ADV
a repelo	LOC_ADV
a repelones	LOC_ADV
a reserva de	LOC_PREP
a resto abierto	LOC_ADV
a retaguardia de	LOC_PREP
a revienta cinchas	LOC_ADV
a rienda suelta	LOC_ADV
a riesgo de	LOC_PREP
a riesgo y ventura	LOC_ADV
a rodeabrazo	LOC_ADV
a rompejunta	LOC_ADV
a rostro firme	LOC_ADV
a ruche	LOC_ADV
a río revuelto	LOC_ADV
a sabiendas	LOC_ADV
a salto de mata	LOC_ADV
a saltos	LOC_ADV
a sangre caliente	LOC_ADV
a sangre fría	LOC_ADV
a sangre y fuego	LOC_ADV
a santo de qué	LOC_ADV
a sardinel	LOC_ADV
a seguir bien	LOC_ADV
a semejanza de	LOC_PREP
a so capa	LOC_ADV
a sobre haz	LOC_ADV
a sobre peine	LOC_ADV
a sobremano	LOC_ADV
a socapa	LOC_ADV
a soga	LOC_ADV
a solapo	LOC_ADV
a solas	LOC_ADV
a solaz	LOC_ADV
a sotamano	LOC_ADV
a sotavento	LOC_ADV
a su imagen y semejanza	LOC_ADV
a suplicación de	LOC_PREP
a sus anchas	LOC_ADV
a súplica de	LOC_PREP
a tal punto que	LOC_CS
a teja vana	LOC_ADV
a tenor de	LOC_PREP
a tientas	LOC_ADV
a tiento	LOC_ADV
a tirada	LOC_ADV
a tiro de ballesta	LOC_ADV
a tiro de pistola	LOC_ADV
a tiro limpio	LOC_ADV
a tizón	LOC_ADV
a toca ropa	LOC_ADV
a toca teja	LOC_ADV
a tocateja	LOC_ADV
a toda brida	LOC_ADV
a toda costa	LOC_ADV
a toda furia	LOC_ADV
a toda hostia	LOC_ADV
a toda leche	LOC_ADV
a toda ley	LOC_ADV
a toda marcha	LOC_ADV
a toda mecha	LOC_ADV
a toda máquina	LOC_ADV
a toda pastilla	LOC_ADV
a toda plana	LOC_ADV
a toda prisa	LOC_ADV
a toda rienda	LOC_ADV
#a todas estas	LOC_ADV
a todas horas	LOC_ADV
a todo andar	LOC_ADV
a todo correr	LOC_ADV
a todo evento	LOC_ADV
a todo gas	LOC_ADV
a todo lo largo	LOC_ADV
a todo lo largo de	LOC_PREP
a todo meter	LOC_ADV
a todo moler	LOC_ADV
a todo pasto	LOC_ADV
a todo riesgo	LOC_ADV
a todo ruedo	LOC_ADV
a todo tirar	LOC_ADV
a todo trance	LOC_ADV
a todo vapor	LOC_ADV
a tontas y a locas	LOC_ADV
a topa tolondro	LOC_ADV
a tope	LOC_ADV
a toque de campana	LOC_ADV
a torna peón	LOC_ADV
a torna punta	LOC_ADV
a torno	LOC_ADV
a traición	LOC_ADV
a trancas y barrancas	LOC_ADV
a trancos	LOC_ADV
a traque barraque	LOC_ADV
a través de	LOC_PREP
a troche y moche	LOC_ADV
a trompa y talega	LOC_ADV
a trompicones	LOC_ADV
a tropezones	LOC_ADV
a trueco de	LOC_PREP
a trueque	LOC_ADV
a tuertas	LOC_ADV
a tuertas o a derechas	LOC_ADV
a tuerto o a derecho	LOC_ADV
a tutiplén	LOC_ADV
a título de	LOC_PREP
a ultranza	LOC_ADV
a un lado de	LOC_PREP
a un lado y otro	LOC_ADV
a un solo efecto	LOC_ADV
a uno y otro lado	LOC_ADV
a upa	LOC_ADV
a usanza de	LOC_PREP
a veces	LOC_ADV
a vez que	LOC_CS
a vida o muerte	LOC_ADV
a vista de pájaro	LOC_ADV
a viva voz	LOC_ADV
a voz en cuello	LOC_ADV
a voz en grito	LOC_ADV
a vuela pluma	LOC_ADV
a vuelapluma	LOC_ADV
a vuelco de dado	LOC_ADV
a vuelta de	LOC_PREP
a vuelta de correo	LOC_ADV
a vuelta de ojo	LOC_ADV
a vuelta de ojos	LOC_ADV
a.	Y
a. C.	Y
A. D.	Y
a. de C.	Y
a. de J. C.	Y
A. I.	Y
a. J. C.	Y
a. m.	Y
A. M. D. G.	Y
A. R.	Y
A. S.	Y
A. T.	Y
A/A	Y
a/c	Y
a/f	Y
AA. VV.	Y
aa. vv.	Y
ab aeterno	LOC_ADV
ab initio	LOC_ADV
ab intestato	LOC_ADV
ab irato	LOC_ADV
ab ovo	LOC_ADV
Abg.	Y
acept.	Y
#acerca de	LOC_PREP
ad calendas graecas	LOC_ADV
ad cautelam	LOC_ADV
ad efesios	LOC_ADV
ad hoc	LOC_ADV
ad hominem	LOC_ADV
ad honorem	LOC_ADV
ad infinitum	LOC_ADV
ad interim	LOC_ADV
ad lib	LOC_ADV
ad libitum	LOC_ADV
ad litem	LOC_ADV
ad litteram	LOC_ADV
ad quadrantum	LOC_ADV
ad triangulum	LOC_ADV
ad valorem	LOC_ADV
además de	LOC_PREP
además de eso	LOC_ADV
además de que	LOC_CS
adm.	Y
admón.	Y
afma.	Y
afmo.	Y
Agnus Dei	NCMS000
ahora bien	LOC_ADV
ahí es nada	LOC_ADV
ahí le duele	LOC_ADV
al abrigo de	LOC_PREP
al alcance de la mano	LOC_ADV
al alimón	LOC_ADV
al apa	LOC_ADV
al avemaría	LOC_ADV
al bies	LOC_ADV
al cabo de	LOC_PREP
al calor de	LOC_PREP
al carboncillo	LOC_ADV
al cargo de	LOC_PREP
al centro de	LOC_PREP
al chas chas	LOC_ADV
al cien por cien	LOC_ADV
al cierre del ejercicio	LOC_ADV
al clarear el día	LOC_ADV
al compás de	LOC_PREP
al conjuro de	LOC_PREP
al correr de la pluma	LOC_ADV
al correr del tiempo	LOC_ADV
al decir de	LOC_PREP
al derredor	LOC_ADV
al derredor de	LOC_PREP
al desbarate	LOC_ADV
al descuido y con cuidado	LOC_ADV
al desgaire	LOC_ADV
al detall	LOC_ADV
al estricote	LOC_ADV
al filo de	LOC_PREP
al filo de mediodía	LOC_ADV
al fin de la jornada	LOC_ADV
al fin y a la postre	LOC_ADV
al fin y al cabo	LOC_ADV
al frente de	LOC_PREP
al gratén	LOC_ADV
al grill	LOC_ADV
al gusto de	LOC_PREP
al hilo	LOC_ADV
al hilo de mediodía	LOC_ADV
al hilo del viento	LOC_ADV
al igual que	LOC_CS
al interior de	LOC_PREP
al libre albedrío	LOC_ADV
al lucero del alba	LOC_ADV
al mejor tiempo	LOC_ADV
al modo de	LOC_PREP
al objeto de	LOC_PREP
al olor de	LOC_PREP
al otro lado de	LOC_PREP
al par	LOC_ADV
al par que	LOC_CS
al paso que	LOC_CS
al paño	LOC_ADV
al pie de fábrica	LOC_ADV
al pie de la cuesta	LOC_ADV
al pie de la letra	LOC_ADV
al pie de la obra	LOC_ADV
al poco rato	LOC_ADV
al por mayor	LOC_ADV
al por menor	LOC_ADV
al primer envite	LOC_ADV
al primer folio	LOC_ADV
al primer gallo	LOC_ADV
al primer golpe de vista	LOC_ADV
al primer impulso	LOC_ADV
al proviso	LOC_ADV
al punto que	LOC_CS
al rape	LOC_ADV
al raso	LOC_ADV
al rededor	LOC_ADV
al retortero	LOC_ADV
al rojo blanco	LOC_ADV
al rojo cereza	LOC_ADV
al sesgo	LOC_ADV
al socaire	LOC_ADV
al socaire de	LOC_PREP
al tanto de	LOC_PREP
al temple	LOC_ADV
al tendido	LOC_ADV
al tenor de	LOC_PREP
al tiempo que	LOC_CS
al tresbolillo	LOC_ADV
al volateo	LOC_ADV
alea iacta est	LOC_ADV
Alfz.	Y
alguna que otra vez	LOC_ADV
algunas veces	LOC_ADV
alguno que otro	LOC_ADV
allende de	LOC_PREP
allá se andan	LOC_ADV
allá se las avenga	LOC_ADV
allá se las componga	LOC_ADV
allá se las haya	LOC_ADV
allá se las hayan	LOC_ADV
allá se van	LOC_ADV
alma mater	NCFS000
Almte.	Y
alter ego	NCMN000
ante diem	LOC_ADV
ante meridiem	LOC_ADV
anterior a	LOC_PREP
antes bien	LOC_ADV
antes pues	LOC_ADV
antes que nada	LOC_ADV
ap.	Y
#aparte de	LOC_PREP
apdo.	Y
aprox.	Y
arate cavate	LOC_ADV
ares y mares	LOC_ADV
Arq.	Y
arroz abanda	NCMS000
art déco	AQ0CN0
art deco	AQ0CN0
art decó	AQ0CN0
Art Déco	AQ0CN0
Art Deco	AQ0CN0
Art Decó	AQ0CN0
art nouveau	AQ0CN0
Art Nouveau	AQ0CN0
Art Brut	AQ0CN0
art brut	AQ0CN0
art.	Y
art.º	Y
Arz.	Y
Ayto.	Y
así como también	LOC_ADV
así como tampoco	LOC_ADV
así pues	LOC_ADV
así y todo	LOC_ADV
atta.	Y
atte.	Y
atto.	Y
aurea mediocritas	LOC_ADV
av.	Y
avd.	Y
avda.	Y
ayer noche	LOC_ADV
aún así	LOC_ADV
aún con eso	LOC_ADV
aún cuando	LOC_ADV
B.	Y
b. l. m.	Y
B.º	Y
bajo cuerda	LOC_ADV
bajo el poder de	LOC_PREP
bajo juramento	LOC_ADV
bajo la responsabilidad de	LOC_PREP
bajo llave	LOC_ADV
bajo mano	LOC_ADV
bajo ningún concepto	LOC_ADV
bajo siete llaves	LOC_ADV
Barna.	Y
Bco.	Y
bel canto	NCMS000
belle époque	NCFS000
best seller	NCMN000
Bibl.	Y
bien entendido que	LOC_CS
bien mirado	LOC_ADV
bien que mal	LOC_ADV
bien sabe Dios que	LOC_CS
big band	NCMS000
big bands	NCMP000
Big Bang	NCMS000
big bang	NCMS000
black jack	NCMS000
blue jean	NCMS000
blue jeans	NCMP000
Bma.	Y
Bmo.	Y
Bo.	Y
boca arriba	LOC_ADV
boy scout	NCMS000
boy scouts	NCMP000
Boy Scout	NCMS000
Boy Scouts	NCMP000
break dance	NCMS000
Brig.	Y
Brutus Brutus	NPCNSP0
Bs. As.	Y
Bta.	Y
Bto.	Y
Buenos Aires	NPCSG00
Burkina Faso	NPCSG00
bóbilis bóbilis	LOC_ADV
c.	Y
C. A.	Y
c. c.	Y
C. C.	Y
c. e.	Y
C. F.	Y
c. f. s.	Y
C. I.	Y
C. P.	Y
C. por A.	Y
C.ª	Y
c/	Y
c/c	Y
c/u	Y
cada cosa por su lado	LOC_ADV
cada dos por tres	LOC_ADV
cada quisque	NCMS000
caj.	Y
calamo currente	LOC_ADV
cap.	Y
Cap. Fed.	Y
cap.º	Y
capin melao	LOC_ADV
cara a cara	LOC_ADV
cara abajo	LOC_ADV
cara arriba	LOC_ADV
carpe diem	LOC_ADV
casa museo	NCFS000
casas museo	NCFP000
casi que	LOC_CS
casus belli	LOC_ADV
Cdad.	Y
cent.	Y
cf.	Y
cfr.	Y
cgo.	Y
ch/	Y
chaise longue	NCFS000
chill out	NCMS000
cien por cien	LOC_ADV
ciento por ciento	LOC_ADV
ciento y la madre	LOC_ADV
cje.	Y
cl.	Y
Cmdt.	Y
Cmte.	Y
Cnel.	Y
cochite hervite	LOC_ADV
codo a codo	LOC_ADV
codo con codo	LOC_ADV
coitus interruptus	NCMN000
col.	Y
como a los ojos de su cara	LOC_ADV
como a real de enemigo	LOC_ADV
como ahora es de día	LOC_ADV
como alma que lleva el diablo	LOC_ADV
como caído de las nubes	LOC_ADV
como de la noche al día	LOC_ADV
como dos y dos son cuatro	LOC_ADV
como el convidado de piedra	LOC_ADV
como el día a la noche	LOC_ADV
como el perro y el gato	LOC_ADV
como es de día	LOC_ADV
como es debido	LOC_ADV
como estamos aquí tú y yo	LOC_ADV
como está mandado	LOC_ADV
como hay Dios	LOC_ADV
como hecho de encargo	LOC_ADV
como la palma de la mano	LOC_ADV
como los chorros del oro	LOC_ADV
como mucho	LOC_ADV
como mínimo	LOC_ADV
como oro en paño	LOC_ADV
como Pedro por su casa	LOC_ADV
como por ensalmo	LOC_ADV
como que	LOC_CS
como quien dice	LOC_ADV
como quien no quiere la cosa	LOC_ADV
como quien oye llover	LOC_ADV
como quiera que	LOC_CS
como si no hubiera dicho nada	LOC_ADV
como si tal cosa	LOC_ADV
como un pepe	LOC_ADV
Comod.	Y
Comp.	Y
Comte.	Y
con carácter de	LOC_PREP
con claridad meridiana	LOC_ADV
con conocimiento de causa	LOC_ADV
con creces	LOC_ADV
con efecto desde	LOC_PREP
con el culo al aire	LOC_ADV
con el ojo tan largo	LOC_ADV
con el sudor de la frente	LOC_ADV
con excepción de	LOC_PREP
con honores de	LOC_PREP
con la ayuda de Dios	LOC_ADV
con la boca abierta	LOC_ADV
con la casa a cuestas	LOC_ADV
con la condición de	LOC_PREP
con la espada desnuda	LOC_ADV
con la frente alta	LOC_ADV
con la frente bien alta	LOC_ADV
con la frente levantada	LOC_ADV
con la lengua de un palmo	LOC_ADV
con la lengua fuera	LOC_ADV
con la mano en el corazón	LOC_ADV
con la música a otra parte	LOC_ADV
con la soga al cuello	LOC_ADV
con la vida en un hilo	LOC_ADV
con las manos cruzadas	LOC_ADV
con las manos vacías	LOC_ADV
con las orejas caídas	LOC_ADV
con las orejas gachas	LOC_ADV
con las orejas tan largas	LOC_ADV
con las piernas cruzadas	LOC_ADV
con lo que respecta a	LOC_PREP
con los cinco sentidos	LOC_ADV
con los ojos cerrados	LOC_ADV
con los pies delante	LOC_ADV
con mal pie	LOC_ADV
con mala idea	LOC_ADV
con mano escasa	LOC_ADV
con mano pesada	LOC_ADV
con mil amores	LOC_ADV
con miquis	LOC_ADV
con miras a	LOC_PREP
con moto	LOC_ADV
con mucho gusto	LOC_ADV
con objeto de	LOC_PREP
con objeto que	LOC_CS
con ocasión de	LOC_PREP
con pelos y señales	LOC_ADV
con pies de plomo	LOC_ADV
con puntos y comas	LOC_ADV
con relación a	LOC_PREP
con respecto a	LOC_PREP
con respecto de	LOC_PREP
con solo que	LOC_CS
con sordina	LOC_ADV
con tal de	LOC_PREP
con tal de que	LOC_CS
con tal que	LOC_CS
con toda la barba	LOC_ADV
con toda la boca	LOC_ADV
con toda normalidad	LOC_ADV
con todas las de la ley	LOC_ADV
con todo y con eso	LOC_ADV
con un palmo de lengua	LOC_ADV
con uñas y dientes	LOC_ADV
con valor de	LOC_PREP
con viento fresco	LOC_ADV
con vistas a	LOC_PREP
con zurrapas	LOC_ADV
conforme a	LOC_PREP
consecutio temporum	LOC_ADV
contra reloj	LOC_ADV
contra rembolso	LOC_ADV
contra viento y marea	LOC_ADV
contradictio in terminis	NCFS000
Contralmte.	Y
coord.	Y
coord.ª	Y
coram populo	LOC_ADV
corpore insepulto	LOC_ADV
corriente y moliente	AQ0CS0
cp.	Y
crec.	Y
cta.	Y
cta. cte.	Y
Cte.	Y
cts.	Y
ctv.	Y
ctvo.	Y
cuanto antes	LOC_ADV
cum laude	LOC_ADJ
cum laude	LOC_ADV
curriculum vitae	LOC_ADV
curriculum vitae	NCMN000
cálamo currente	LOC_ADV
Cástor y Pólux	LOC_ADV
cént.	Y
Cía.	Y
cód.	Y
cónf.	Y
cónfr.	Y
córam pópulo	LOC_ADV
D.	Y
d. C.	Y
d. de C.	Y
d. de J. C.	Y
D. E. P.	Y
D. F.	Y
d. J. C.	Y
D. L.	Y
D. m.	Y
D. P.	Y
D.ª	Y
d/f	Y
d/v	Y
da capo	LOC_ADV
dado que	LOC_CS
dalái lama	NPMNSP0
darse de alta	LOC_ADV
dcha.	Y
dcho.	Y
de a folio	LOC_ADJ
de a veras	LOC_ADV
#de acarreo	LOC_ADV
de acuerdo con	LOC_PREP
de acá para allá	LOC_ADV
de ahí que	LOC_CS
de al lado de	LOC_PREP
de alto copete	LOC_ADJ
de alto coturno	LOC_ADJ
de altos vuelos	LOC_ADJ
#de amplio espectro	LOC_ADJ
de andar por casa	LOC_ADJ
de anequín	LOC_ADJ
de antemano	LOC_ADV
de aquí en adelante	LOC_ADV
de aquí para allí	LOC_ADV
de aquí que	LOC_CS
de armas tomar	LOC_ADJ
de arrastre	LOC_ADJ
#de arte mayor	LOC_ADJ
#de arte menor	LOC_ADJ
de aúpa	LOC_ADJ
de baja estofa	LOC_ADJ
de bajo vuelo	LOC_ADJ
de balde	LOC_ADV
#de ballesta	LOC_ADV
de barra a barra	LOC_ADV
de boca en boca	LOC_ADV
de bote en bote	LOC_ADV
#de bracero	LOC_ADV
de bruces	LOC_ADV
de buen efecto	LOC_ADJ
#de buen grado	LOC_ADV
#de buen tono	LOC_ADV
de buena cepa	LOC_ADJ
de buena familia	LOC_ADJ
de buena fe	LOC_ADV
de buena gana	LOC_ADV
#de buena ley	LOC_ADJ
#de buena ropa	LOC_ADJ
#de buena voluntad	LOC_ADJ
de buenas a primeras	LOC_ADV
de bureo	LOC_ADJ
de bóbilis	LOC_ADV
de cabo a rabo	LOC_ADV
de canto	LOC_ADV
de cara a	LOC_PREP
de carrerilla	LOC_ADV
de carretilla	LOC_ADV
de cascabel gordo	LOC_ADJ
#de casquería	LOC_ADV
#de cañutillo	LOC_ADV
de chipé	LOC_ADJ
de churro	LOC_ADV
de ciencia cierta	LOC_ADV
#de circunvalación	LOC_ADV
de consuno	LOC_ADV
#de corredera	LOC_ADJ
#de cortos vuelos	LOC_ADJ
de coña	LOC_ADV
de cuajo	LOC_ADV
de cualquier forma	LOC_ADV
de cuando en cuando	LOC_ADV
de cuelga	LOC_ADJ
de cuenta y riesgo	LOC_ADV
de cuerpo presente	LOC_ADJ
de cutio	LOC_ADV
de debajo de	LOC_PREP
de delante de	LOC_PREP
de dentro de	LOC_PREP
de detrás de	LOC_PREP
de dientes afuera	LOC_ADV
de Dios abajo	LOC_ADV
de disparo	LOC_ADV
de doble filo	LOC_ADV
de dos en dos	LOC_ADV
de dos filos	LOC_ADV
de día en día	LOC_ADV
de ensueño	LOC_ADJ
de entonces acá	LOC_ADV
de entreguerras	LOC_ADJ
de estampía	LOC_ADV
de este lado de	LOC_PREP
de extranjis	LOC_ADV
de facto	LOC_ADV
de falondres	LOC_ADV
#de fogueo	LOC_ADJ
de fuera de	LOC_PREP
de golpe y porrazo	LOC_ADV
de grado en grado	LOC_ADV
de guagua	LOC_ADV
de guardarropía	LOC_ADV
de guillotina	LOC_ADV
de higos a brevas	LOC_ADV
de hoy en adelante	LOC_ADV
de hoy para mañana	LOC_ADV
de hoz y de coz	LOC_ADV
de ida y vuelta	LOC_ADV
de iure	LOC_ADV
de jure	LOC_ADV
de juro	LOC_ADV
de la cruz a la fecha	LOC_ADV
de la mano de	LOC_PREP
de la noche a la mañana	LOC_ADV
de la puñeta	LOC_ADV
de la zona de	LOC_PREP
de lado a lado	LOC_ADV
de lance en lance	LOC_ADV
de lengua en lengua	LOC_ADV
de lo contrario	LOC_ADV
de lo lindo	LOC_ADV
de lo vivo a lo pintado	LOC_ADV
de madrugada	LOC_ADV
de mal a mal	LOC_ADV
de mal abrigo	LOC_ADV
de mal efecto	LOC_ADJ
de mal en peor	LOC_ADV
de mal grado	LOC_ADJ
de mal tono	LOC_ADJ
de mal vivir	LOC_ADJ
de mala fe	LOC_ADV
de mala gana	LOC_ADV
de mala ley	LOC_ADV
de mala manera	LOC_ADV
de mala muerte	LOC_ADJ
#de mala nota	LOC_ADJ
de mancomún	LOC_ADV
#de mano derecha	LOC_ADJ
de mano en mano	LOC_ADV
#de mano izquierda	LOC_ADJ
de manos a boca	LOC_ADV
de marca mayor	LOC_ADV
de marras	LOC_ADJ
de matute	LOC_ADV
#de media gala	LOC_ADJ
de medio a medio	LOC_ADV
de medio lado	LOC_ADV
de medio ojo	LOC_ADV
de medio pie	LOC_ADV
de mentirijillas	LOC_ADV
de mil amores	LOC_ADJ
de mil diablos	LOC_ADJ
de miranda	LOC_ADV
de misa y olla	LOC_ADJ
de modo que	LOC_CS
de momio	LOC_ADV
de morondanga	LOC_ADV
de muchas campanillas	LOC_ADV
de muchas leguas	LOC_ADV
de mucho efecto	LOC_ADV
de mucho trote	LOC_ADV
de más marca	LOC_ADV
de mírame y no me toques	LOC_ADV
de ninguna manera	LOC_ADV
de nueva planta	LOC_ADJ
de nuevo cuño	LOC_ADJ
de nunca acabar	LOC_ADJ
de oque	LOC_ADV
de oreja a oreja	LOC_ADV
de oro y azul	LOC_ADV
de oídas	LOC_ADV
de pacotilla	LOC_ADV
de padre y muy señor mío	LOC_ADV
de palabra en palabra	LOC_ADV
de pascuas a ramos	LOC_ADV
de pe a pa	LOC_ADV
de pega	LOC_ADV
de pelo en pecho	LOC_ADV
de perdidos al río	LOC_ADV
de perilla	LOC_ADV
de perillas	LOC_ADV
de persona a persona	LOC_ADV
de pie de banco	LOC_ADV
de pies a cabeza	LOC_ADV
de pilón	LOC_ADV
de pitiminí	LOC_ADV
de pleno derecho	LOC_ADV
de poca monta	LOC_ADV
de poca ropa	LOC_ADV
de poco más o menos	LOC_ADV
de poco pelo	LOC_ADV
de poder a poder	LOC_ADV
de polo a polo	LOC_ADV
de pontifical	LOC_ADV
de popa a proa	LOC_ADV
de por junto	LOC_ADV
de por medio	LOC_ADV
de por sí	LOC_ADV
de por vida	LOC_ADV
de postín	LOC_ADJ
de potencia en potencia	LOC_ADV
de primera clase	LOC_ADV
de primera intención	LOC_ADV
de primera línea	LOC_ADV
de prisa	LOC_ADV
de prisa y corriendo	LOC_ADV
de pro	LOC_ADV
de profundis	LOC_ADV
de propia minerva	LOC_ADV
de propio puño	LOC_ADV
de puerta a puerta	LOC_ADV
de puerta en puerta	LOC_ADV
de puertas adentro	LOC_ADV
de puertas afuera	LOC_ADV
de puertos allende	LOC_ADV
de puertos aquende	LOC_ADV
de punta a cabo	LOC_ADV
de punta a punta	LOC_ADV
de pura cepa	LOC_ADJ
de puta madre	LOC_ADJ
de puta pena	LOC_ADV
de putifa	LOC_ADV
de puño y letra	LOC_ADV
de quedo	LOC_ADV
de quita y pon	LOC_ADV
de rama en rama	LOC_ADV
de raro en raro	LOC_ADV
de rato en rato	LOC_ADV
de rebato	LOC_ADV
de rebote	LOC_ADV
de rechupete	LOC_ADJ
de refilón	LOC_ADV
de relumbrón	LOC_ADJ
de reojo	LOC_ADV
de repelón	LOC_ADV
de repente	LOC_ADV
de repuesto	LOC_ADJ
#de reserva	LOC_ADV
de resultas	LOC_ADV
de retrocarga	LOC_ADJ
de revuelo	LOC_ADV
de rodilla en rodilla	LOC_ADV
de rompe y rasga	LOC_ADJ
de rondón	LOC_ADJ
de seguida	LOC_ADV
de segunda mano	LOC_ADJ
de sentido común	LOC_ADJ
de so capa	LOC_ADJ
de sobra	LOC_ADV
de sobresalto	LOC_ADJ
de sol a sol	LOC_ADV
de soslayo	LOC_ADV
de suerte que	LOC_CS
de tal manera que	LOC_CS
de tapadillo	LOC_ADV
de tarde en tarde	LOC_ADV
de tiempo en tiempo	LOC_ADV
de tiento en tiento	LOC_ADV
de todas maneras	LOC_ADV
de todas todas	LOC_ADV
de todo corazón	LOC_ADV
de todo en todo	LOC_ADV
de todo punto	LOC_ADV
de todos los diablos	LOC_ADJ
de todos modos	LOC_ADV
de través	LOC_ADV
de trazo continuo	LOC_ADV
de trecho en trecho	LOC_ADV
de tres al cuarto	LOC_ADV
de tú a tú	LOC_ADV
de ultratumba	LOC_ADV
de un día a otro	LOC_ADV
de un jalón	LOC_ADV
de un lado a otro	LOC_ADV
de un lado para otro	LOC_ADV
de un plumazo	LOC_ADV
de un primer voleo	LOC_ADV
de un tirón	LOC_ADV
de una manera o de otra	LOC_ADV
de una sentada	LOC_ADV
de una tacada	LOC_ADV
de una tirada	LOC_ADV
de una vez para siempre	LOC_ADV
de uno en uno	LOC_ADV
de uso externo	LOC_ADV
de uvas a peras	LOC_ADV
de vez en cuando	LOC_ADV
de visu	LOC_ADV
de viva voz	LOC_ADV
de volatería	LOC_ADV
de vértigo	LOC_ADV
de vía estrecha	LOC_ADV
de órdago	LOC_ADV
debajo de	LOC_PREP
decreto ley	NCMS000
decretos leyes	NCMS000
del otro lado	LOC_ADV
del otro lado de	LOC_PREP
del poder de	LOC_PREP
del primer voleo	LOC_ADV
del principio al fin	LOC_ADV
del revés	LOC_ADV
del tiempo de Maricastaña	LOC_ADJ
del.	Y
delante de	LOC_PREP
delante de Dios y de todo el	LOC_ADV
delirium tremens	NCMN000
deo gracias	I
deo gracias	LOC_ADV
Deo volente	LOC_ADV
deo volente	LOC_ADV
depto.	Y
desct.º	Y
desde cero	LOC_ADV
desde el momento en que	LOC_CS
desde luego	LOC_ADV
desde niño	LOC_ADV
desde que el mundo es mundo	LOC_ADV
detrás de	LOC_PREP
deus ex machina	NCMN000
diag.	Y
dicc.	Y
dies irae	NCMS000
Dir.	NCMS000
Dir.ª	NCFS000
dirección a	LOC_PREP
do ut des	LOC_ADV
doc.	Y
dpto.	Y
Dr.ª	NCFS000
dto.	Y
dupdo.	Y
duty free	LOC_ADJ
Dña.	NCFS000
e. c.	Y
e. p. d.	Y
e. p. m.	Y
e. s. m.	Y
e/	Y
e/c	Y
ed.	Y
edit.	Y
edo.	Y
EE. UU.	NPMPG00
JJ. OO.	NPMPO00
ef.	Y
ej.	Y
el acabose	NCMS000
El Escorial	NPMSG00
Em.ª	Y
Emmo.	Y
ext.	Y
en agraz	LOC_ADV
en aquel entonces	LOC_ADV
en aras de	LOC_PREP
en atención a	LOC_PREP
en babia	LOC_ADV
en batería	LOC_ADV
en berlina	LOC_ADV
en buena lid	LOC_ADV
en buenos términos	LOC_ADV
en busca de	LOC_PREP
en calidad de	LOC_PREP
en cambio de	LOC_PREP
en caso de	LOC_PREP
en caso de que	LOC_CS
en cierto modo	LOC_ADV
en compañía de	LOC_PREP
en compensación de	LOC_PREP
en concepto de	LOC_PREP
en consecuencia	LOC_ADV
en contorno	LOC_ADV
en contra de	LOC_PREP
en contracambio	LOC_ADV
en coña	LOC_ADV
en cuanto a	LOC_PREP
en cuanto que	LOC_CS
en cuclillas	LOC_ADV
en cuerpo y alma	LOC_ADV
en cuestión de	LOC_PREP
en círculo	LOC_ADV
en defecto de	LOC_PREP
en demanda de	LOC_PREP
en demasía	LOC_ADV
en derredor	LOC_ADV
en derredor de	LOC_PREP
en desbandada	LOC_ADV
en descargo	LOC_ADV
en desquite	LOC_ADV
en detalle	LOC_ADV
en diferido	LOC_ADV
en Dios y en conciencia	LOC_ADV
en dirección a	LOC_PREP
en el centro de	LOC_PREP
en el entorno de	LOC_PREP
en el interior de	LOC_PREP
en el otro lado de	LOC_PREP
en el plazo de	LOC_PREP
en el puesto de	LOC_PREP
en el supuesto que	LOC_CS
en entredicho	LOC_ADV
en espera de	LOC_PREP
en este mismo instante	LOC_ADV
en evitación de	LOC_PREP
en favor de	LOC_PREP
en fiado	LOC_ADV
en fila india	LOC_ADV
en fin de cuentas	LOC_ADV
en franquía	LOC_ADV
en gracia a	LOC_PREP
en gran manera	LOC_ADV
en gran medida	LOC_ADV
en guisa de	LOC_PREP
en honor a la verdad	LOC_ADV
en horre	LOC_ADV
en interés	LOC_ADV
en jamás de los jamases	LOC_ADV
en junto	LOC_ADV
en la línea de	LOC_PREP
en la necesidad de	LOC_PREP
en la temporada de	LOC_PREP
en la zona de	LOC_PREP
en las cercanías de	LOC_PREP
en las proximidades de	LOC_PREP
en limpio	LOC_ADV
en lo concerniente a	LOC_PREP
en lo sucesivo	LOC_ADV
en lontananza	LOC_ADV
en los buenos tiempos	LOC_ADV
en lugar de	LOC_PREP
en lugar de que	LOC_CS
#en línea	LOC_ADV
en líneas generales	LOC_ADV
en mala hora	LOC_ADV
en mangas de camisa	LOC_ADV
en manos de	LOC_PREP
en materia de	LOC_PREP
en medio de	LOC_PREP
en memoria de	LOC_PREP
en menos de	LOC_PREP
#en miniatura	LOC_ADV
en mitad de	LOC_PREP
en modo alguno	LOC_ADV
en obligación de	LOC_PREP
en obsequio a	LOC_PREP
en obsequio de	LOC_PREP
en oferta	LOC_ADV
en oposición a	LOC_PREP
en orden a	LOC_PREP
en paralelo	LOC_ADV
en parte por	LOC_PREP
en partes iguales	LOC_ADV
en paños menores	LOC_ADV
en pelota picada	LOC_ADV
en pie de guerra	LOC_ADV
en plan de	LOC_PREP
en plantilla	LOC_ADV
en pocas palabras	LOC_ADV
en porretas	LOC_ADV
en pos de	LOC_PREP
en prenda	LOC_ADV
en primicia	LOC_ADV
en pro de	LOC_PREP
en procura	LOC_ADV
en prueba de	LOC_PREP
en punto de caramelo	LOC_ADV
en puridad	LOC_ADV
en rama	LOC_ADV
en razón de	LOC_PREP
en recuerdo de	LOC_PREP
en rededor	LOC_ADV
en remojo	LOC_ADV
en representación de	LOC_PREP
en resumidas cuentas	LOC_ADV
en ristre	LOC_ADV
en salvo	LOC_ADV
en seguida	LOC_ADV
en señal de	LOC_PREP
en sordina	LOC_ADV
en su defecto	LOC_ADV
en tanto que	LOC_CS
en tiempo de	LOC_PREP
en tiempo diferido	LOC_ADV
en tiempo real	LOC_ADV
en tiempo récord	LOC_ADV
en tiempo y forma	LOC_ADV
en toda la extensión de la palabra	LOC_ADV
en toda regla	LOC_ADV
en toda tierra de garbanzos	LOC_ADV
en todo caso	LOC_ADV
en todo lo descubierto	LOC_ADV
en torno a	LOC_PREP
en torno de	LOC_PREP
en touche	LOC_ADV
en tromba	LOC_ADV
en tándem	LOC_ADV
en un abrir y cerrar de ojos	LOC_ADV
en un decir amén	LOC_ADV
en un pis-pas	LOC_ADV
en un pispás	LOC_ADV
en un santiamén	LOC_ADV
en un tris	LOC_ADV
en vez de	LOC_PREP
en vez de que	LOC_CS
en vilo	LOC_ADV
en virtud de	LOC_PREP
en vista de	LOC_PREP
en vista de que	LOC_CS
en volandas	LOC_ADV
en vías de	LOC_PREP
en zigzag	LOC_ADV
encima de	LOC_PREP
enfrente de	LOC_PREP
entlo.	Y
entre la espada y la pared	LOC_ADV
entre la vida y la muerte	LOC_ADV
entre pecho y espalda	LOC_ADV
entre que	LOC_CS
entre tanto que	LOC_CS
es hablar por demás	LOC_ADV
esperando a	LOC_PREP
et al.	Y
et alii	Y
AA. VV.	Y
etc.	Y
ex abrupto	LOC_ADV
ex aequo	LOC_ADV
ex ante	LOC_ADV
ex cathedra	LOC_ADV
ex cátedra	LOC_ADV
ex cáthedra	LOC_ADV
ex post	LOC_ADV
ex profeso	LOC_ADV
ex testamento	LOC_ADV
Exc.ª	Y
exceptio veritatis	LOC_ADV
excepto que	LOC_CS
excl.	Y
Excma.	Y
Excmo.	Y
f.	Y
F. C.	Y
f.ª	Y
f.º	Y
fasc.	Y
fata morgana	NCFS000
fca.	Y
Fdo.	Y
FF. AA.	Y
fig.	Y
foie gras	NCMS000
fol.	Y
fox terrier	NCMN000
Fr.	Y
fra.	Y
free lance	NCMN000
fuera de que	LOC_CS
full time	LOC_ADV
féc.	Y
g. p.	Y
g. v.	Y
g/p	Y
Gdor.	Y
Gdor.ª	Y
Gdora.	Y
Gengis Kan	NPMNSP0
Gloria Patri	NCMN000
Gob.	Y
gracias a	LOC_PREP
gracias a que	LOC_CS
gracias al que	LOC_CS
Gral.	Y
gratis et amore	LOC_ADV
grosso modo	LOC_ADV
H.	Y
habeas corpus	NCMN000
hacia mediados de	LOC_PREP
hasta cierto punto	LOC_ADV
hasta cuando	LOC_CS
hasta más ver	LOC_ADV
hasta tanto que	LOC_CS
heavy metal	AQ0CN0
hic et nunc	LOC_ADV
high tech	LOC_ADJ
Hna.	Y
Hno.	Y
Hong Kong	NPCSG00
honoris causa	LOC_ADJ
horror vacui	NCMS000
I.	Y
i. e.	Y
ib.	Y
ibíd.	Y
igl.ª	Y
Il.	Y
Ilma.	Y
Ilmo.	Y
Iltre.	Y
imp.	Y
impr.	Y
impto.	Y
in absentia	LOC_ADV
in aeternum	LOC_ADV
in albis	LOC_ADV
in anima vili	LOC_ADV
in articulo mortis	LOC_ADV
in artículo mortis	LOC_ADV
in crescendo	LOC_ADV
in extenso	LOC_ADV
in extremis	LOC_ADV
in fieri	LOC_ADV
in fraganti	LOC_ADV
in illo tempore	LOC_ADV
in illo témpore	LOC_ADV
in memóriam	LOC_ADV
in partibus	LOC_ADV
in pectore	LOC_ADV
in perpétuum	LOC_ADV
in promptu	LOC_ADV
in pártibus infidélium	LOC_ADV
in péctore	LOC_ADV
in púribus	LOC_ADV
in situ	LOC_ADV
in sólidum	LOC_ADV
in vitro	LOC_ADV
in vivo	LOC_ADV
in ánima vili	LOC_ADV
incl.	Y
Ing.	Y
inmediatamente después de	LOC_PREP
Inst.	Y
inter nos	LOC_ADV
inter vivos	LOC_ADV
interposita persona	LOC_ADV
invita Minerva	LOC_ADV
ipso facto	LOC_ADV
ipso iure	LOC_ADV
ipso jure	LOC_ADV
Islas Solomon	NPFPG00
Italo Calvino	NPMSSP0
iuris et de iure	LOC_ADV
izda.	Y
izdo.	Y
izq.	Y
izqda.	Y
izqdo.	Y
J. C.	Y
jamás de los jamases	LOC_ADV
jamás por jamás	LOC_ADV
jet lag	NCMS000
jet set	NCFS000
Jhs.	Y
JJ. OO.	Y
juro a bríos	LOC_ADV
k. o.	Y
Kublai Kan	NPMNSP0
l. c.	Y
L/	Y
laissez faire	NCMS000
lapsus calami	NCMN000
lapsus linguae	NCMN000
lato sensu	LOC_ADV
laus Deo	LOC_ADV
Lcda.	Y
Lcdo.	Y
Lda.	Y
Ldo.	Y
lejos de	LOC_PREP
lengua de oc	NCFS000
lengua de oíl	NCFS000
lenguas de oc	NCFP000
lenguas de oíl	NCFP000
Lic.	Y
lignum crucis	LOC_ADV
Lincoln Lincoln	NPCNSP0
lo de menos	LOC_ADV
lo malo es que	LOC_CS
lo uno por lo otro	LOC_ADV
loc. cit.	Y
loco citato	LOC_ADV
Ltd.	Y
Ltda.	Y
Ltdo.	Y
luego que	LOC_CS
m.	Y
m. n.	Y
Magallanes Magallanes	NPCNSP0
Magfca.	Y
Magfco.	Y
magister dixit	LOC_ADV
maguer que	LOC_CS
mal a mal	LOC_ADV
manu militari	LOC_ADV
Mare Nostrum	NPMSG00
mass media	NCMN000
mass media	NCMP000
mea culpa	NCMN000
medio ambiente	NCMS000
merced a que	LOC_CS
mientras que	LOC_CS
mixti fori	LOC_ADV
modus operandi	NCMN000
modus vivendi	NCMN000
moliente y corriente	AQ0CS0
Mons.	Y
mortis causa	LOC_ADV
motu proprio	LOC_ADV
mr.	Y
ms.	Y
mutatis mutandis	LOC_ADV
muy de mañana	LOC_ADV
muy muy	LOC_ADV
más allá de	LOC_PREP
más de la cuenta	LOC_ADV
más valiera	LOC_ADV
máx.	Y
mín.	Y
n.	Y
N. B.	Y
N. del T.	Y
N. S.	Y
N. S. J. C.	Y
N.ª S.ª	Y
n.º	NCCN000
nada más y nada menos	LOC_ADV
Nebrija Nebrija	NPCNSP0
nemine discrepante	LOC_ADV
new look	NCMS000
ni a la de tres	LOC_ADV
ni a tiros	LOC_ADV
ni aún	LOC_ADV
ni corto ni perezoso	LOC_ADV
ni fu ni fa	LOC_ADV
ni hablar del peluquín	LOC_ADV
ni mucho menos	LOC_ADV
ni más ni menos	LOC_ADV
ni que	LOC_CS
ni que decir tiene	LOC_ADV
ni remotamente	LOC_ADV
ni rey ni roque	LOC_ADV
ni suena ni truena	LOC_ADV
ni tan sólo	LOC_ADV
ni tanto así	LOC_ADV
ni tanto ni tan calvo	LOC_ADV
ni tanto ni tan poco	LOC_ADV
nihil obstat	NCMN000
no ha lugar	LOC_ADV
no obstante	LOC_ADV
no sea que	LOC_CS
noli me tangere	LOC_ADV
non bis in idem	NCMS000
non plus ultra	LOC_ADV
nora en tal	LOC_ADV
nora tal	LOC_ADV
nota bene	NCMN000
nro.	NCCN000
Ntr.ª Sr.ª	Y
Ntra. Sra.	Y
nueces moscadas	NCFP000
Nueva Zelanda	NPFSG00
nuez moscada	NCFS000
numerus clausus	NCMN000
núm.	NCCN00
o sea	LOC_CC
O. F. M.	Y
O. M.	Y
O. P.	Y
O. S. A.	Y
Ob.	Y
ob. cit.	Y
obiter dictum	LOC_ADV
off line	LOC_ADV
on line	LOC_ADV
p.	Y
p. a.	Y
p. d.	Y
P. D.	Y
p. ej.	Y
p. k.	Y
p. m.	Y
P. M.	Y
P. O.	Y
p. o.	Y
p. p.	Y
P. S.	Y
p. v.	Y
P. V. P.	Y
p.º	Y
p/o	Y
pane lucrando	LOC_ADV
panem et circenses	LOC_ADV
Pange lingua	LOC_ADV
para colmo	LOC_ADV
para dar y tomar	LOC_ADV
para más inri	LOC_ADV
para rato	LOC_ADV
para remate	LOC_ADV
para todo trote	LOC_ADV
parecido a	LOC_PREP
pasado mañana	LOC_ADV
Pat.	Y
Pbro.	Y
pdo.	Y
Pdta.	Y
Pdte.	Y
peccata minuta	LOC_ADV
peccata minuta	NCFS000
per accidens	LOC_ADV
per cápita	AQ0CN0
per se	LOC_ADV
persona non grata	NCFS000
#pese a	LOC_PREP
pese a que	LOC_CS
Petrus in cunctis	LOC_ADV
pg.	Y
pian pian	LOC_ADV
pian pianito	LOC_ADV
pian piano	LOC_ADV
pl.	Y
play back	NCMN000
play boy	NCMS000
play boys	NCMP000
plis plas	NCMS000
pluralia tantum	LOC_ADV
plus minusve	LOC_ADV
plus ultra	LOC_ADV
plza.	Y
Pnt.	Y
poco a poco	LOC_ADV
pop art	AQ0CN0
por adarmes	LOC_ADV
por al lado de	LOC_PREP
por amor de Dios	LOC_ADV
por anticipado	LOC_ADV
por aquel entonces	LOC_ADV
por arte de birlibirloque	LOC_ADV
por arte de magia	LOC_ADV
por barba	LOC_ADV
por carambola	LOC_ADV
por causa de	LOC_PREP
por ce o por be	LOC_ADV
por ceremonia	LOC_ADV
por concuerda	LOC_ADV
por consecuencia	LOC_ADV
por consiguiente	LOC_ADV
por contera	LOC_ADV
por cuatro reales	LOC_ADV
por cuenta de	LOC_PREP
por cuenta y riesgo	LOC_ADV
por de contado	LOC_ADV
por de pronto	LOC_ADV
por debajo de	LOC_PREP
por debajo de cuerda	LOC_ADV
por decirlo así	LOC_ADV
por delante de	LOC_PREP
por dentro de	LOC_PREP
por descontado	LOC_ADV
por detrás de	LOC_PREP
por duplicado	LOC_ADV
por ejemplo	LOC_ADV
por el centro de	LOC_PREP
por el contrario	LOC_ADV
por contra	LOC_ADV
por el otro lado de	LOC_PREP
por en medio	LOC_ADV
por ende	LOC_ADV
por ensalmo	LOC_ADV
por entonces	LOC_ADV
por esos mundos de Dios	LOC_ADV
por este lado de	LOC_PREP
por favor	LOC_ADV
por hache o por be	LOC_ADV
por igual	LOC_ADV
por intuito	LOC_ADV
por la cuenta que	LOC_CS
por la gracia de Dios	LOC_ADV
por lo bajines	LOC_ADV
por lo bajini	LOC_ADV
por lo bajinis	LOC_ADV
por lo claro	LOC_ADV
por lo común	LOC_ADV
por lo general	LOC_ADV
por lo menos	LOC_ADV
por lo pronto	LOC_ADV
por lo tanto	LOC_ADV
por medio de	LOC_PREP
por minutos	LOC_ADV
por motivo de	LOC_PREP
por mucho que	LOC_CS
por más que digas	LOC_ADV
por nada del mundo	LOC_ADV
por ningún concepto	LOC_ADV
por norma general	LOC_ADV
por obra de	LOC_PREP
por obra y gracia de	LOC_PREP
por onzas	LOC_ADV
por otro lado	LOC_ADV
por oídas	LOC_ADV
por pura fórmula	LOC_ADV
por razón de que	LOC_CS
por real decreto	LOC_ADV
por regla general	LOC_ADV
por segundo año consecutivo	LOC_ADV
por separado	LOC_ADV
por si acaso	LOC_ADV
por si las moscas	LOC_ADV
por siempre jamás	LOC_ADV
#por supuesto	LOC_ADV
por testa	LOC_ADV
por todo lo alto	LOC_ADV
por un tris	LOC_ADV
por ventura	LOC_ADV
por virtud de	LOC_PREP
post meridiem	LOC_ADV
post mortem	LOC_ADV
Post Mortem	LOC_ADV
post scriptum	LOC_ADV
ppal.	Y
prae manibus	LOC_ADV
pral.	Y
Presb.	Y
prima donna	NCFN000
prima facie	LOC_ADV
primus inter pares	NCMS000
pro domo sua	LOC_ADV
pro forma	LOC_ADV
Prof.	Y
Prof.ª	Y
propter nuptias	LOC_ADV
prov.	Y
pról.	Y
pues bien	LOC_ADV
pues sí que	LOC_CS
pza.	Y
pág.	Y
párr.	Y
q. b. s. m.	Y
q. b. s. p.	Y
Q. D. G.	Y
q. D. g.	Y
q. e. g. e.	Y
q. e. p. d.	Y
q. e. s. m.	Y
q. s. g. h.	Y
que ni hecho de encargo	LOC_ADV
que ni pintado	LOC_ADV
que si tal que si cual	LOC_ADV
quid divinum	LOC_ADV
quid pro quo	LOC_ADV
quiera que no	LOC_ADV
quieras que no	LOC_ADV
R.	Y
R. D.	Y
R. I. P.	Y
R. O.	Y
r. p. m.	Y
r.p.m.	NCFN000
r.º	Y
rabassa morta	LOC_ADV
rara avis	NCCN000
rara vez	LOC_ADV
rata parte	LOC_ADV
Rda.	Y
Rdo.	Y
reales decretos leyes	NCMS000
reality show	NCMS000
reality shows	NCMP000
reg.	Y
relata refero	LOC_ADV
Rep.	Y
requiescat in pace	LOC_ADV
respecto a	LOC_PREP
respecto a que	LOC_CS
respecto de	LOC_PREP
Rev.	Y
rigor mortis	NCMN000
rock & roll	NCMS000
rock 'n' roll	NCMS000
rock ’n’ roll	NCMS000
rock and roll	NCMS000
rock&roll	NCMS000
rock'n'roll	NCMS000
rock’n’roll	NCMS000
RR. HH.	Y
Rte.	Y
rum rum	NCMS000
Rvd.	Y
Rvda.	Y
Rvdma.	Y
Rvdmo.	Y
Rvdo.	Y
río abajo	LOC_ADV
río arriba	LOC_ADV
Río de Janeiro	NPCSG00
s.	Y
s. a.	Y
S. A.	Y
S. A. I.	Y
S. A. R.	Y
S. A. S.	Y
s. c.	Y
s. d.	Y
S. D. M.	Y
s. e.	Y
S. E.	Y
s. e. u o.	Y
s. f.	Y
S. I.	Y
S. J.	Y
s. l.	Y
S. L.	Y
S. M.	Y
s. n.	Y
S. P.	Y
S. R. C.	Y
S. R. M.	Y
s. s.	Y
S. S.	Y
s. s. s.	Y
s. v.	Y
S.ª	Y
s/a	Y
s/c	Y
s/e	Y
s/f	Y
s/l	Y
s/n	Y
s/v	Y
salga lo que salga	LOC_ADV
San Cristóbal y Nieves	NPCSG00
Sant Cugat	NPCSG00
Sant Cugat del Vallès	NPCSG00
Sant Joan Despí	NPCSG00
Sdad.	Y
sea cual fuere	LOC_ADV
sea lo que fuere	LOC_ADV
según como	LOC_ADV
según el decir de	LOC_PREP
según que	LOC_CS
semejante a	LOC_PREP
sensu lato	LOC_ADV
sensu stricto	LOC_ADV
sex appeal	NCMS000
sex shop	NCCS000
sex shops	NCCP000
sex symbol	NCCS000
sex symbols	NCCP000
Sgto.	Y
show business	NCMS000
si acaso	LOC_ADV
si bien se mira	LOC_ADV
siempre y cuando	LOC_CS
sig.	Y
similar a	LOC_PREP
sin ambages	LOC_ADV
sin chistar ni mistar	LOC_ADV
sin comerlo ni beberlo	LOC_ADV
sin contar con	LOC_PREP
sin contar con que	LOC_CS
sin duda alguna	LOC_ADV
sin ir más lejos	LOC_ADV
sin lugar a dudas	LOC_ADV
sin más ni más	LOC_ADV
sin necesidad de	LOC_PREP
sin ninguna duda	LOC_ADV
sin pena ni gloria	LOC_ADV
sin perjuicio de	LOC_PREP
sin qué ni para qué	LOC_ADV
sin ton ni son	LOC_ADV
sin trastes	LOC_ADV
sin venir a pelo	LOC_ADV
sine die	LOC_ADV
sine qua non	LOC_ADV
singularia tantum	LOC_ADV
snack bar	NCMS000
snack bars	NCMP000
so pena de que	LOC_CS
so pena que	LOC_CS
sobre manera	LOC_ADV
sobre seguro	LOC_ADV
Soc.	Y
sotto voce	LOC_ADV
Sr.ª	Y
Sri Lanka	NPCSG00
Srta.	Y
Sta.	Y
stabat mater	NCMN000
statu quo	NCMN000
status quo	NCMN000
Sto.	Y
stricto sensu	LOC_ADV
sub iudice	LOC_ADV
sub judice	LOC_ADV
sub voce	LOC_ADV
sui géneris	LOC_ADV
sui generis	LOC_ADV
#supuesto que	LOC_CS
t.	Y
tabula gratulatoria	NCFS000
tabula rasa	NCFS000
tal como	LOC_CS
tal cual	LOC_ADV
tal vez	LOC_ADV
tal y como	LOC_CS
tan pronto como	LOC_CS
tan siquiera	LOC_ADV
tanto menos que	LOC_CS
tanto más que	LOC_CS
tanto peor	LOC_ADV
tanto por ciento	NCMS000
tanto por tanto	LOC_ADV
Tantum ergo	NCMS000
tel.	Y
teléf.	Y
test.º	Y
tfno.	Y
tie break	NCMS000
tie breaks	NCMP000
tierra adentro	LOC_ADV
todo lo contrario	LOC_ADV
todo oídos	LOC_ADV
todo quisque	NCMS000
toga picta	LOC_ADV
top model	NCCS000
top models	NCCP000
totum revolutum	NCMS000
tour de force	NCMS000
trad.	Y
Trinidad y Tobago	NPCSG00
Tte.	Y
tutti quanti	LOC_ADV
tít.	Y
U.	Y
Ud.	Y
Uds.	Y
un día u otro	LOC_ADV
un día y otro	LOC_ADV
un poco tarde	LOC_ADV
una vez que	LOC_CS
una y no más	LOC_ADV
Univ.	Y
uno por uno	LOC_ADV
urbi et orbi	LOC_ADV
ut retro	LOC_ADV
ut supra	LOC_ADV
v.	Y
V. A.	Y
V. A. R.	Y
V. B.	Y
V. E.	Y
v. g.	Y
v. gr.	Y
V. I.	Y
V. M.	Y
V. O.	Y
V. O. S.	Y
V. P.	Y
V. S.	Y
V. S. I.	Y
v.º	Y
V.º B.º	Y
v/	Y
vade retro	LOC_ADV
vae victis	LOC_ADV
Valmte.	Y
vaya por Dios	LOC_I
Vd.	Y
Vda.	Y
Vdo.	Y
Vds.	Y
velis nolis	LOC_ADV
vera effigies	LOC_ADV
verbi gratia	LOC_ADV
vid.	Y
viva voce	LOC_ADV
vol.	Y
voto a bríos	LOC_ADV
vox populi	LOC_ADV
vox populi	NCFS000
vs.	Y
vta.	Y
vto.	Y
VV. AA.	Y
vv. aa.	Y
vía crucis	NCMN000
Vía Crucis	NCMN000
W. C.	Y
wi fi	NCCN000
Wi Fi	NCCN000
wi-fi	NCCN000
Wi-Fi	NCCN000
wind surf	NCMS000
wind surfing	NCMS000
Xto.	Y
ya es mucho decir	LOC_ADV
ya que	LOC_CS
ya será menos	LOC_ADV
íd.	Y
ídem de ídem	LOC_ADV
óp. cit.	Y
ópera prima	NCFS000

#########################################################################
###                        Nombres científicos                        ###
#########################################################################

Acacia baileyana	NPCN000
Acacia cyanophylla	NPCN000
Acacia cyclops	NPCN000
Acacia dealbata	NPCN000
Acacia decurrens	NPCN000
Acacia karroo	NPCN000
Acacia longifolia	NPCN000
Acacia mearnsii	NPCN000
Acacia melanoxylon	NPCN000
Acacia pycnantha	NPCN000
Acacia retinodes	NPCN000
Acacia sp	NPCN000
Acacia spp	NPCN000
Acanthamoeba castellanii	NPCN000
Acanthamoeba sp	NPCN000
Acanthamoeba spp	NPCN000
Acetobacter aurantius	NPCN000
Acetobacter sp	NPCN000
Acetobacter spp	NPCN000
Acinetobacter baumannii	NPCN000
Acinetobacter sp	NPCN000
Acinetobacter spp	NPCN000
Acridotheres cristatellus	NPCN000
Acridotheres sp	NPCN000
Acridotheres spp	NPCN000
Acridotheres tristis	NPCN000
Actinomyces israelii	NPCN000
Actinomyces sp	NPCN000
Actinomyces spp	NPCN000
Aedes aegypti	NPCN000
Aedes albopictus	NPCN000
Aedes sp	NPCN000
Aedes spp	NPCN000
Aegilops sp	NPCN000
Aegilops spp	NPCN000
Aegilops tauschii	NPCN000
Agave americana	NPCN000
Agave sp	NPCN000
Agave spp	NPCN000
Agrobacterium radiobacter	NPCN000
Agrobacterium sp	NPCN000
Agrobacterium spp	NPCN000
Agrobacterium tumefaciens	NPCN000
Ailanthus altissima	NPCN000
Ailanthus sp	NPCN000
Ailanthus spp	NPCN000
Albizia lophanta	NPCN000
Albizia sp	NPCN000
Albizia spp	NPCN000
Albugo candidalbugo	NPCN000
Albugo sp	NPCN000
Albugo spp	NPCN000
Alopochen aegyptiacus	NPCN000
Alopochen sp	NPCN000
Alopochen spp	NPCN000
Amadina fasciata	NPCN000
Amadina sp	NPCN000
Amadina spp	NPCN000
Amandava amandava	NPCN000
Amandava sp	NPCN000
Amandava spp	NPCN000
Amandava subflava	NPCN000
Amborella sp	NPCN000
Amborella spp	NPCN000
Amborella trichopodarabidopsis	NPCN000
Amphimedon queenslandicanopheles	NPCN000
Amphimedon sp	NPCN000
Amphimedon spp	NPCN000
Anaplasma phagocytophilum	NPCN000
Anaplasma sp	NPCN000
Anaplasma spp	NPCN000
Anas platyrhynchos	NPCN000
Anas sp	NPCN000
Anas spp	NPCN000
Angomonas deanei	NPCN000
Angomonas sp	NPCN000
Angomonas spp	NPCN000
Anopheles gambiae	NPCN000
Anopheles sp	NPCN000
Anopheles spp	NPCN000
Anser indicus	NPCN000
Anser sp	NPCN000
Anser spp	NPCN000
Aphanomyces astaci	NPCN000
Aphanomyces invadans	NPCN000
Aphanomyces sp	NPCN000
Aphanomyces spp	NPCN000
Apis mellifera	NPCN000
Apis melliferatta	NPCN000
Apis sp	NPCN000
Apis spp	NPCN000
Apodemus sp	NPCN000
Apodemus spp	NPCN000
Apodemus sylvaticus	NPCN000
Aquila chrysaetos	NPCN000
Aquila sp	NPCN000
Aquila spp	NPCN000
Ara sp	NPCN000
Ara spp	NPCN000
Aratinga acuticaudata	NPCN000
Aratinga sp	NPCN000
Aratinga spp	NPCN000
Arctotheca calendula	NPCN000
Arctotheca sp	NPCN000
Arctotheca spp	NPCN000
Arundo donax	NPCN000
Arundo sp	NPCN000
Arundo spp	NPCN000
Arvicola sapidus	NPCN000
Arvicola sp	NPCN000
Arvicola spp	NPCN000
Arvicola terrestris	NPCN000
Astyanax mexicanus	NPCN000
Astyanax sp	NPCN000
Astyanax spp	NPCN000
Aureococcus anophagefferens	NPCN000
Aureococcus sp	NPCN000
Aureococcus spp	NPCN000
Azolla caroliniana	NPCN000
Azolla filiculoides	NPCN000
Azolla sp	NPCN000
Azolla spp	NPCN000
Azorhizobium caulinodans	NPCN000
Azorhizobium sp	NPCN000
Azorhizobium spp	NPCN000
Azotobacter sp	NPCN000
Azotobacter spp	NPCN000
Azotobacter vinelandii	NPCN000
Babesia bigemina	NPCN000
Babesia bovis	NPCN000
Babesia microti	NPCN000
Babesia sp	NPCN000
Babesia spp	NPCN000
Bacillus anthracis	NPCN000
Bacillus brevis	NPCN000
Bacillus cereus	NPCN000
Bacillus fusiformis	NPCN000
Bacillus licheniformis	NPCN000
Bacillus megaterium	NPCN000
Bacillus mycoides	NPCN000
Bacillus sp	NPCN000
Bacillus spp	NPCN000
Bacillus stearothermophilus	NPCN000
Bacillus subtilis	NPCN000
Bacteroides fragilis	NPCN000
Bacteroides gingivalis	NPCN000
Bacteroides melaninogenicus	NPCN000
Bacteroides sp	NPCN000
Bacteroides spp	NPCN000
Balaena mysticetus	NPCN000
Balaena sp	NPCN000
Balaena spp	NPCN000
Balaenoptera acutorostrata	NPCN000
Balaenoptera bonaerensis	NPCN000
Balaenoptera borealis	NPCN000
Balaenoptera brydei	NPCN000
Balaenoptera edeni	NPCN000
Balaenoptera musculus	NPCN000
Balaenoptera omurai	NPCN000
Balaenoptera physalus	NPCN000
Balaenoptera sp	NPCN000
Balaenoptera spp	NPCN000
Barbastella barbastellus	NPCN000
Barbastella sp	NPCN000
Barbastella spp	NPCN000
Bartonella henselae	NPCN000
Bartonella quintana	NPCN000
Bartonella sp	NPCN000
Bartonella spp	NPCN000
Belgica antarctica	NPCN000
Belgica sp	NPCN000
Belgica spp	NPCN000
Berardius arnuxii	NPCN000
Berardius bairdii	NPCN000
Berardius sp	NPCN000
Berardius spp	NPCN000
Beta sp	NPCN000
Beta spp	NPCN000
Beta vulgaris	NPCN000
Bigelowiella natans	NPCN000
Bigelowiella sp	NPCN000
Bigelowiella spp	NPCN000
Blastocystis hominis	NPCN000
Blastocystis sp	NPCN000
Blastocystis spp	NPCN000
Bodo saltans	NPCN000
Bodo sp	NPCN000
Bodo spp	NPCN000
Bombus impatiens	NPCN000
Bombus sp	NPCN000
Bombus spp	NPCN000
Bombyx mori	NPCN000
Bombyx sp	NPCN000
Bombyx spp	NPCN000
Bordetella bronchiseptica	NPCN000
Bordetella pertussis	NPCN000
Bordetella sp	NPCN000
Bordetella spp	NPCN000
Borrelia burgdorferi	NPCN000
Borrelia sp	NPCN000
Borrelia spp	NPCN000
Bos sp	NPCN000
Bos spp	NPCN000
Bos taurus	NPCN000
Brachypodium distachyon	NPCN000
Brachypodium sp	NPCN000
Brachypodium spp	NPCN000
Brassica napus	NPCN000
Brassica oleracea	NPCN000
Brassica rapa	NPCN000
Brassica sp	NPCN000
Brassica spp	NPCN000
Brucella abortus	NPCN000
Brucella melitensis	NPCN000
Brucella sp	NPCN000
Brucella spp	NPCN000
Brucella suis	NPCN000
Brugia malayi	NPCN000
Brugia sp	NPCN000
Brugia spp	NPCN000
Bulweria bulwerii	NPCN000
Bulweria sp	NPCN000
Bulweria spp	NPCN000
Burkholderia cepacia	NPCN000
Burkholderia mallei	NPCN000
Burkholderia pseudomallei	NPCN000
Burkholderia sp	NPCN000
Burkholderia spp	NPCN000
Buteo buteo	NPCN000
Buteo sp	NPCN000
Buteo spp	NPCN000
Cacatua goffini	NPCN000
Cacatua sp	NPCN000
Cacatua spp	NPCN000
Caenorhabditis brenneri	NPCN000
Caenorhabditis briggsae	NPCN000
Caenorhabditis elegans	NPCN000
Caenorhabditis japonicaenorhabditis	NPCN000
Caenorhabditis sp	NPCN000
Caenorhabditis spp	NPCN000
Callithrix jacchus	NPCN000
Callithrix sp	NPCN000
Callithrix spp	NPCN000
Calymmatobacterium granulomatis	NPCN000
Calymmatobacterium sp	NPCN000
Calymmatobacterium spp	NPCN000
Campylobacter coli	NPCN000
Campylobacter fetus	NPCN000
Campylobacter jejuni	NPCN000
Campylobacter pylori	NPCN000
Campylobacter sp	NPCN000
Campylobacter spp	NPCN000
Canis lupus	NPCN000
Canis sp	NPCN000
Canis spp	NPCN000
Caperea marginata	NPCN000
Caperea sp	NPCN000
Caperea spp	NPCN000
Capitella sp	NPCN000
Capitella spp	NPCN000
Capitella teleta	NPCN000
Capra pyrenaica	NPCN000
Capra sp	NPCN000
Capra spp	NPCN000
Capreolus capreolus	NPCN000
Capreolus sp	NPCN000
Capreolus spp	NPCN000
Capsaspora owczarzaki	NPCN000
Capsaspora sp	NPCN000
Capsaspora spp	NPCN000
Carassius auratus	NPCN000
Carassius sp	NPCN000
Carassius spp	NPCN000
Carduelis carduelis	NPCN000
Carduelis chloris	NPCN000
Carduelis sp	NPCN000
Carduelis spp	NPCN000
Carpobrotus edulis	NPCN000
Carpobrotus sp	NPCN000
Carpobrotus spp	NPCN000
Castanea sativa	NPCN000
Castanea sp	NPCN000
Castanea spp	NPCN000
Castor fiber	NPCN000
Castor sp	NPCN000
Castor spp	NPCN000
Cavia porcellus	NPCN000
Cavia sp	NPCN000
Cavia spp	NPCN000
Cephalorhynchus commersonii	NPCN000
Cephalorhynchus eutropia	NPCN000
Cephalorhynchus heavisidii	NPCN000
Cephalorhynchus hectori	NPCN000
Cephalorhynchus sp	NPCN000
Cephalorhynchus spp	NPCN000
Ceratotherium simum	NPCN000
Ceratotherium sp	NPCN000
Ceratotherium spp	NPCN000
Cervus elaphus	NPCN000
Cervus sp	NPCN000
Cervus spp	NPCN000
Carcharodon carcharias	NPCN000
Carcharodon sp	NPCN000
Carcharodon spp	NPCN000
Carcharias sp	NPCN000
Carcharias spp	NPCN000
Carcharias taurus	NPCN000
Chlamydia sp	NPCN000
Chlamydia spp	NPCN000
Chlamydia trachomatis	NPCN000
Chlamydomonas reinhardtii	NPCN000
Chlamydomonas sp	NPCN000
Chlamydomonas spp	NPCN000
Chlamydophila pneumoniae	NPCN000
Chlamydophila psittaci	NPCN000
Chlamydophila sp	NPCN000
Chlamydophila spp	NPCN000
Chlorocebus sabaeus	NPCN000
Chlorocebus sp	NPCN000
Chlorocebus spp	NPCN000
Choloepus hoffmanni	NPCN000
Choloepus sp	NPCN000
Choloepus spp	NPCN000
Chondrus crispus	NPCN000
Chondrus sp	NPCN000
Chondrus spp	NPCN000
Chroomonas mesostigmatica	NPCN000
Chroomonas sp	NPCN000
Chroomonas spp	NPCN000
Chrysemys pictailuropoda	NPCN000
Chrysemys sp	NPCN000
Chrysemys spp	NPCN000
Cichlasoma facetum	NPCN000
Cichlasoma sp	NPCN000
Cichlasoma spp	NPCN000
Ciconia sp	NPCN000
Ciconia spp	NPCN000
Ciconia ciconia	NPCN000
Ciona intestinalis	NPCN000
Ciona savignyi	NPCN000
Ciona sp	NPCN000
Ciona spp	NPCN000
Clostridium botulinum	NPCN000
Clostridium difficile	NPCN000
Clostridium perfringens	NPCN000
Clostridium sp	NPCN000
Clostridium spp	NPCN000
Clostridium tetani	NPCN000
Columba livia	NPCN000
Columba sp	NPCN000
Columba spp	NPCN000
Columbina passerina	NPCN000
Columbina sp	NPCN000
Columbina spp	NPCN000
Conyza bonariensis	NPCN000
Conyza sp	NPCN000
Conyza spp	NPCN000
Corbicula fluminea	NPCN000
Corbicula sp	NPCN000
Corbicula spp	NPCN000
Cortaderia selloana	NPCN000
Cortaderia sp	NPCN000
Cortaderia spp	NPCN000
Corynebacterium diphtheriae	NPCN000
Corynebacterium fusiforme	NPCN000
Corynebacterium sp	NPCN000
Corynebacterium spp	NPCN000
Coxiella burnetii	NPCN000
Coxiella sp	NPCN000
Coxiella spp	NPCN000
Crassostrea gigas	NPCN000
Crassostrea sp	NPCN000
Crassostrea spp	NPCN000
Cricetulus griseus	NPCN000
Cricetulus sp	NPCN000
Cricetulus spp	NPCN000
Crocidura russula	NPCN000
Crocidura sp	NPCN000
Crocidura spp	NPCN000
Crocidura suaveolens	NPCN000
Cryptomonas paramecium	NPCN000
Cryptomonas sp	NPCN000
Cryptomonas spp	NPCN000
Cryptosporidium muris	NPCN000
Cryptosporidium parvum	NPCN000
Cryptosporidium sp	NPCN000
Cryptosporidium spp	NPCN000
Culex quinquefasciatus	NPCN000
Culex sp	NPCN000
Culex spp	NPCN000
Cupressus lusitanica	NPCN000
Cupressus sp	NPCN000
Cupressus spp	NPCN000
Cyanidioschyzon merolae	NPCN000
Cyanidioschyzon sp	NPCN000
Cyanidioschyzon spp	NPCN000
Cyanollseus patagonus	NPCN000
Cyanollseus sp	NPCN000
Cyanollseus spp	NPCN000
Cygnus atratus	NPCN000
Cygnus sp	NPCN000
Cygnus spp	NPCN000
Cyprinus carpio	NPCN000
Cyprinus sp	NPCN000
Cyprinus spp	NPCN000
Cystophora cristata	NPCN000
Cystophora sp	NPCN000
Cystophora spp	NPCN000
Dama dama	NPCN000
Dama sp	NPCN000
Dama spp	NPCN000
Danaus plexippus	NPCN000
Danaus sp	NPCN000
Danaus spp	NPCN000
Danio rerio	NPCN000
Danio sp	NPCN000
Danio spp	NPCN000
Daphnia pulex	NPCN000
Daphnia sp	NPCN000
Daphnia spp	NPCN000
Dasypus novemcinctus	NPCN000
Dasypus sp	NPCN000
Dasypus spp	NPCN000
Datura sp	NPCN000
Datura spp	NPCN000
Datura stramonium	NPCN000
Delichon sp	NPCN000
Delichon spp	NPCN000
Delichon urbicum	NPCN000
Delphinapterus leucas	NPCN000
Delphinapterus sp	NPCN000
Delphinapterus spp	NPCN000
Delphinus capensis	NPCN000
Delphinus delphis	NPCN000
Delphinus sp	NPCN000
Delphinus spp	NPCN000
Delphinus tropicalis	NPCN000
Dendroctonus ponderosae	NPCN000
Dendroctonus sp	NPCN000
Dendroctonus spp	NPCN000
Dictyostelium discoideum	NPCN000
Dictyostelium fasciculatum	NPCN000
Dictyostelium lacteum	NPCN000
Dictyostelium purpureum	NPCN000
Dictyostelium sp	NPCN000
Dictyostelium spp	NPCN000
Dipodomys ordii	NPCN000
Dipodomys sp	NPCN000
Dipodomys spp	NPCN000
Drosophila ananassae	NPCN000
Drosophila erecta	NPCN000
Drosophila grimshawi	NPCN000
Drosophila melanogaster	NPCN000
Drosophila mojavensis	NPCN000
Drosophila persimilis	NPCN000
Drosophila pseudoobscura	NPCN000
Drosophila sechellia	NPCN000
Drosophila simulans	NPCN000
Drosophila sp	NPCN000
Drosophila spp	NPCN000
Drosophila virilis	NPCN000
Drosophila willistoni	NPCN000
Drosophila yakuba	NPCN000
Dwarf minke	NPCN000
Dwarf sp	NPCN000
Dwarf spp	NPCN000
Echinops sp	NPCN000
Echinops spp	NPCN000
Echinops telfairi	NPCN000
Ehrlichia chaffeensis	NPCN000
Ehrlichia sp	NPCN000
Ehrlichia spp	NPCN000
Eichhornia crassipes	NPCN000
Eichhornia sp	NPCN000
Eichhornia spp	NPCN000
Eimeria acervulina	NPCN000
Eimeria brunetti	NPCN000
Eimeria maxima	NPCN000
Eimeria mitis	NPCN000
Eimeria necatrix	NPCN000
Eimeria praecox	NPCN000
Eimeria sp	NPCN000
Eimeria spp	NPCN000
Eimeria tenella	NPCN000
Eliomys quercinus	NPCN000
Eliomys sp	NPCN000
Eliomys spp	NPCN000
Elodea canadensis	NPCN000
Elodea sp	NPCN000
Elodea spp	NPCN000
Emberiza calandra	NPCN000
Emberiza sp	NPCN000
Emberiza spp	NPCN000
Emiliania huxleyi	NPCN000
Emiliania sp	NPCN000
Emiliania spp	NPCN000
Entamoeba dispar	NPCN000
Entamoeba histolytica	NPCN000
Entamoeba invadens	NPCN000
Entamoeba nuttalli	NPCN000
Entamoeba sp	NPCN000
Entamoeba spp	NPCN000
Enterobacter cloacae	NPCN000
Enterobacter sp	NPCN000
Enterobacter spp	NPCN000
Enterococcus avium	NPCN000
Enterococcus durans	NPCN000
Enterococcus faecalis	NPCN000
Enterococcus faecium	NPCN000
Enterococcus galllinarum	NPCN000
Enterococcus maloratus	NPCN000
Enterococcus sp	NPCN000
Enterococcus spp	NPCN000
Eos bornea	NPCN000
Eos sp	NPCN000
Eos spp	NPCN000
Eptesicus serotinus	NPCN000
Eptesicus sp	NPCN000
Eptesicus spp	NPCN000
Equus caballus	NPCN000
Equus sp	NPCN000
Equus spp	NPCN000
Erigeron karvinskianus	NPCN000
Erigeron sp	NPCN000
Erigeron spp	NPCN000
Erignathus barbatus	NPCN000
Erignathus sp	NPCN000
Erignathus spp	NPCN000
Erinaceus europaeus	NPCN000
Erinaceus sp	NPCN000
Erinaceus spp	NPCN000
Eriocheir sinensis	NPCN000
Eriocheir sp	NPCN000
Eriocheir spp	NPCN000
Erithacus rubecula	NPCN000
Erithacus sp	NPCN000
Erithacus spp	NPCN000
Eryngium pandanifolium	NPCN000
Eryngium sp	NPCN000
Eryngium spp	NPCN000
Escherichia coli	NPCN000
Escherichia sp	NPCN000
Escherichia spp	NPCN000
Eschrichtius robustus	NPCN000
Eschrichtius sp	NPCN000
Eschrichtius spp	NPCN000
Esox lucius	NPCN000
Esox sp	NPCN000
Esox spp	NPCN000
Estrilda astrild	NPCN000
Estrilda caerulescens	NPCN000
Estrilda melpoda	NPCN000
Estrilda rhodopyga	NPCN000
Estrilda sp	NPCN000
Estrilda spp	NPCN000
Estrilda troglodytes	NPCN000
Eubalaena australis	NPCN000
Eubalaena glacialis	NPCN000
Eubalaena japonica	NPCN000
Eubalaena sp	NPCN000
Eubalaena spp	NPCN000
Eucalyptus globulus	NPCN000
Eucalyptus sp	NPCN000
Eucalyptus spp	NPCN000
Euplectes afer	NPCN000
Euplectes ardens	NPCN000
Euplectes franciscanus	NPCN000
Euplectes hordeaceus	NPCN000
Euplectes macrourus	NPCN000
Euplectes orix	NPCN000
Euplectes progne	NPCN000
Euplectes sp	NPCN000
Euplectes spp	NPCN000
European hedgehog	NPCN000
European sp	NPCN000
European spp	NPCN000
Felis catus	NPCN000
Felis silvestris	NPCN000
Felis sp	NPCN000
Felis spp	NPCN000
Feresa attenuata	NPCN000
Feresa sp	NPCN000
Feresa spp	NPCN000
Ficedula albicollis	NPCN000
Ficedula sp	NPCN000
Ficedula spp	NPCN000
Fissipeds –	NPCN000
Fissipeds sp	NPCN000
Fissipeds spp	NPCN000
Fonticula alba	NPCN000
Fonticula sp	NPCN000
Fonticula spp	NPCN000
Francisella sp	NPCN000
Francisella spp	NPCN000
Francisella tularensis	NPCN000
Francolinus francolinus	NPCN000
Francolinus sp	NPCN000
Francolinus spp	NPCN000
Fringilla coelebs	NPCN000
Fringilla sp	NPCN000
Fringilla spp	NPCN000
Fundulus heteroclitus	NPCN000
Fundulus sp	NPCN000
Fundulus spp	NPCN000
Fusobacterium nucleatum	NPCN000
Fusobacterium sp	NPCN000
Fusobacterium spp	NPCN000
Gadus morhua	NPCN000
Gadus sp	NPCN000
Gadus spp	NPCN000
Galdieria sp	NPCN000
Galdieria spp	NPCN000
Galdieria sulphuraria	NPCN000
Galemys pyrenaicus	NPCN000
Galemys sp	NPCN000
Galemys spp	NPCN000
Galinsoga parviflora	NPCN000
Galinsoga sp	NPCN000
Galinsoga spp	NPCN000
Gallus gallus	NPCN000
Gallus sp	NPCN000
Gallus spp	NPCN000
Gambusia holbrooki	NPCN000
Gambusia sp	NPCN000
Gambusia spp	NPCN000
Gardnerella sp	NPCN000
Gardnerella spp	NPCN000
Gardnerella vaginalis	NPCN000
Garrulax leucolophus	NPCN000
Garrulax sp	NPCN000
Garrulax spp	NPCN000
Gasterosteus aculeatus	NPCN000
Gasterosteus sp	NPCN000
Gasterosteus spp	NPCN000
Genetta genetta	NPCN000
Genetta sp	NPCN000
Genetta spp	NPCN000
Giardia intestinalis	NPCN000
Giardia lamblia	NPCN000
Giardia sp	NPCN000
Giardia spp	NPCN000
Ginkgo biloba	NPCN000
Ginkgo sp	NPCN000
Ginkgo spp	NPCN000
Globicephala macrorhynchus	NPCN000
Globicephala melas	NPCN000
Globicephala sp	NPCN000
Globicephala spp	NPCN000
Glycine max	NPCN000
Glycine sp	NPCN000
Glycine spp	NPCN000
Gorilla gorilla	NPCN000
Gorilla sp	NPCN000
Gorilla spp	NPCN000
Grampus griseus	NPCN000
Grampus sp	NPCN000
Grampus spp	NPCN000
Gregarina niphandrodes	NPCN000
Gregarina sp	NPCN000
Gregarina spp	NPCN000
Grus grus	NPCN000
Grus sp	NPCN000
Grus spp	NPCN000
Guillardia sp	NPCN000
Guillardia spp	NPCN000
Guillardia theta	NPCN000
Haemophilus ducreyi	NPCN000
Haemophilus influenzae	NPCN000
Haemophilus parainfluenzae	NPCN000
Haemophilus pertussis	NPCN000
Haemophilus sp	NPCN000
Haemophilus spp	NPCN000
Haemophilus vaginalis	NPCN000
Hakea salicifolia	NPCN000
Hakea sericea	NPCN000
Hakea sp	NPCN000
Hakea spp	NPCN000
Hammondia hammondi	NPCN000
Hammondia sp	NPCN000
Hammondia spp	NPCN000
Hedychium gardnerianum	NPCN000
Hedychium sp	NPCN000
Hedychium spp	NPCN000
Helicobacter pylori	NPCN000
Helicobacter sp	NPCN000
Helicobacter spp	NPCN000
Heliconius melpomene	NPCN000
Heliconius sp	NPCN000
Heliconius spp	NPCN000
Helobdella robusta	NPCN000
Helobdella sp	NPCN000
Helobdella spp	NPCN000
Herpestes ichneumon	NPCN000
Herpestes sp	NPCN000
Herpestes spp	NPCN000
Heterocephalus glaber	NPCN000
Heterocephalus sp	NPCN000
Heterocephalus spp	NPCN000
Hirundo rustica	NPCN000
Hirundo sp	NPCN000
Hirundo spp	NPCN000
Homo antecessor	NPCN000
Homo cepranensis	NPCN000
Homo erectus	NPCN000
Homo ergaster	NPCN000
Homo floresiensis	NPCN000
Homo gautengensis	NPCN000
Homo habilis	NPCN000
Homo heidelbergensis	NPCN000
Homo naledi	NPCN000
Homo neanderthalensis	NPCN000
Homo rhodesiensis	NPCN000
Homo rudolfensis	NPCN000
Homo sapiens	NPCN000
Homo sapiens sapiens	NPCN000
Homo sp	NPCN000
Homo spp	NPCN000
Homo tsaichangensis	NPCN000
Hordeum sp	NPCN000
Hordeum spp	NPCN000
Hordeum vulgare	NPCN000
Hyaloperonospora arabidopsidis	NPCN000
Hyaloperonospora sp	NPCN000
Hyaloperonospora spp	NPCN000
Hyperoodon ampullatus	NPCN000
Hyperoodon planifrons	NPCN000
Hyperoodon sp	NPCN000
Hyperoodon spp	NPCN000
Ictalurus punctatus	NPCN000
Ictalurus sp	NPCN000
Ictalurus spp	NPCN000
Ichthyophthirius multifiliis	NPCN000
Ichthyophthirius sp	NPCN000
Ichthyophthirius spp	NPCN000
Ictidomys sp	NPCN000
Ictidomys spp	NPCN000
Ictidomys tridecemlineatusaimiri	NPCN000
Ilex aquifolium	NPCN000
Ilex sp	NPCN000
Ilex spp	NPCN000
Inia geoffrensis	NPCN000
Inia sp	NPCN000
Inia spp	NPCN000
Ipomoea acuminata	NPCN000
Ipomoea sp	NPCN000
Ipomoea spp	NPCN000
Ixodes scapularis	NPCN000
Ixodes sp	NPCN000
Ixodes spp	NPCN000
Klebsiella pneumoniae	NPCN000
Klebsiella sp	NPCN000
Klebsiella spp	NPCN000
Kogia breviceps	NPCN000
Kogia sima	NPCN000
Kogia sp	NPCN000
Kogia spp	NPCN000
Lactobacillus acidophilus	NPCN000
Lactobacillus bulgaricus	NPCN000
Lactobacillus casei	NPCN000
Lactobacillus sp	NPCN000
Lactobacillus spp	NPCN000
Lactococcus lactis	NPCN000
Lactococcus sp	NPCN000
Lactococcus spp	NPCN000
Lagenodelphis hosei	NPCN000
Lagenodelphis sp	NPCN000
Lagenodelphis spp	NPCN000
Lagenorhynchus acutus	NPCN000
Lagenorhynchus albirostris	NPCN000
Lagenorhynchus australissodelphis	NPCN000
Lagenorhynchus cruciger	NPCN000
Lagenorhynchus obliquidens	NPCN000
Lagenorhynchus obscurus	NPCN000
Lagenorhynchus sp	NPCN000
Lagenorhynchus spp	NPCN000
Lamprotornis sp	NPCN000
Lamprotornis spp	NPCN000
Lantana camara	NPCN000
Lantana sp	NPCN000
Lantana spp	NPCN000
Larus michahellis	NPCN000
Larus sp	NPCN000
Larus spp	NPCN000
Latimeria chalumnae	NPCN000
Latimeria sp	NPCN000
Latimeria spp	NPCN000
Leersia perrieri	NPCN000
Leersia sp	NPCN000
Leersia spp	NPCN000
Legionella pneumophila	NPCN000
Legionella sp	NPCN000
Legionella spp	NPCN000
Leiothrix lutea	NPCN000
Leiothrix sp	NPCN000
Leiothrix spp	NPCN000
Leishmania braziliensis	NPCN000
Leishmania donovani	NPCN000
Leishmania infantum	NPCN000
Leishmania major	NPCN000
Leishmania mexicana	NPCN000
Leishmania panamensis	NPCN000
Leishmania sp	NPCN000
Leishmania spp	NPCN000
Lepeophtheirus salmonis	NPCN000
Lepeophtheirus sp	NPCN000
Lepeophtheirus spp	NPCN000
Lepisosteus oculatus	NPCN000
Lepisosteus sp	NPCN000
Lepisosteus spp	NPCN000
Lepomis gibbosus	NPCN000
Lepomis sp	NPCN000
Lepomis spp	NPCN000
Leptomonas pyrrhocoris	NPCN000
Leptomonas seymouri	NPCN000
Leptomonas sp	NPCN000
Leptomonas spp	NPCN000
Leptoptilos crumeniferus	NPCN000
Leptoptilos sp	NPCN000
Leptoptilos spp	NPCN000
Lepus granatensis	NPCN000
Lepus sp	NPCN000
Lepus spp	NPCN000
Lingula anatina	NPCN000
Lingula sp	NPCN000
Lingula spp	NPCN000
Lipotes sp	NPCN000
Lipotes spp	NPCN000
Lipotes vexillifer	NPCN000
Listeria monocytogenes	NPCN000
Listeria sp	NPCN000
Listeria spp	NPCN000
Loa loa	NPCN000
Loa sp	NPCN000
Loa spp	NPCN000
Lonchura cantans	NPCN000
Lonchura maja	NPCN000
Lonchura malacca	NPCN000
Lonchura punctulata	NPCN000
Lonchura sp	NPCN000
Lonchura spp	NPCN000
Lophophorus impejanus	NPCN000
Lophophorus sp	NPCN000
Lophophorus spp	NPCN000
Lotharella oceanica	NPCN000
Lotharella sp	NPCN000
Lotharella spp	NPCN000
Lottia gigantea	NPCN000
Lottia sp	NPCN000
Lottia spp	NPCN000
Loxodonta africana	NPCN000
Loxodonta sp	NPCN000
Loxodonta spp	NPCN000
Lucilia cuprina	NPCN000
Lucilia sp	NPCN000
Lucilia spp	NPCN000
Lutra lutra	NPCN000
Lutra sp	NPCN000
Lutra spp	NPCN000
Lynx pardinus	NPCN000
Lynx sp	NPCN000
Lynx spp	NPCN000
Macaca fascicularis	NPCN000
Macaca mulatta	NPCN000
Macaca sp	NPCN000
Macaca spp	NPCN000
Macropus eugenii	NPCN000
Macropus sp	NPCN000
Macropus spp	NPCN000
Martes foina	NPCN000
Martes martes	NPCN000
Martes sp	NPCN000
Martes spp	NPCN000
Medicago sp	NPCN000
Medicago spp	NPCN000
Medicago truncatula	NPCN000
Megaptera novaeangliae	NPCN000
Megaptera sp	NPCN000
Megaptera spp	NPCN000
Megaselia scalaris	NPCN000
Megaselia sp	NPCN000
Megaselia spp	NPCN000
Meleagris gallopavo	NPCN000
Meleagris sp	NPCN000
Meleagris spp	NPCN000
Meles meles	NPCN000
Meles sp	NPCN000
Meles spp	NPCN000
Melitaea cinxia	NPCN000
Melitaea sp	NPCN000
Melitaea spp	NPCN000
Melopsittacus sp	NPCN000
Melopsittacus spp	NPCN000
Melopsittacus undulatus	NPCN000
Mesoplodon bidens	NPCN000
Mesoplodon bowdoini	NPCN000
Mesoplodon carlhubbsindopacetus	NPCN000
Mesoplodon densirostris	NPCN000
Mesoplodon europaeus	NPCN000
Mesoplodon ginkgodens	NPCN000
Mesoplodon grayi	NPCN000
Mesoplodon hectori	NPCN000
Mesoplodon layardii	NPCN000
Mesoplodon mirus	NPCN000
Mesoplodon perrini	NPCN000
Mesoplodon peruvianus	NPCN000
Mesoplodon sp	NPCN000
Mesoplodon spp	NPCN000
Mesoplodon stejnegeri	NPCN000
Mesoplodon traversii	NPCN000
Methanobacterium extroquens	NPCN000
Methanobacterium sp	NPCN000
Methanobacterium spp	NPCN000
Microbacterium multiforme	NPCN000
Microbacterium sp	NPCN000
Microbacterium spp	NPCN000
Microcebus murinus	NPCN000
Microcebus sp	NPCN000
Microcebus spp	NPCN000
Micrococcus luteus	NPCN000
Micrococcus sp	NPCN000
Micrococcus spp	NPCN000
Micropterus salmoides	NPCN000
Micropterus sp	NPCN000
Micropterus spp	NPCN000
Microtus agrestis	NPCN000
Microtus cabrerae	NPCN000
Microtus duodecimcostatus	NPCN000
Microtus lusitanicus	NPCN000
Microtus ochrogaster	NPCN000
Microtus sp	NPCN000
Microtus spp	NPCN000
Miniopterus schreibersii	NPCN000
Miniopterus sp	NPCN000
Miniopterus spp	NPCN000
Mnemiopsis leidyi	NPCN000
Mnemiopsis sp	NPCN000
Mnemiopsis spp	NPCN000
Monachus monachus	NPCN000
Monachus sp	NPCN000
Monachus spp	NPCN000
Monodelphis domestica	NPCN000
Monodelphis sp	NPCN000
Monodelphis spp	NPCN000
Monodon monoceros	NPCN000
Monodon sp	NPCN000
Monodon spp	NPCN000
Monosiga brevicollis	NPCN000
Monosiga sp	NPCN000
Monosiga spp	NPCN000
Moraxella catarrhalis	NPCN000
Moraxella sp	NPCN000
Moraxella spp	NPCN000
Motacilla cinerea	NPCN000
Motacilla sp	NPCN000
Motacilla spp	NPCN000
Musa acuminata	NPCN000
Musa sp	NPCN000
Musa spp	NPCN000
Mus musculus	NPCN000
Mus sp	NPCN000
Mus spp	NPCN000
Mus spretus	NPCN000
Mustela erminea	NPCN000
Mustela nivalis	NPCN000
Mustela putorius	NPCN000
Mustela sp	NPCN000
Mustela spp	NPCN000
Mycobacterium avium	NPCN000
Mycobacterium bovis	NPCN000
Mycobacterium diphtheriae	NPCN000
Mycobacterium intracellulare	NPCN000
Mycobacterium lepraemurium	NPCN000
Mycobacterium leprae	NPCN000
Mycobacterium phlei	NPCN000
Mycobacterium smegmatis	NPCN000
Mycobacterium sp	NPCN000
Mycobacterium spp	NPCN000
Mycobacterium tuberculosis	NPCN000
Mycoplasma fermentans	NPCN000
Mycoplasma genitalium	NPCN000
Mycoplasma hominis	NPCN000
Mycoplasma penetrans	NPCN000
Mycoplasma pneumoniae	NPCN000
Mycoplasma sp	NPCN000
Mycoplasma spp	NPCN000
Mycteria ibis	NPCN000
Mycteria sp	NPCN000
Mycteria spp	NPCN000
Myiopsitta monachus	NPCN000
Myiopsitta sp	NPCN000
Myiopsitta spp	NPCN000
Myoporum sp	NPCN000
Myoporum spp	NPCN000
Myoporum tenuifolium	NPCN000
Myotis bechsteini	NPCN000
Myotis daubentonii	NPCN000
Myotis emarginatus	NPCN000
Myotis escalerai	NPCN000
Myotis lucifugus	NPCN000
Myotis myotis	NPCN000
Myotis mystacinus	NPCN000
Myotis nattereri	NPCN000
Myotis sp	NPCN000
Myotis spp	NPCN000
Myriophyllum brasiliensis	NPCN000
Myriophyllum sp	NPCN000
Myriophyllum spp	NPCN000
Naegleria gruberi	NPCN000
Naegleria sp	NPCN000
Naegleria spp	NPCN000
Nandayus nenday	NPCN000
Nandayus sp	NPCN000
Nandayus spp	NPCN000
Nannochloropsis gaditana	NPCN000
Nannochloropsis sp	NPCN000
Nannochloropsis spp	NPCN000
Nasonia sp	NPCN000
Nasonia spp	NPCN000
Nasonia vitripennis	NPCN000
Neisseria gonorrhoeae	NPCN000
Neisseria meningitidis	NPCN000
Neisseria sp	NPCN000
Neisseria spp	NPCN000
Nematostella sp	NPCN000
Nematostella spp	NPCN000
Nematostella vectensis	NPCN000
Neomys anomalus	NPCN000
Neomys sp	NPCN000
Neomys spp	NPCN000
Neophocaena phocaenoides	NPCN000
Neophocaena sp	NPCN000
Neophocaena spp	NPCN000
Nicotiana glauca	NPCN000
Nicotiana sp	NPCN000
Nicotiana spp	NPCN000
Nomascus leucogenys	NPCN000
Nomascus sp	NPCN000
Nomascus spp	NPCN000
Nyctalus azoreum	NPCN000
Nyctalus lasiopterus	NPCN000
Nyctalus leisleri	NPCN000
Nyctalus noctula	NPCN000
Nyctalus sp	NPCN000
Nyctalus spp	NPCN000
Nymphicus hollandicus	NPCN000
Nymphicus sp	NPCN000
Nymphicus spp	NPCN000
Ochotona princeps	NPCN000
Ochotona sp	NPCN000
Ochotona spp	NPCN000
Octopus bimaculoides	NPCN000
Octopus sp	NPCN000
Octopus spp	NPCN000
Oena capensis	NPCN000
Oena sp	NPCN000
Oena spp	NPCN000
Onchocerca sp	NPCN000
Onchocerca spp	NPCN000
Onchocerca volvulus	NPCN000
Opuntia ficus	NPCN000
Opuntia sp	NPCN000
Opuntia spp	NPCN000
Orcaella brevirostris	NPCN000
Orcaella heinsohni	NPCN000
Orcaella sp	NPCN000
Orcaella spp	NPCN000
Orcinus orca	NPCN000
Orcinus sp	NPCN000
Orcinus spp	NPCN000
Oreochromis niloticus	NPCN000
Oreochromis sp	NPCN000
Oreochromis spp	NPCN000
Ornithorhynchus anatinus	NPCN000
Ornithorhynchus sp	NPCN000
Ornithorhynchus spp	NPCN000
Orycteropus afer	NPCN000
Orycteropus sp	NPCN000
Orycteropus spp	NPCN000
Oryctolagus cuniculus	NPCN000
Oryctolagus sp	NPCN000
Oryctolagus spp	NPCN000
Oryza barthii	NPCN000
Oryza brachyantha	NPCN000
Oryza glaberrima	NPCN000
Oryza glumaepatula	NPCN000
Oryza longistaminata	NPCN000
Oryza meridionalis	NPCN000
Oryza nivara	NPCN000
Oryza punctata	NPCN000
Oryza rufipogon	NPCN000
Oryza sativa	NPCN000
Oryza sp	NPCN000
Oryza spp	NPCN000
Oryzias latipes	NPCN000
Oryzias sp	NPCN000
Oryzias spp	NPCN000
Ostreococcus lucimarinus	NPCN000
Ostreococcus sp	NPCN000
Ostreococcus spp	NPCN000
Otolemur garnettii	NPCN000
Otolemur sp	NPCN000
Otolemur spp	NPCN000
Ovis ariesorex	NPCN000
Ovis sp	NPCN000
Ovis spp	NPCN000
Oxalis pes	NPCN000
Oxalis sp	NPCN000
Oxalis spp	NPCN000
Oxytricha sp	NPCN000
Oxytricha spp	NPCN000
Oxytricha trifallax	NPCN000
Oxyura jamaicensis	NPCN000
Oxyura sp	NPCN000
Oxyura spp	NPCN000
Padda oryzivora	NPCN000
Padda sp	NPCN000
Padda spp	NPCN000
Pan sp	NPCN000
Pan spp	NPCN000
Pan troglodytes	NPCN000
Papio anubis	NPCN000
Papio hamadryas	NPCN000
Papio sp	NPCN000
Papio spp	NPCN000
Paramecium sp	NPCN000
Paramecium spp	NPCN000
Paramecium tetraurelia	NPCN000
Passer domesticus	NPCN000
Passer hispaniolensis	NPCN000
Passer sp	NPCN000
Passer spp	NPCN000
Pasteurella multocida	NPCN000
Pasteurella sp	NPCN000
Pasteurella spp	NPCN000
Pasteurella tularensis	NPCN000
Paulinella chromatophora	NPCN000
Paulinella sp	NPCN000
Paulinella spp	NPCN000
Pediculus humanus	NPCN000
Pediculus sp	NPCN000
Pediculus spp	NPCN000
Pelecanus onocrotalus	NPCN000
Pelecanus sp	NPCN000
Pelecanus spp	NPCN000
Pelodiscus sinensis	NPCN000
Pelodiscus sp	NPCN000
Pelodiscus spp	NPCN000
Peponocephala electra	NPCN000
Peponocephala sp	NPCN000
Peponocephala spp	NPCN000
Perkinsela sp	NPCN000
Perkinsela spp	NPCN000
Perkinsus marinus	NPCN000
Perkinsus sp	NPCN000
Perkinsus spp	NPCN000
Petromyzon marinus	NPCN000
Petromyzon sp	NPCN000
Petromyzon spp	NPCN000
Phaeodactylum sp	NPCN000
Phaeodactylum spp	NPCN000
Phaeodactylum tricornutum	NPCN000
Phasianus colchicus	NPCN000
Phasianus sp	NPCN000
Phasianus spp	NPCN000
Phoca sp	NPCN000
Phoca spp	NPCN000
Phoca vitulina	NPCN000
Phocoena phocoena	NPCN000
Phocoena sinus	NPCN000
Phocoena spinipinnis	NPCN000
Phocoena sp	NPCN000
Phocoena spp	NPCN000
Phocoenoides dalli	NPCN000
Phocoenoides sp	NPCN000
Phocoenoides spp	NPCN000
Physcomitrella patens	NPCN000
Physcomitrella sp	NPCN000
Physcomitrella spp	NPCN000
Physeter macrocephalus	NPCN000
Physeter sp	NPCN000
Physeter spp	NPCN000
Physter macrocephalus	NPCN000
Physter sp	NPCN000
Physter spp	NPCN000
Phytomonas sp	NPCN000
Phytomonas spp	NPCN000
Phytophthora infestans	NPCN000
Phytophthora kernoviae	NPCN000
Phytophthora lateralis	NPCN000
Phytophthora nicotianae	NPCN000
Phytophthora parasitica	NPCN000
Phytophthora ramorum	NPCN000
Phytophthora sojae	NPCN000
Phytophthora sp	NPCN000
Phytophthora spp	NPCN000
Pinus pinaster	NPCN000
Pinus sylvestris	NPCN000
Pinus sp	NPCN000
Pinus spp	NPCN000
Pipistrellus maderensis	NPCN000
Pipistrellus sp	NPCN000
Pipistrellus spp	NPCN000
Pittosporum sp	NPCN000
Pittosporum spp	NPCN000
Pittosporum undulatum	NPCN000
Plasmodiophora brassicae	NPCN000
Plasmodiophora sp	NPCN000
Plasmodiophora spp	NPCN000
Plasmodium berghei	NPCN000
Plasmodium chabaudi	NPCN000
Plasmodium cynomolgi	NPCN000
Plasmodium falciparum	NPCN000
Plasmodium fragile	NPCN000
Plasmodium gaboni	NPCN000
Plasmodium inui	NPCN000
Plasmodium knowlesi	NPCN000
Plasmodium reichenowi	NPCN000
Plasmodium sp	NPCN000
Plasmodium spp	NPCN000
Plasmodium vinckei	NPCN000
Plasmodium vivax	NPCN000
Plasmodium yoelii	NPCN000
Plasmopara halstedii	NPCN000
Plasmopara sp	NPCN000
Plasmopara spp	NPCN000
Platanista gangetica	NPCN000
Platanista sp	NPCN000
Platanista spp	NPCN000
Plecotus auritus	NPCN000
Plecotus austriacus	NPCN000
Plecotus sp	NPCN000
Plecotus spp	NPCN000
Plectropterus gambensis	NPCN000
Plectropterus sp	NPCN000
Plectropterus spp	NPCN000
Ploceus cucullatus	NPCN000
Ploceus melanocephalus	NPCN000
Ploceus sp	NPCN000
Ploceus spp	NPCN000
Ploceus velatus	NPCN000
Poecilia formosanolis	NPCN000
Poecilia sp	NPCN000
Poecilia spp	NPCN000
Poicephalus senegalus	NPCN000
Poicephalus sp	NPCN000
Poicephalus spp	NPCN000
Polysphondylium pallidum	NPCN000
Polysphondylium sp	NPCN000
Polysphondylium spp	NPCN000
Pongo abelii	NPCN000
Pongo sp	NPCN000
Pongo spp	NPCN000
Pontoporia blainvillei	NPCN000
Pontoporia sp	NPCN000
Pontoporia spp	NPCN000
Populus sp	NPCN000
Populus spp	NPCN000
Populus trichocarpa	NPCN000
Porphyromonas gingivalis	NPCN000
Porphyromonas sp	NPCN000
Porphyromonas spp	NPCN000
Prevotella melaninogenica	NPCN000
Prevotella sp	NPCN000
Prevotella spp	NPCN000
Pristionchus pacificus	NPCN000
Pristionchus sp	NPCN000
Pristionchus spp	NPCN000
Procambarus clarkii	NPCN000
Procambarus sp	NPCN000
Procambarus spp	NPCN000
Procavia capensis	NPCN000
Procavia sp	NPCN000
Procavia spp	NPCN000
Prunus lusitanica	NPCN000
Prunus persica	NPCN000
Prunus sp	NPCN000
Prunus spp	NPCN000
Psammodromus algirus	NPCN000
Psammodromus sp	NPCN000
Psammodromus spp	NPCN000
Pseudocohnilembus persalinus	NPCN000
Pseudocohnilembus sp	NPCN000
Pseudocohnilembus spp	NPCN000
Pseudomonas aeruginosa	NPCN000
Pseudomonas sp	NPCN000
Pseudomonas spp	NPCN000
Pseudorca crassidens	NPCN000
Pseudorca sp	NPCN000
Pseudorca spp	NPCN000
Psittacula krameri	NPCN000
Psittacula sp	NPCN000
Psittacula spp	NPCN000
Psittacus erithacus	NPCN000
Psittacus sp	NPCN000
Psittacus spp	NPCN000
Pteropus sp	NPCN000
Pteropus spp	NPCN000
Pteropus vampyrus	NPCN000
Pusa hispida	NPCN000
Pusa sp	NPCN000
Pusa spp	NPCN000
Pythium aphanidermatum	NPCN000
Pythium arrhenomanes	NPCN000
Pythium irregulare	NPCN000
Pythium iwayamai	NPCN000
Pythium sp	NPCN000
Pythium spp	NPCN000
Pythium ultimum	NPCN000
Pythium vexans	NPCN000
Quelea quelea	NPCN000
Quelea sp	NPCN000
Quelea spp	NPCN000
Quercus coccifera	NPCN000
Quercus faginea	NPCN000
Quercus ilex	NPCN000
Quercus lusitanica	NPCN000
Quercus pyrenaica	NPCN000
Quercus robur	NPCN000
Quercus sp	NPCN000
Quercus spp	NPCN000
Quercus suber	NPCN000
Rattus norvegicus	NPCN000
Rattus rattus	NPCN000
Rattus sp	NPCN000
Rattus spp	NPCN000
Regulus madeirensis	NPCN000
Regulus sp	NPCN000
Regulus spp	NPCN000
Reticulomyxa filosalpingoeca	NPCN000
Reticulomyxa sp	NPCN000
Reticulomyxa spp	NPCN000
Reynoutria japonica	NPCN000
Reynoutria sp	NPCN000
Reynoutria spp	NPCN000
Rhinolophus euryale	NPCN000
Rhinolophus ferrumequinum	NPCN000
Rhinolophus hipposideros	NPCN000
Rhinolophus mehelyi	NPCN000
Rhinolophus sp	NPCN000
Rhinolophus spp	NPCN000
Rhizobium radiobacter	NPCN000
Rhizobium sp	NPCN000
Rhizobium spp	NPCN000
Rhodnius prolixusarcoptes	NPCN000
Rhodnius sp	NPCN000
Rhodnius spp	NPCN000
Ricinus communis	NPCN000
Ricinus sp	NPCN000
Ricinus spp	NPCN000
Rickettsia prowazekii	NPCN000
Rickettsia psittaci	NPCN000
Rickettsia quintana	NPCN000
Rickettsia rickettsii	NPCN000
Rickettsia sp	NPCN000
Rickettsia spp	NPCN000
Rickettsia trachomae	NPCN000
Robinia pseudoacacia	NPCN000
Robinia sp	NPCN000
Robinia spp	NPCN000
Rochalimaea henselae	NPCN000
Rochalimaea quintana	NPCN000
Rochalimaea sp	NPCN000
Rochalimaea spp	NPCN000
Rothia dentocariosa	NPCN000
Rothia sp	NPCN000
Rothia spp	NPCN000
Saccharomyces cerevisiae	NPCN000
Saccharomyces sp	NPCN000
Saccharomyces spp	NPCN000
Salix atrocinerea	NPCN000
Salix sp	NPCN000
Salix spp	NPCN000
Salmo salar	NPCN000
Salmo sp	NPCN000
Salmo spp	NPCN000
Salmonella enteritidis	NPCN000
Salmonella sp	NPCN000
Salmonella spp	NPCN000
Salmonella typhimurium	NPCN000
Salmonella typhi	NPCN000
Salvinia molesta	NPCN000
Salvinia sp	NPCN000
Salvinia spp	NPCN000
Saprolegnia diclina	NPCN000
Saprolegnia parasitica	NPCN000
Saprolegnia sp	NPCN000
Saprolegnia spp	NPCN000
Sarcophilus harrisii	NPCN000
Sarcophilus sp	NPCN000
Sarcophilus spp	NPCN000
Schistosoma mansoni	NPCN000
Schistosoma sp	NPCN000
Schistosoma spp	NPCN000
Sciurus sp	NPCN000
Sciurus spp	NPCN000
Sciurus vulgaris	NPCN000
Selaginella moellendorffii	NPCN000
Selaginella sp	NPCN000
Selaginella spp	NPCN000
Senecio bicolor	NPCN000
Senecio sp	NPCN000
Senecio spp	NPCN000
Serinus canaria	NPCN000
Serinus serinus	NPCN000
Serinus sp	NPCN000
Serinus spp	NPCN000
Serratia marcescens	NPCN000
Serratia sp	NPCN000
Serratia spp	NPCN000
Sesbania punicea	NPCN000
Sesbania sp	NPCN000
Sesbania spp	NPCN000
Setaria italica	NPCN000
Setaria sp	NPCN000
Setaria spp	NPCN000
Shigella dysenteriae	NPCN000
Shigella sp	NPCN000
Shigella spp	NPCN000
Solanum lycopersicum	NPCN000
Solanum sp	NPCN000
Solanum spp	NPCN000
Solanum tuberosum	NPCN000
Solenopsis invicta	NPCN000
Solenopsis sp	NPCN000
Solenopsis spp	NPCN000
Sorex granarius	NPCN000
Sorex minutus	NPCN000
Sorex sp	NPCN000
Sorex spp	NPCN000
Sorghum bicolor	NPCN000
Sorghum sp	NPCN000
Sorghum spp	NPCN000
Sotalia fluviatilis	NPCN000
Sotalia guianensis	NPCN000
Sotalia sp	NPCN000
Sotalia spp	NPCN000
Sousa chinensis	NPCN000
Sousa chinensistenella	NPCN000
Sousa plumbea	NPCN000
Sousa sp	NPCN000
Sousa spp	NPCN000
Sousa teuszi	NPCN000
Spartina densiflora	NPCN000
Spartina sp	NPCN000
Spartina spp	NPCN000
Sphaeroforma arctica	NPCN000
Sphaeroforma sp	NPCN000
Sphaeroforma spp	NPCN000
Spironucleus salmonicida	NPCN000
Spironucleus sp	NPCN000
Spironucleus spp	NPCN000
Staphylococcus aureus	NPCN000
Staphylococcus epidermidis	NPCN000
Staphylococcus sp	NPCN000
Staphylococcus spp	NPCN000
Stegodyphus mimosarum	NPCN000
Stegodyphus sp	NPCN000
Stegodyphus spp	NPCN000
Stenella coeruleoalba	NPCN000
Stenella frontalis	NPCN000
Stenella sp	NPCN000
Stenella spp	NPCN000
Steno bredanensis	NPCN000
Steno bredanensistenella	NPCN000
Steno sp	NPCN000
Steno spp	NPCN000
Stenotrophomonas maltophilia	NPCN000
Stenotrophomonas sp	NPCN000
Stenotrophomonas spp	NPCN000
Streptococcus agalactiae	NPCN000
Streptococcus avium	NPCN000
Streptococcus bovis	NPCN000
Streptococcus cricetus	NPCN000
Streptococcus faceium	NPCN000
Streptococcus faecalis	NPCN000
Streptococcus ferus	NPCN000
Streptococcus gallinarum	NPCN000
Streptococcus lactis	NPCN000
Streptococcus mitior	NPCN000
Streptococcus mitis	NPCN000
Streptococcus mutans	NPCN000
Streptococcus oralis	NPCN000
Streptococcus pneumoniae	NPCN000
Streptococcus pyogenes	NPCN000
Streptococcus rattus	NPCN000
Streptococcus salivarius	NPCN000
Streptococcus sanguis	NPCN000
Streptococcus sobrinus	NPCN000
Streptococcus sp	NPCN000
Streptococcus spp	NPCN000
Streptopelia roseogrisea	NPCN000
Streptopelia senegalensis	NPCN000
Streptopelia sp	NPCN000
Streptopelia spp	NPCN000
Strigamia maritima	NPCN000
Strigamia sp	NPCN000
Strigamia spp	NPCN000
Strigomonas culicistylonychia	NPCN000
Strigomonas sp	NPCN000
Strigomonas spp	NPCN000
Strongylocentrotus purpuratustrongyloides	NPCN000
Strongylocentrotus sp	NPCN000
Strongylocentrotus spp	NPCN000
Sturnus sp	NPCN000
Sturnus spp	NPCN000
Sturnus unicolor	NPCN000
Sturnus vulgaris	NPCN000
Suncus etruscus	NPCN000
Suncus sp	NPCN000
Suncus spp	NPCN000
Sus scrofa	NPCN000
Sus sp	NPCN000
Sus spp	NPCN000
Sylvia atricapilla	NPCN000
Sylvia sp	NPCN000
Sylvia spp	NPCN000
Tadarida sp	NPCN000
Tadarida spp	NPCN000
Tadarida teniotis	NPCN000
Taeniopygia guttata	NPCN000
Taeniopygia sp	NPCN000
Taeniopygia spp	NPCN000
Takifugu rubripes	NPCN000
Takifugu sp	NPCN000
Takifugu spp	NPCN000
Talpa occidentalis	NPCN000
Talpa sp	NPCN000
Talpa spp	NPCN000
Tarsius sp	NPCN000
Tarsius spp	NPCN000
Tarsius syrichta	NPCN000
Tasmacetus shepherdi	NPCN000
Tasmacetus sp	NPCN000
Tasmacetus spp	NPCN000
Taxus baccata	NPCN000
Taxus sp	NPCN000
Taxus spp	NPCN000
Tetrahymena sp	NPCN000
Tetrahymena spp	NPCN000
Tetrahymena thermophila	NPCN000
Tetranychus sp	NPCN000
Tetranychus spp	NPCN000
Tetranychus urticae	NPCN000
Tetraodon nigroviridis	NPCN000
Tetraodon sp	NPCN000
Tetraodon spp	NPCN000
Thalassiosira oceanica	NPCN000
Thalassiosira pseudonana	NPCN000
Thalassiosira sp	NPCN000
Thalassiosira spp	NPCN000
Thecamonas sp	NPCN000
Thecamonas spp	NPCN000
Thecamonas trahens	NPCN000
Theileria annulata	NPCN000
Theileria equi	NPCN000
Theileria orientalis	NPCN000
Theileria parva	NPCN000
Theileria sp	NPCN000
Theileria spp	NPCN000
Thelohanellus kitauei	NPCN000
Thelohanellus sp	NPCN000
Thelohanellus spp	NPCN000
Theobroma cacao	NPCN000
Theobroma sp	NPCN000
Theobroma spp	NPCN000
Threskiornis aethiopicus	NPCN000
Threskiornis sp	NPCN000
Threskiornis spp	NPCN000
Toxoplasma gondii	NPCN000
Toxoplasma sp	NPCN000
Toxoplasma spp	NPCN000
Tradescantia fluminensis	NPCN000
Tradescantia sp	NPCN000
Tradescantia spp	NPCN000
Treponema denticola	NPCN000
Treponema pallidum	NPCN000
Treponema sp	NPCN000
Treponema spp	NPCN000
Tribolium castaneum	NPCN000
Tribolium sp	NPCN000
Tribolium spp	NPCN000
Trichinella spiralis	NPCN000
Trichinella sp	NPCN000
Trichinella spp	NPCN000
Trichomonas sp	NPCN000
Trichomonas spp	NPCN000
Trichomonas vaginalis	NPCN000
Trichoplax adhaerens	NPCN000
Trichoplax sp	NPCN000
Trichoplax spp	NPCN000
Trifolium pratense	NPCN000
Trifolium sp	NPCN000
Trifolium spp	NPCN000
Triticum aestivum	NPCN000
Triticum sp	NPCN000
Triticum spp	NPCN000
Triticum urartu	NPCN000
Trypanosoma brucei	NPCN000
Trypanosoma cruzi	NPCN000
Trypanosoma rangeli	NPCN000
Trypanosoma sp	NPCN000
Trypanosoma spp	NPCN000
Tupaia belangeri	NPCN000
Tupaia sp	NPCN000
Tupaia spp	NPCN000
Turdus merula	NPCN000
Turdus sp	NPCN000
Turdus spp	NPCN000
Tursiops aduncus	NPCN000
Tursiops australis	NPCN000
Tursiops sp	NPCN000
Tursiops spp	NPCN000
Tursiops truncatus	NPCN000
Uraeginthus bengalus	NPCN000
Uraeginthus sp	NPCN000
Uraeginthus spp	NPCN000
Ursus arctos	NPCN000
Ursus maritimus	NPCN000
Ursus sp	NPCN000
Ursus spp	NPCN000
Vespa velutina	NPCN000
Vespa sp	NPCN000
Vespa spp	NPCN000
Vibrio cholerae	NPCN000
Vibrio comma	NPCN000
Vibrio parahaemolyticus	NPCN000
Vibrio sp	NPCN000
Vibrio spp	NPCN000
Vibrio vulnificus	NPCN000
Vicugna pacos	NPCN000
Vicugna sp	NPCN000
Vicugna spp	NPCN000
Vidua fischeri	NPCN000
Vidua macroura	NPCN000
Vidua sp	NPCN000
Vidua spp	NPCN000
Vitis sp	NPCN000
Vitis spp	NPCN000
Vitis vinifera	NPCN000
Vitrella brassicaformis	NPCN000
Vitrella sp	NPCN000
Vitrella spp	NPCN000
Vulpes sp	NPCN000
Vulpes spp	NPCN000
Vulpes vulpes	NPCN000
Xenopus laevis	NPCN000
Xenopus sp	NPCN000
Xenopus spp	NPCN000
Xenopus tropicalis	NPCN000
Xiphophorus maculatus	NPCN000
Xiphophorus sp	NPCN000
Xiphophorus spp	NPCN000
Yersinia enterocolitica	NPCN000
Yersinia pestis	NPCN000
Yersinia pseudotuberculosis	NPCN000
Yersinia sp	NPCN000
Yersinia spp	NPCN000
Zalerion maritimum	NPCN000
Zalerion sp	NPCN000
Zalerion spp	NPCN000
Zea mays	NPCN000
Zea sp	NPCN000
Zea spp	NPCN000
Ziphius cavirostris	NPCN000
Ziphius sp	NPCN000
Ziphius spp	NPCN000
Zootermopsis nevadensis	NPCN000
Zootermopsis sp	NPCN000
Zootermopsis spp	NPCN000
