agusto=a gusto
cocreta=concreta|croqueta
cocretas=concretas|croquetas
vermouth=vermut|vermú
vermouths=vermuts|vermús
tambien=también|cambien
shampoo=champú
aver=a ver|haber|ver|aves|saber
alante=adelante
ostentóreo=estentóreo|ostentoso
ostentóreos=estentóreos|ostentosos
ostentórea=estentórea|ostentosa
ostentóreas=estentóreas|ostentosas
osea=o sea|ósea|posea|óseas
doberman|dóbermans|dóbermen|dobermen=dóberman
mecenaje=mecenazgo
micromecenaje=micromecenazgo
atraves=a través
fosfina=fosfano
ESTAN=ESTÁN
pej=p. ej.|pez
poliomelitis=poliomielitis
hos=os|los|dos|hoy|nos
degolla=degüella
degollas=degüellas
degollan=degüellan
degollo=degüello|degolló
degolle=degüelle
degolles=degüelles
degollen=degüellen
sanitización|desinfectación=desinfección
sanitizaciones|desinfectaciones=desinfecciones
estructuralización|estructurización=estructuración
estructuralizaciones|estructurizaciones=estructuraciones
sanitizante=desinfectante
sanitizantes=desinfectantes
mui=muy
preveyó=previó|proveyó
preveyeron=previeron|proveyeron
preveyendo=previendo|proveyendo
freaky=friki
freakies|freakys=frikis
andó=anduvo
andé=anduve
andaste=anduviste
#andamos=anduvimos #can be present/past
andasteis=anduvisteis
andaron=anduvieron
logeo|logueo=inicio de sesión
CO2=CO₂
H2O=H₂O
sinocentrismo=chinocentrismo
catárquico=catártico
catárquicos=catárticos
catárquica=catártica
catárquicas=catárticas
rugerizado|rugerizada|rugerizados|rugerizadas=todoterreno|a prueba de golpes|resistente al agua
infectación=infección|infestación
infectaciones=infecciones|infestaciones
jerifalte=gerifalte
jerifaltes=gerifaltes
Yedda|Jeddah|Jeda=Yeda
provinente|proviniente=proveniente
provinentes|provinientes=provenientes
RRHH=RR. HH.
masterclass=master class
imperecero=imperecedero
impereceros=imperecederos
imperecera=imperecedera
impereceras=imperecederas
almenos=al menos|almenas|a menos
antibacterial=antibacteriano|antibacteriana
antibacteriales=antibacterianos|antibacterianas
sanitizante=desinfectante
whatsapp=WhatsApp|wasap
yoghourt|yogourt|yoghurt|yogurt=yogur
yoghourts|yogourts|yoghurts|yogurts=yogures
similaridad=similitud
similaridades=similitudes
autoregulación=autorregulación
autoregulaciones=autorregulaciones
alenta=alienta
alentas=alientas
alentan=alientan
alente=aliente
alentes=alientes
alenten=alienten
alento=aliento|alentó
aiga|haiga=haya
aigas|haigas=hayas
aigan|haigan=hayan
area=área
areas=áreas
zoom=zum|Zoom
zairense=zaireño|zaireña
zairenses=zaireños|zaireñas
boicó|boycott=boicot|boicoteo
boicós|boycotts=boicots|boicoteos
click=clic
clicks=clics
#################################################
# Errors in the dictionary 
# (can be removed after updating the dictionary)
#################################################
