aconteixement=esdeveniment
aconteixements=esdeveniments
admón=adm
alemà=alemany
aleman=alemany
antes=abans
assunto=assumpte
averiguar=esbrinar|escatir|investigar|indagar|inquirir
botellón=festa alcohòlica
botellones=festes alcohòliques
brillantesa=brillantor
bueno=bé
cansanci=cansament
cansancis=cansaments
carent=mancat|mancada|freturós|freturosa
carents=mancats|mancades|freturosos|freturoses
carinyo=estimat|estimada|rei|reina|amor|amor meu|vida|afecte|estima|estimació|afecció
chanchullo=tripijoc|martingala
chanchullos=tripijocs|martingales
desprovist=desproveït
desprovista=desproveïda
desprovistes=desproveïdes
desprovistos=desproveïts
desprovists=desproveïts
después=després
dña=sra
doña=senyora
enfermetat=malaltia
enfermetats=malalties
entonses=aleshores|llavors
garantitzar=garantir
gelos=gelosia
hasta=fins|fins a
huelga=vaga
jefe=cap|capitost|director|capdavanter
jefes=caps|capitosts|directors|capdavanters
jeque=xeic
jeques=xeics
làmpara=llum|llàntia|làmpada
làmpares=llums|llànties|làmpades
línea=línia
línees=línies
mantequilla=mantega
máx=màx
migeval=medieval
migevals=medievals
mitgeval=medieval
mitgevals=medievals
octavilla=full volant
octavilles=fulls volants
parxe=pegat
parxes=pegats
pasmós=esbalaïdor
pasmosa=esbalaïdora
pasmoses=esbalaïdores
pasmosos=esbalaïdors
provist=proveït
provista=proveïda
provistes=proveïdes
provistos=proveïts
provists=proveïts
reaci=refractari|reticent|renitent
reàcia=refractària|reticent|renitent
reàcies=refractàries|reticents|renitents
reacis=refractaris|reticents|renitents
reapertura=reobertura
recado=encàrrec|comanda|avís
recados=encàrrecs|comandes|avisos
reflexar=reflectir
sello=segell
sellos=segells
sombra=ombra
tamany=mida|grandària|format
tamanys=mides|grandàries|formats
toldo=vela|tendal|para-sol
toldos=veles|tendals|para-sols
tonta=ximple|beneita|bajana|babaua|tanoca|nècia|totxa|pallussa
tontada=beneiteria|ximpleria|bajanada|fotesa|beneitura|poca-soltada|niciesa|totxeria|bagatel·la|ximplesa|bajaneria|neciesa|ximplesa
tontades=beneiteries|ximpleries|bajanades|foteses|beneitures|poca-soltades|nicieses|totxeries|bagatel·les|ximpleses|bajaneries|necieses|ximpleses
tonteria=beneiteria|ximpleria|bajanada|fotesa|beneitura|poca-soltada|niciesa|totxeria|bagatel·la|ximplesa|bajaneria|neciesa|ximplesa
tonteries=beneiteries|ximpleries|bajanades|foteses|beneitures|poca-soltades|nicieses|totxeries|bagatel·les|ximpleses|bajaneries|necieses|ximpleses
tontes=ximples|beneites|bajanes|babaues|tanoques|nècies|totxes|pallusses
tonto=ximple|beneit|bajà|babau|tanoca|neci|totxo|pallús
tontos=ximples|beneits|bajans|babaus|tanoques|necis|totxos|pallussos
urbano=urbà
vastedat=vastitud
xanxullo=tripijoc|martingala
xanxullos=tripijocs|martingales
xarco=toll|bassal
xarcos=tolls|bassals