# adaptacions
gay=gai
gays=gais
troll=trol
trolls=trols
squash=esquaix
smoking=esmòquing
smokings=esmòquings
drone=dron
drones=dons
ticket=tiquet
tickets=tiquets
meme=mem
memes=mems
# anglicismes innecesaris
grooming=ciberassetjament pedòfil
deadline=data límit|termini
foodie|foody=cuinòfil|cuinòfila|menjaretes
foodies=cuinòfils|cuinòfiles|menjaretes
screenshot=captura de pantalla
screenshots=captures de pantalla
loser=perdedor|perdedora
losers=perdedors|perdedores
webinar=seminari web|seminari en línia
webinars=seminaris web|seminaris en línia
customizable|customitzable=personalitzable
customizables|customitzables=personalitzables
compliance=compliment|compliment normatiu
protoboard=placa de proves
hyperlink|hiperlink|hipervincle|link=enllaç
hyperlinks|hiperlinks|hipervincles|links=enllaços
play=joc|jugada|reproducció
booktrailer|booktràiler=bibliotràiler|tràiler de llibre
booktrailers|booktràilers=bibliotràilers|tràilers de llibres
track=pista|circuit|camí|carrer|itinerari|empremta
tracks=pistes|circuits|camins|carrers|itineraris|empremtes
tracking=seguiment|traçabilitat|interlletratge|caça al rastre
blockchain=cadena de blocs
crowdfunding=finançament col·lectiu
influencer|influèncer=influenciador|influenciadora
influencers|influèncers=influenciadors|influenciadores
fixing=fixació
gay-friendly=amic dels gais|amiga dels gais|amics dels gais|amigues dels gais
classroom=aula|classe|aula virtual|aula digital|aula en línia
classrooms=aules|classes|aules virtuals|aules digitals|aules en línia
bullying=assetjament escolar|assetjament
cyberbullying=ciberassetjament
know-how=saber fer
hockey=hoquei
lockout=locaut|tancament patronal
lockdown=tancament|confinament
leaker=filtrador|filtradora
leakers=filtradors|filtradores
merchandising=marxandatge
microarray=bioxip|matriu
microarrays=bioxips|matrius
online=en línia|digital|electrònic|connectat|en internet|per internet
pendrive=llapis de memòria|memòria USB
pendrives=llapis de memòria|memòries USB
permafrost=permagel
power=poder|energia
prosumerisme|prosumerism=consum proactiu
sell-off=venda massiva
smartphone=telèfon intel·ligent
smartphones=telèfons intel·ligents
snorkel=respirador de superfície|tub respirador
snorkels=respiradors de superfície|tubs respiradors
spin-offs|spinoffs=empreses derivades
spin-off|spinoff=empresa derivada
stakeholder=part interessada
stakeholders=parts interessades
startups|start-ups|start ups=empreses emergents
startup|start-up|start up=empresa emergent
storyboard=guió il·lustrat
target=blanc|diana|objectiu|públic objectiu|grup objectiu
website=lloc web
webpage=pàgina web
windsurf|windsurfing=surf de vela|planxa de vela
whistleblower=alertador|alertadora|denunciant
whistleblowers=alertadors|alertadores|denunciants
gamer=jugador|videojugador
gamers=jugadors|videojugadors
reset=inicialització
clickbait=pescaclics
healthy=saludable|sa
coffee break=descans|descans per a prendre cafè
delivery=lliurament|lliurament a domicili|repartiment|repartidor
prime time|prime-time=horari de màxima audiència|hora punta
workshop=taller|aula taller|jornada|seminari|sessió de treball
workshops=tallers|aules taller|jornades|seminaris|sessions de treball
timeline|time line|time-line=cronologia|línia de temps|línia cronològica
win-win=de guanyar-guanyar|guanyar-guanyar
win-lose=de guanyar-perdre|guanyar-perdre
lose-lose=de perdre-perdre|perdre-perdre
snorkeling=immersió lleugera
round=ronda|assalt
match point=punt de partit
private equity=capital d'inversió
insider=intern|privilegiat|membre
outsider=independent|alternatiu|marginal|sorpresa|extern|intrús|foraster|forà
insiders=interns|privilegiats|membres
outsiders=independents|alternatius|marginals|sorpresa|externs|intrusos|forasters|forans
recordman|recordwoman=plusmarquista|recordista
recordmen|recordwomen=plusmarquistes|recordistes
aspiracional=amb aspiracions|ambiciós|ideal
aspiracionals=amb aspiracions|ambiciosos|ideals
login|logon=inici de sessió
logins|logons=inicis de sessió
en streaming|per streaming=en continu|en línia|en temps real
streaming=reproducció en continu|reproducció en línia|vídeo en temps real|difusió en continu
cloud computing=informàtica en el núvol|computació en el núvol
deep web=internet profund|web profund
factoring=facturatge
leasing=lísing|arrendament financer
loop=bucle|circuit
loops=bucles|circuits
mindfulness=atenció plena|consciència plena
brand manager=director de marca|gestor de marca|directora de marca|gestora de marca
brand managers=directors de marca|gestors de marca|directores de marca|gestores de marca
trick or treat=paga o plora|crit o confit|broma o regal|llaminadura o entremaliadura
open source|open source code|open-source|open-source code=codi obert|codi font obert
millennial=mil·lennista
millennials=mil·lennistes
snorkelling=immersió lleugera
snorkel=respirador de superfície|tub respirador
router=encaminador
routers=encaminadors
stakeholder=part interessada|interessat|afectat
stakeholders=parts interessades|interessats|afectats|grup d'interès|públic d'interès
Thanksgiving Day=Dia d'Acció de Gràcies
Thanksgiving=Acció de Gràcies
fair play|fair-play=joc net|esportivitat|joc noble
big data=dades massives
coach=guia|orientador|assessor|mentor|entrenador
coaches=guies|orientadors|assessors|mentors|entrenadors
dashboard=quadre de control|davantal
e-sport=esport electrònic
e-sports=esports electrònics
fake news=notícies enganyoses|notícies falses|notícia enganyosa|notícia falsa
celebrity|celeb=famós|famosa|celebritat
celebrities|celebs=famosos|famoses|celebritats
fast food|fast-food=menjar ràpid
networking=gestió de xarxes|treball en xarxa|entrevista
newsletter=butlletí|butlletí d'informació|revista d'empresa
newsletters=butlletins|butlletins d'informació|revistes d'empresa
smart cities=ciutats intel·ligents
smart city=ciutat intel·ligent
playlist=llista de reproducció
playlists=llistes de reproducció
sold out|sold-out|soldout=esgotat
sold outs|sold-outs|soldouts=esgotats
retail=al detall|a la menuda|a particulars
guilty pleasure=plaer culpable|plaer inconfessable
guilty pleasures=plaers culpables|plaers inconfessables
outfit=conjunt|combinació|modelet
automatic learning=aprenentatge automàtic
deep learning=aprenentatge profund
machine learning=aprenentatge automàtic
display=visualitzador|visualització|expositor|pantalla
displays=visualitzadors|visualitzacions|expositors|pantalles
trending topic|trending-topic=tema del moment|tema destacat|tema de moda|tendència
trending topics|trending-topics=temes del moment|temes destacats|temes de moda|tendències
brainstorming=pluja d'idees
smartwatch=rellotge intel·ligent
smartwatches=rellotges intel·ligents
impeachment=procés de destitució
Yangon|Rangoon=Rangun
briefing=sessió informativa|reunió informativa|report|brífing
briefings=sessions informatives|reunions informatives|reports|brífings
hosting=allotjament
hostings=allotjaments
share=quota|quota de pantalla|índex d'audiència
market share=quota de mercat
skate=patí
switch=commutador|interruptor
pack=lot|paquet
like|likes=m'agrada
on demand|on-demand|sota comanda=segons demanda|per encàrrec|a la carta
true crime|true-crime=basat en crims reals|sobre crims reals
mockumentary=fals documental
mockumentaries=falsos documentals
quiz=joc de preguntes i respostes|concurs|prova|test
bail out|bail-out|bailout=rescat|rescat financer
fact checking|fact-checking|fact-check|fact check=verificació|verificació d'informació|verificació de dades
fintech|FinTech=tecnologies financeres|tecnofinances
commodities=matèries primeres|productes bàsics
commodity=matèria primera|producte bàsic
hater=odiador|seguidor hostil|enemic
haters=odiadors|seguidors hostils|enemics