# A part-of-speech dictionary that's used additionally to the binary dictionary (*.dict).
# This does not add words to the spell checker, see hunspell/spelling.txt for that.
# File Encoding: UTF-8
# Format: three tab-separated fields: fullform baseform postags
# Need replace to dict
ёмкостной	ёмкостный	ADJ:Posit:Masc:Nom
кпсс	кпсс	ABR:Fem
он	он	PNN:Masc:Nom:P3
она	она	PNN:Fem:Nom:P3
оно	оно	PNN:Neut:Nom:P3
ао	ао	ABR:Fem
аозт	аозт	ABR:Neut	
аоот	аоот	ABR:Neut	
аэс	аэс	ABR:Fem
бд	бд	ABR:Fem
бнр	бнр	ABR:Fem
взу	взу	ABR:Neut	
внр	внр	ABR:Fem
вовд	вовд	ABR:Neut	
втэк	втэк	ABR:Fem
га	га	ABR:Мasc	
гаэс	гаэс	ABR:Fem
гдр	гдр	ABR:Fem
грэс	грэс	ABR:Fem
гувд	гувд	ABR:Neut	
гэс	гэс	ABR:Fem
еэс	еэс	ABR:Fem
еэс	еэс	ABR:Neut
зао	зао	ABR:Neut	
ичп	ичп	ABR:Neut	
кб	кб	ABR:Мasc	
кнр	кнр	ABR:Fem
мвс	мвс	ABR:Neut	
мвф	мвф	ABR:Neut	
мвэс	мвэс	ABR:Neut	
мгб	мгб	ABR:Neut	
мгту	мгту	ABR:Masc	
ми	ми	ABR:Neut	
мкс	мкс	ABR:Fem	
ммм	ммм	ABR:Neut	
мо	мо	ABR:Neut	
мпс	мпс	ABR:Neut	
мчс	мчс	ABR:Neut	
нпо	нпо	ABR:Neut	
нпп	нпп	ABR:Neut	
нтв	нтв	ABR:Neut	
оао	оао	ABR:Neut	
обл	обл	ABR:Fem
озу	озу	ABR:Fem
озу	озу	ABR:Neut	
окб	окб	ABR:Neut	
оон	оон	ABR:Fem
ооо	ооо	ABR:Neut	
ос	ос	ABR:Fem
пзу	пзу	ABR:Neut	
пнр	пнр	ABR:Fem
пту	пту	ABR:Neut	
пэвм	пэвм	ABR:Fem
рао	рао	ABR:Neut	
риа	риа	ABR:Neut	
рка	рка	ABR:Fem	
ровд	ровд	ABR:Neut	
рожд	рожд	ABR:Neut	
рпц	рпц	ABR:Fem
ртр	ртр	ABR:Neut	
рувд	рувд	ABR:Neut	
свч	свч	ABR:Fem
си	си	ABR:Fem	
скб	скб	ABR:Neut	
снпо	снпо	ABR:Neut	
сп	сп	ABR:Neut	
спту	спту	ABR:Neut	
срр	срр	ABR:Fem
субд	субд	ABR:Fem
су	су	ABR:Neut	
тв	тв	ABR:Neut	
тоо	тоо	ABR:Neut	
тчк	тчк	ABR:Fem
тэс	тэс	ABR:Fem
тэц	тэц	ABR:Fem
увд	увд	ABR:Neut	
фбр	фбр	ABR:Neut
фбр	фбр	ABR:Neut	
фио	фио	ABR:Neut	
фнс	фнс	ABR:Fem
фрг	фрг	ABR:Fem
фрс	фрс	ABR:Neut	
фск	фск	ABR:Fem
фс	фс	ABR:Fem	
фэп	фэп	ABR:Fem
цб	цб	ABR:Neut	
цик	цик	ABR:Fem
цру	цру	ABR:Neut
цру	цру	ABR:Neut	
цт	цт	ABR:Neut	
чп	чп	ABR:Neut
чсср	чсср	ABR:Fem
эвм	эвм	ABR:Fem
юар	юар	ABR:Fem
# Need add to dict with extended postag like PNN:Inanim:V, PNN:Inanim:R, PNN:Inanim:D, PNN:Inanim:T, PNN:Inanim:P (TODO) 
себя	себя	PNN
себе	себе	PNN
собою	собою	PNN
собой	собою	PNN
# Need add to dict
атами	aтами	NN:Inanim
беспроводной	беспроводный	ADJ:Posit:Masc:Nom
вцик	вцик	ABR:Fem
гас	гас	ABR:Fem
исследоваться	исследоваться	VB:INF:
кипиа	кипиа	ABR:Masc
преобразующая	преобразующий	ADJ:Posit:Fem:Nom
преобразующего	преобразующий	ADJ:Posit:Masc:R
преобразующего	преобразующий	ADJ:Posit:Masc:V
преобразующего	преобразующий	ADJ:Posit:Neut:R
преобразующее	преобразующий	ADJ:Posit:Neut:Nom
преобразующее	преобразующий	ADJ:Posit:Neut:V
преобразующей	преобразующий	ADJ:Posit:Fem:D
преобразующей	преобразующий	ADJ:Posit:Fem:P
преобразующей	преобразующий	ADJ:Posit:Fem:R
преобразующей	преобразующий	ADJ:Posit:Fem:T
преобразующем	преобразующий	ADJ:Posit:Masc:P
преобразующем	преобразующий	ADJ:Posit:Neut:P
преобразующему	преобразующий	ADJ:Posit:Masc:D
преобразующему	преобразующий	ADJ:Posit:Neut:D
преобразующею	преобразующий	ADJ:Posit:Fem:T
преобразующие	преобразующий	ADJ:Posit:PL:Nom
преобразующие	преобразующий	ADJ:Posit:PL:V
преобразующий	преобразующий	ADJ:Posit:Masc:Nom
преобразующий	преобразующий	ADJ:Posit:Masc:V
преобразующими	преобразующий	ADJ:Posit:PL:T
преобразующим	преобразующий	ADJ:Posit:Masc:T
преобразующим	преобразующий	ADJ:Posit:Neut:T
преобразующим	преобразующий	ADJ:Posit:PL:D
преобразующих	преобразующий	ADJ:Posit:PL:P
преобразующих	преобразующий	ADJ:Posit:PL:R
преобразующих	преобразующий	ADJ:Posit:PL:V
преобразующую	преобразующий	ADJ:Posit:Fem:V
снк	снк	ABR:Masc
татами	татами	NN:Inanim
трём	три	Num
цар	цар	ABR:Fem
# migrated from disambiguation.xml, need improve. This words are already has tag in dictionary, but it need additional tags.
аввы	аввы	NN:Inanim	
авеню	авеню	NN:Inanim
автономов	автономов	NN:Inanim
автономы	автономы	NN:Inanim
айс	айс	NN:Inanim
анхом	анх	NN:Inanim
ариан	ариан	NN:Inanim
арианами	арианами	NN:Inanim
ариев	ариев	NN:Anim
арсин	арсин	NN:Inanim
арт	арт	NN:Inanim
архимедов	архимедов	NN:Inanim
ат	ат	NN:Inanim
аурелия	аурелия	NN:Inanim
бен	бен	NN:Inanim	
валин	валин	NN:Inanim
валина	валина	NN:Inanim
гея	гея	NN:Inanim
геям	геям	NN:Inanim
геи	геи	NN:Inanim
геями	геями	NN:Inanim
данов	данов	NN:Inanim
деи	деи	NN:Inanim
ден	ден	NN:Inanim
диско	диско	NN:Inanim
зарин	зарин	NN:Inanim
зоманом	зоманом	NN:Inanim
иваси	иваси	NN:Inanim
иже	иже	NN:Inanim
калиф	калиф	NN:Anim
калифа	калифа	NN:Anim
каратэ	каратэ	NN:Inanim
кларисс	кларисс	NN:Inanim
коста	коста	NN:Inanim
косты	косты	NN:Inanim
лобби	лобби	NN:Inanim
медиа	медиа	NN:Inanim
мисс	мисс	NN:Anim
миссис	миссис	NN:Anim
нереид	нереид	NN:Inanim
оглы	оглы	NN:Anim
роксаланами	роксаланами	NN:Anim
роксоланы	роксоланы	NN:Anim
роялти	роялти	NN:Inanim
сарин	сарин	NN:Inanim
сити	сити	NN:Inanim
спагетти	спагетти	NN:Inanim
суперЭВМ	суперЭВМ	NN:Inanim
троян	троян	NN:Inanim
троянами	троянами	NN:Inanim
фастам	фастам	NN:Inanim
фасты	фасты	NN:Inanim
франц	франц	NN:Anim
фрау	фрау	NN:Anim
эдипов	эдипов	NN:Inanim
януарий	януарий	NN:Inanim
# fast fix
пламень	пламень	NN:Inanim:Masc:Sin:Nom
пламень	пламень	NN:Inanim:Masc:Sin:V
проц	проц	NN:Inanim:Masc:Sin:Nom
проца	проц	NN:Inanim:Masc:Sin:R
процу	проц	NN:Inanim:Masc:Sin:D
проц	проц	NN:Inanim:Masc:Sin:V
процем	проц	NN:Inanim:Masc:Sin:T
проце	проц	NN:Inanim:Masc:Sin:P
процы	проц	NN:Inanim:Masc:PL:Nom
процев	проц	NN:Inanim:Masc:PL:R
процам	проц	NN:Inanim:Masc:PL:D
процы	проц	NN:Inanim:Masc:PL:V
процами	проц	NN:Inanim:Masc:PL:T
процах	проц	NN:Inanim:Masc:PL:P