#Russian multiwords file used for chunking
# FR  frazeologism
################
до мажор	NN:Masc
до минор	NN:Masc
###############
откуда ни возьмись	FR
пиши пропал	FR
пиши пропала	FR
пиши пропали	FR
пиши пропало	FR
считай пропал	FR
считай пропала	FR
считай пропали	FR
считай пропало	FR
###############
в дальнейшем	ADV
в диковинку	ADV
в заключение	ADV
в меру	ADV
в насмешку	ADV
в обнимку	ADV
в обтяжку	ADV
в обхват	ADV
в общем	ADV
в основном	ADV
в отместку	ADV
во что бы ни стало	ADV
Во что бы ни стало	ADV
во что бы то ни стало	ADV
Во что бы то ни стало	ADV
в рассрочку	ADV
в розницу	ADV
в складчину	ADV
в старину	ADV
в тиши	ADV
до востребования	ADV
до зарезу	ADV
до крайности	ADV
до неузнаваемости	ADV
до отвала	ADV
до отказа	ADV
до свидания	ADV
до упаду	ADV
как попало	ADV
Как попало	ADV
как следует	ADV
Как следует	ADV
на бегу	ADV
на боковую	ADV
на вес	ADV
на весу	ADV
на вид	ADV
на виду	ADV
на время	ADV
на выбор	ADV
на глаз	ADV
на грех	ADV
на диво	ADV
на днях	ADV
на дому	ADV
на дыбы	ADV
на зависть	ADV
на излёте	ADV
на измор	ADV
на износ	ADV
на исходе	ADV
на корточках	ADV
на корточки	ADV
на лад	ADV
на лету	ADV
на манер	ADV
на миг	ADV
на мировую	ADV
на отлично	ADV
на ощупь	ADV
на плаву	ADV
на поруки	ADV
на прицел	ADV
на редкость	ADV
на рысях	ADV
на скаку	ADV
на славу	ADV
на слуху	ADV
на совесть	ADV
на страже	ADV
на ура	ADV
на ходу	ADV
на цыпочках	ADV
на четвереньках	ADV
с ведома	ADV
с виду	ADV
с выгодой	ADV
с головой	ADV
с маху	ADV
с опережением	ADV
с опозданием	ADV
с разбегу	ADV
с размаху	ADV
с толку	ADV
того и гляди	ADV
Того и гляди	ADV
######################
# цельные выражения с деепричастием
######################
затаив дыхание	ADV
сложа руки	ADV
сломя голову	ADV
спустя рукава	ADV
