# Simple replace table
# Format: word=suggestion1|suggestion2|suggestion3...

# Прыслоўі
з большага=збольшага

# Частыя лексічныя памылкі
захіст=абарона
захіста=абароны
захісту=абароны|абароне
захістам=абаронай
захісце=абароне
захіснік=абаронца
захіснікі=абаронцы
захісніках=абаронцах
кампутар=камп’ютар
кампутара=камп’ютара
кампутару=камп’ютару
кампутарам=камп’ютарам
кампутары=камп’ютары
кампутараў=камп’ютараў
кампутарамі=камп’ютарамі
кампутарах=камп’ютарах
кампутарны=камп’ютарны
кампутарная=камп’ютарная
кампутарную=камп’ютарную
кампутарнае=камп’ютарнае
кампутарнага=камп’ютарнага
кампутарнаму=камп’ютарнаму
кампутарным=камп’ютарным
кампутарнай=камп’ютарнай
кампутарныя=камп’ютарныя
кампутарных=камп’ютарных
кампутарнымі=камп’ютарнымі
кампутэр=камп’ютар
кампутэра=камп’ютара
кампутэру=камп’ютару
кампутэрам=камп’ютарам
кампутэры=камп’ютары
кампутэраў=камп’ютараў
кампутэрамі=камп’ютарамі
кампутэрах=камп’ютарах
кампутэрны=камп’ютарны
кампутэрная=камп’ютарная
кампутэрную=камп’ютарную
кампутэрнае=камп’ютарнае
кампутэрнага=камп’ютарнага
кампутэрнаму=камп’ютарнаму
кампутэрным=камп’ютарным
кампутэрнай=камп’ютарнай
кампутэрныя=камп’ютарныя
кампутэрных=камп’ютарных
кампутэрнымі=камп’ютарнымі
накірунак=кірунак|напрамак
накірунку=кірунку|напрамку
накірункам=кірункам|напрамкам
накірункі=кірункі|напрамкі
накірункаў=кірункаў|напрамкаў
накірункамі=кірункамі|напрамкамі
накірунках=кірунках|напрамках
пацверджанне=пацвярджэнне
пацверджання=пацвярджэння
пацверджанню=пацвярджэнню
пацверджаннем=пацвярджэннем
пацверджанні=пацвярджэнні
пацверджанняў=пацвярджэнняў
пацверджанням=пацвярджэнням
пацверджаннямі=пацвярджэннямі
пацверджаннях=пацвярджэннях
паседжанне=пасяджэнне
паседжання=пасяджэння
паседжанню=пасяджэнню
паседжаннем=пасяджэннем
паседжанні=пасяджэнні
паседжанняў=пасяджэнняў
паседжанням=пасяджэнням
паседжаннямі=пасяджэннямі
паседжаннях=пасяджэннях
сыход=зыход|сход|адыход|выхад|выйсце
сыхода=зыходу|схода|адыходу|выхаду|выйсця
сыходу=зыходу|схода|сходу|адыходу|выхаду|выйсця|выйсцю
сыходам=зыходам|сходам|адыходам|выхадам|выйсцем
сыходзе=зыходзе|сходзе|адыходзе|выхадзе|выйсці
сыходы=зыходы|сходы|сходкі|адыходы|выхады|выйсці
сыходаў=зыходаў|сходаў|сходак|адыходаў|выхадаў|выйсцяў
сыходам=зыходам|сходам|сходкам|адыходам|выхадам|выйсцям
сыходамі=зыходамі|сходамі|сходкамі|адыходамі|выхадамі|выйсцямі
сыходах=зыходах|сходах|сходках|адыходах|выхадах|выйсцях
япіскап=епіскап
япіскапа=епіскапа
япіскапу=епіскапу
япіскапам=епіскапам
япіскапе=епіскапе
япіскапы=епіскапы
япіскапаў=епіскапаў
япіскапам=епіскапам
япіскапамі=епіскапамі
япіскапах=епіскапах
япіскапат=епіскапат
япіскапства=епіскапства
япіскапальны=епіскапальны
япіскапальная=епіскапальная
япіскапальнае=епіскапальнае
япіскапальныя=епіскапальныя
япіскапальнага=епіскапальнага
япіскапальнай=епіскпальнай
япіскапальных=епіскапальных
япіскапальнаму=епіскапальнаму
япіскапальнай=епіскапальнай
япіскапальную=епіскапальную
япіскапальным=епіскапальным
япіскапальнымі=епіскапальнымі

# Памылкі ў тапаніміцы
Ліцве=Літве
Глубокае=Глыбокае
Глубокага=Глыбокага
Глубокаму=Глыбокаму
Глубокім=Глыбокім
Заслаўль=Заслаўе
Заслаўле=Заслаўе
Заслаўля=Заслаўя
Заслаўлю=Заслаўю
Заслаўлем=Заслаўем
Заслаўлі=Заслаўі
Копыль=Капыль
Копыля=Капыля
Копылю=Капылю
Копылем=Капылём
Копылі=Капылю
Лукомель=Лукомль
Лукомеля=Лукомля
Лукомелю=Лукомлю
Лукомелем=Лукомлем
Лукомелі=Лукомлі
Міёры=Мёры
Міёр=Мёр|Мёраў
Міёраў=Мёраў|Мёр
Міёрам=Мёрам
Міёрамі=Мёрамі
Міёрах=Мёрах
Малорыта=Маларыта
Малорыты=Маларыты
Малорыце=Маларыце
Малорыту=Маларыту
Малорытай=Маларытай|Маларытаю
Малорытаю=Маларытай|Маларытаю
Мозыр=Мазыр
Мозыра=Мазыра
Мозыру=Мазыру
Мозырам=Мазыром
Мсціслаўль=Мсціслаў
Мсціслаўля=Мсціслава
Мсціслаўлю=Мсціславу
Мсціслаўлем=Мсціславам
Мсціслаўле=Мсціславе
Мсціслаўлі=Мсціславе
Мядзель=Мядзел
Мядзеля=Мядзела
Мядзелю=Мядзелу|Мядзелі
Мядзелем=Мядзелам
Навалукомль=Новалукомль
Навалукомель=Новалукомль
Навалукомля=Новалукомля
Навалукомеля=Новалукомля
Навалукомлю=Новалукомлю
Навалукомелю=Новалукомлю
Навалукомлем=Новалукомлем
Навалукомелем=Новалукомлем
Навалукомлі=Новалукомлі
Навалукомелі=Новалукомлі
Несвіж=Нясвіж
Несвіжа=Нясвіжа
Несвіжу=Нясвіжу
Несвіжам=Нясвіжам
Несвіжы=Нясвіжу
Стаўбцы=Стоўбцы
Стаўбцоў=Стоўбцаў
Стаўбцам=Стоўбцам
Стаўбцамі=Стоўбцамі
Стаўбцах=Стоўбцах
Скідзел=Скідзель
Скідзела=Скідзеля
Скідзелу=Скідзелю|Скідзелі
Скідзелам=Скідзелем
Скідзелы=Скідзелі
Талочын=Талачын
Талочына=Талачына
Талочыну=Талачыну
Талочынам=Талачыном
Талочыне=Талачыне
Чаўсы=Чавусы
Чаўс=Чавус|Чавусаў
Чаўсаў=Чавус|Чавусаў
Чаўсам=Чавусам
Чаўсамі=Чавусамі
Чаўсах=Чавусах

# Нелітаратурныя запазычанні
акаўнт=уліковы запіс
акаўнта=уліковага запісу
акаўнту=уліковаму запісу|уліковага запісу
акаўнтам=уліковым запісам
акаўнце=уліковым запісе
акаўнты=уліковыя запісы
акаўнтаў=уліковых запісаў
акаўнтамі=уліковымі запісамі
акаўнтах=уліковых запісах
вырабніцтва=вытворчасць|вытворчасці
вырабніцтву=вытворчасці
вырабніцтвам=вытворчасцю
вырабніцтве=вытворчасці
вырабніцтвы=вытворчасці
вырабніцтв=вытворчасцей|вытворчасцяў
вырабніцтваў=вытворчасцей|вытворчасцяў
вырабніцтвам=вытворчасцям
вырабніцтвамі=вытворчасцямі
вырабніцтвах=вытворчасцях
гуртажытак=інтэрнат
гуртажытка=інтэрната
гуртажытку=інтэрнату|інтэрната|інтэрнаце
гуртажыткам=інтэрнатам
гуртажыткі=інтэрнаты
гуртажыткаў=інтэрнатаў
гуртажыткамі=інтэрнатамі
гуртажытках=інтэрнатах
дэвайс=прылада|прыладу
дэвайса=прылады
дэвайсу=прыладзе
дэвайсам=прыладай|прыладаю
дэвайсе=прыладзе
дэвайсы=прылады
дэвайсаў=прылад
дэвайсам=прыладам
дэвайсамі=прыладамі
дэвайсах=прыладах
дыяцэзія=епархія
дыяцэзіі=епархіі
дыяцэзіяй=епархіяй|епархіяю
дыяцэзій=епархій
дыяцэзіям=епархіям
дыяцэзіямі=епархіямі
дыяцэзіях=епархіях
надзор=нагляд
надзора=нагляду
надзору=нагляду
надзорам=наглядам
надзоры=наглядзе|нагляды
надзораў=наглядаў
надзорамі=наглядамі
надзорах=наглядах
недасказанасць=недаказанасць|недагаворанасць
недасказанасці=недаказанасці|недагаворанасці
недасказанасцю=недаказанасцю|недагаворанасцю
недасказанасцяў=недаказанасцяў|недаказанасцей|недагаворанасцяў|недагаворанасцей
недасказанасцей=недаказанасцяў|недаказанасцей|недагаворанасцяў|недагаворанасцей
недасказанасцям=недаказанасцям|недагаворанасцям
недасказанасцямі=недаказанасцямі|недагаворанасцямі
недасказанасцях=недаказанасцях|недагаворанасцях
пагаворка=прымаўка
пагаворкі=прымаўкі
пагаворцы=прымаўцы
пагаворку=прымаўку
пагаворкай=прымаўкай
пагаворак=прымавак
пагаворкам=прымаўкам
пагаворкамі=прымаўкамі
пагаворках=прымаўках
прысказка=прыказка|прымаўка
прысказкі=прыказкі|прымаўкі
прысказку=прыказку|прымаўку
прысказкай=прыказкай|прымаўкай
прысказак=прыказак|прымавак
прысказкам=прыказкам|прымаўкам
прысказкамі=прыказкамі|прымаўкамі
прысказках=прыказках|прымаўках
успрыняцце=успрыманне
успрыняцця=успрымання
успрыняццю=успрыманню
успрыняццем=успрыманнем
успрыняцці=успрыманні
успрыняццяў=успрыманняў
успрыняццям=успрыманням
успрыняццямі=успрыманнямі
успрыняццях=успрыманнях
ушыб=выцятае месца|удар|выцяў|пабіў|прыбіў|ударыў
ушыбла=выцяла|пабіла|прыбіла|ударыла
ушыблі=выцялі|пабілі|прыбілі|ударылі
ушыбіць=выцяць|пабіць|прыбіць|ударыць
ушыбся=выцяўся|пабіўся|прыбіўся|ударыўся
ушыблася=выцялася|пабілася|прыбілася|ударылася
ушыбу=вытну|паб’ю|прыб’ю|удару
ушыбеш=вытнеш|паб’еш|прыб’еш|ударыш
ушыбе=вытне|паб’е|прыб’е|ударыць
ушыбем=вытнем|паб’ём|прыб’ём|ударым
ушыбуць=вытнуць|паб’юць|прыб’юць|удараць
ушыбеце=вытнеце|паб'яце|прыб’яце|ударыце
ушыбяце=вытнеце|паб'яце|прыб’яце|ударыце
ушыбецё=вытнеце|паб'яце|прыб’яце|ударыце
ушыбі=вытні|пабі|прыбі|удар
ушыбіце=вытніце|пабіце|прыбіце|ударце
ушыбшы=выцяўшы|пабіўшы|прыбіўшы|ударыўшы
чуйнік=датчык
чуйніка=датчыка
чуйніку=датчыку|датчыка
чуйнікам=датчыкам
чуйнікі=датчыкі
чуйнікаў=датчыкаў
чуйнікамі=датчыкамі
чуйніках=датчыках

# Нелітаратурныя альтэрнатыўныя словы
бамбоўка=бамбардзіроўка
бамбоўкі=бамбардзіроўкі
бамбоўку=бамбардзіроўку
бамбоўцы=бамбардзіроўцы
бамбоўке=бамбардзіроўцы
бамбоўкай=бамбардзіроўкай
бамбовак=бамбардзіровак
бамбоўкам=бамбардзіроўкам
бамбоўкамі=бамбардзіроўкамі
бамбоўках=бамбардзіроўках
крэмн=крэмній|крэм|крэн
крэмна=крэмнію|крэму|крэну
крэмну=крэмнію|крэму|крэну
крэмнам=крэмніем|крэмам|крэнам
крэмне=крэмніі|крэме|крэне
крэмнавы=крэмніевы|крэмавы
крэмнавага=крэмніевага|крэмавага|крамнага|крэўнага
крэмнага=крэмніевага|крэмавага|крамнага|крэўнага
крэмнаваму=крэмніеваму|крэмаваму
крэмнаму=крэмніеваму|крэмаваму|крамнаму|крэўнаму
крэмнавым=крэмніевым|крэмавым
крэмным=крэмавым|крэмніевым|крамным|крэўным
крэмнавыя=крэмніевыя|крэмавыя
крэмнавых=крэмніевых|крэмавых
крэмных=крэмавых|крэмніевых|крамных|крэўных
крэмнавымі=крэмніевымі|крэмавымі
крэмнымі=крэмавымі|крэмніевымі|крамнымі|крэўнымі
паказнік=паказчык|заказнік
паказніка=паказчыка|заказніка
паказніку=паказчыку|паказчыка|заказніку
паказнікам=паказчыкам|заказнікам
паказніке=паказчыку|заказніку
паказнікі=паказчыкі|заказнікі
паказнікаў=паказчыкаў|заказнікаў
паказнікамі=паказчыкамі|заказнікамі
паказніках=паказчыках|заказніках
перакладнік=перакладчык
перакладніца=перакладчыца
перакладніка=перакладчыка
перакладніцы=перакладчыцы
перакладніку=перакладчыка|перакладчыку
перакладніке=перакладчыку
перакладнікам=перакладчыкам
перакладніцай=перакладчыцай
перакладнікі=перакладчыкі
перакладнікаў=перакладчыкаў
перакладнікамі=перакладчыкамі
перакладніках=перакладчыках
перакладніцкі=перакладчыцкі
перакладніцкая=перакладчыцкая
перакладніцкае=перакладчыцкае
перакладніцкага=перакладчыцкага
перакладніцкай=перакладчыцкай
перакладніцкаму=перакладчыцкаму
перакладніцкім=перакладчыцкім
перакладніцкія=перакладчыцкія
перакладніцкіх=перакладчыцкіх
перакладніцкімі=перакладчыцкімі
слезацечны=слёзатачывы
слезацечнае=слёзатачывае
слезацечная=слёзатачывая
слезацечнага=слёзатачывага
слезацечную=слёзатачывую
слезацечнай=слёзатачывай
слезацечнаму=слёзатачываму
слезацечнай=слёзатачывай
слезацечным=слёзатачывым
слезацечныя=слёзатачывыя
слезацечных=слёзатачывых
слезацечнымі=слёзатачывымі
супраца=супрацоўніцтва
супрацы=супрацоўніцтвы|супрацоўніцтва|супрацоўніцтву|супрацоўніцтве
супрацай=супрацоўніцтвам
супрацу=супрацоўніцтва
спрац=супрацоўніцтваў
спрацаў=супрацоўніцтваў
супрацамі=супрацоўніцтвамі
супрацах=супрацоўніцтвах
экспартэр=экспарцёр
экспартэра=экспарцёра
экспартэру=экспарцёру|экспарцёра
экспартэрам=экспарцёрам
экспартэры=экспарцёры
экспартэраў=экспарцёраў
экспартэрамі=экспарцёрамі
экспартэрах=экспарцёрах

# Прастамоўе
жырны=тлусты
жырная=тлустая
жырнае=тлустае
жырнага=тлустага
жырнай=тлустай
жырным=тлустым
жырныя=тлустыя
жырных=тлустых
жырнымі=тлустымі
пасловіца=прыказка
пасловіцы=прыказкі
пасловіцу=прыказку
пасловіцай=прыказкай
пасловіц=прыказак
пасловіцам=прыказкам
пасловіцамі=прыказкамі
пасловіцах=прыказках
тэж=таксама

# Нязграбныя дзеепрыметнікі
працягваючыся=працягваючы|трывалы|трываючы|працяглы|пастаянны|сталы|безупынны|няўхільны|заўсёдны|устойлівы|які працягваецца
працягваючася=трывалая|працяглая|пастаянная|сталая|безупынная|няўхільная|заўсёдная|устойлівая|якая працягваецца
працягваючаяся=трывалая|працяглая|пастаянная|сталая|безупынная|няўхільная|заўсёдная|устойлівая|якая працягваецца
працягваючыяся=трывалая|працяглая|пастаянная|сталая|безупынная|няўхільная|заўсёдная|устойлівая|якая працягваецца
працягваючаеся=трывалае|працяглае|пастаяннае|сталае|безупыннае|няўхільнае|заўсёднае|устойлівае|якое працягваецца
працягваючыеся=трывалае|працяглае|пастаяннае|сталае|безупыннае|няўхільнае|заўсёднае|устойлівае|якое працягваецца
працягваючагася=трывалага|працяглага|пастаяннага|сталага|безупыннага|няўхільнага|заўсёднага|устойлівага
працягваючыгася=трывалага|працяглага|пастаяннага|сталага|безупыннага|няўхільнага|заўсёднага|устойлівага
працягваючайся=трывалай|працяглай|пастаяннай|сталай|безупыннай|няўхільнай|заўсёднай|устойлівай
працягваючыйся=трывалай|працяглай|пастаяннай|сталай|безупыннай|няўхільнай|заўсёднай|устойлівай
працягваючамуся=трываламу|працягламу|пастаяннаму|сталаму|безупыннаму|няўхільнаму|заўсёднаму|устойліваму
працягваючымуся=трываламу|працягламу|пастаяннаму|сталаму|безупыннаму|няўхільнаму|заўсёднаму|устойліваму
працягваючымся=трывалым|працяглым|пастаянным|сталым|безупынным|няўхільным|заўсёдным|устойлівым
працягваючамся=трывалым|працяглым|пастаянным|сталым|безупынным|няўхільным|заўсёдным|устойлівым
працягваючымся=трывалым|працяглым|пастаянным|сталым|безупынным|няўхільным|заўсёдным|устойлівым
працягваючыеся=трывалыя|працяглыя|пастаянныя|сталыя|безупынныя|няўхільныя|заўсёдныя|устойлівыя|якія працягваюцца
працягваючыяся=трывалыя|працяглыя|пастаянныя|сталыя|безупынныя|няўхільныя|заўсёдныя|устойлівыя|якія працягваюцца
працягваючыхся=трывалых|працяглых|пастаянных|сталых|безупынных|няўхільных|заўсёдных|устойлівых
працягваючахся=трывалых|працяглых|пастаянных|сталых|безупынных|няўхільных|заўсёдных|устойлівых
працягваючыміся=трывалымі|працяглымі|пастаяннымі|сталымі|безупыннымі|няўхільнымі|заўсёднымі|устойлівымі

# Памылкі ў склонах
машынаў=машын
мікрасхемаў=мікрасхем
міляў=міль
мужчынаў=мужчын
падзякаў=падзяк
прэміяў=прэмій
прыладаў=прылад
мікрасхемаў=мікрасхем
серыяў=серый
словаў=слоў
спіной=спінай
тэкста=тэкст|тэксту|тэкстам
фармата=фармат|фармату|фарматам

# Памылкі ў спражэнні
мучаюць=мучаць|лучаюць|мачаюць|мукаюць
мучыюць=мучаць|мучыць

# Памылкі словаўтварэння
несалодка=нясоладка|несалодкае|несалодкая|несалодкай|несалодкаю|несалодкі

# Змяшанае
белка=вавёрка|бялка
белку=вавёрку|бялку
белцы=вавёрцы
белком=бялком
белке=бялку|вавёрцы
белку=бялку|вавёрку
белкі=вавёркі|бялкі
белак=вавёрак|бялкоў
белкаў=вавёрак|бялкоў
белках=вавёрках|бялках
