# General replacement rules, used by org.languagetool.rules.en.SimpleReplaceRule
# Format: UTF-8, one entry per line in format: phrase=replacement
# 'phrase' is what the text is searched for. 'replacement' is the suggestion shown to the user.
# 'phrase' is searched for case-insensitively.
# Both 'phrase' and 'replacement' can contain more than one value when separated by '|'.
# Example:
# incorrect=suggestion one|suggestion two
y'en=y en
jai=j'ai
ca=ça|CA
journé=journée|ajourné
boton=bouton|bâton|béton|Boston
qu=que|qu'
#puisqu=puisque|puisqu'
aus=aux|au|os
pa=pas
puit=puits
antitartre=détartrant
construirent=construisirent
alloo=allô|allo
ceque=ce que
language=langage
á=à
seluit=celui
compren=comprend|comprends|comprenne
autotamponneuse=auto-tamponneuse|auto tamponneuse
autotamponneuses=autos-tamponneuses|autos tamponneuses
lair=l'air|air|clair|lait|pair|laïc
dair=d'air|air|pair
#june=juin
malgrés=malgré
parmis=parmi|partis|permis|Paris
colisé=Colisée
bon fin de journée=bonne fin de journée
citoillien=citoyen
citoilliens=citoyens
étre=être
trés=très
quizz=quiz