# A part-of-speech dictionary that's used additionally to the binary dictionary (*.dict).
# This does not add words to the spell checker, see hunspell/spelling.txt for that.
# File Encoding: UTF-8
# Format: three tab-separated fields: fullform baseform postags
#from Freeling
'en	en	R pers obj 3 sp
'y	y	R pers obj 3 sp
-ce	ce	R dem m s
-elle	elle	R pers suj 3 f s
-elles	elles	R pers suj 3 f p
-en	en	R pers obj 3 sp
-il	il	R pers suj 3 m s
-ils	ils	R pers suj 3 m p
-je	je	R pers suj 1 s
-la	le	R pers obj 3 f s
-le	le	R pers obj 3 m s
-les	les	R pers obj 3 e p
-leur	leur	R pers obj 3 e p
-lui	lui	R pers obj 3 m s
-m	me	R pers obj 1 s
-m'	me	R pers obj 1 s
-moi	moi	R pers obj 1 s
-nous	nous	R pers obj 1 p
-nous	nous	R pers suj 1 p
-on	on	R pers suj 3 e s
-t	te	R pers obj 2 s
-t'	te	R pers obj 2 s
-t-elle	elle	R pers suj 3 f s
-t-elles	elles	R pers suj 3 p
-t-il	il	R pers suj 3 m s
-t-ils	ils	R pers suj 3 m p
-t-on	on	R pers suj 3 e s
-toi	toi	R pers obj 2 s
-tu	tu	R pers suj 2 s
-vous	vous	R pers obj 2 p
-vous	vous	R pers suj 2 p
-vs	vs	R pers suj 2 p
-vs	vs	R pers obj 2 p
-y	y	R pers obj
afin	afin	P
au	à+le	P+D m s
aucune	aucun	R f s
aucunes	aucun	R f p
aucuns	aucun	R m p
auquel	à+lequel	P+R rel m s
autre	autre	R e s
autres	autre	R e p
autrui	autrui	R
aux	à+les	P+D e p
auxquelles	à+lequel	P+R rel f p
auxquels	à+lequel	P+R rel m p
avt	avant	P
because	because	C sub
c'	ce	R dem m s
celle-ci	celui-ci	R dem f s
celle-là	celui-là	R dem f s
celles	celui	R dem f p
celles-ci	celui-ci	R dem f p
celles-là	celui-là	R dem f p
#certaines	certains	R f p
#certains	certains	R m p
ces	ce	D e p
cet	ce	D m s
cette	ce	D f s
ceux	celui	R dem m p
ceux-ci	celui-ci	R dem m p
ceux-là	celui-là	R dem m p
cf	cf	P
chacune	chacun	R f s
ci-devant	ci-devant	P
comme	comme	C coor
comme	comme	P
comme	comme	A
confer	cf	P
ct'	ce	D m s
d'	de	D e s
d'	de	P
des	de+les	P+D e p
des	un	D e p
desquelles	de+lequel	P+R rel f p
desquels	de+lequel	P+R rel m p
du	de+le	P+D m s
du	du	D m s
duquel	de+lequel	P+R rel m s
dès	dès	P
et-ou	et-ou	C coor
icelle	icelui	D f s
icelle	icelui	R dem f s
icelles	icelui	D f p
icelles	icelui	R dem f p
icelui	icelui	D m s
icelui	icelui	R dem m s
iceux	icelui	D m p
iceux	icelui	R dem m p
j'	je	R pers suj 1 s
jusqu'	jusque	P
jusqu'au	jusqu'à+le	P+D m s
jusqu'aux	jusqu'à+les	P+D e p
jusqu'à	jusqu'à	P
l'	le	D e s
l'	le	R pers obj 3 e s
l'on	on	R pers suj 3 e p
la	le	D f s
la	le	R pers obj 3 f s
la	la	N m sp
laquelle	lequel	D f s
laquelle	lequel	R rel f s
ledit	ledit	D m s
lequel	lequel	D m s
lequel	lequel	R rel m s
les	le	D e p
les	les	R pers obj 3 e p
lesdites	ledit	D f p
lesdits	ledit	D m p
lesquelles	lequel	D f p
lesquelles	lequel	R rel f p
lesquels	lequel	D m p
lesquels	lequel	R rel m p
lez	lès	P
lorsqu'	lorsque	C sub
m'	me	R pers obj 1 s
ma	mon	D f s
mes	mon	D e p
moi-même	lui-même	R pers obj 1 s
moyennant	moyennant	P
n'	ne	A
notres	notre	D e s
pareil	pareil	D m s
pareille	pareil	D f s
pareilles	pareil	D f p
pareils	pareil	D m p
partant	partant	C sub
pdt	pendant	P
#plusieurs	plusieurs	R e p
puis	puis	C sub
puis	puis	A
puis	pouvoir	V ind pres 1 s
puisqu'	puisque	C sub
qd	quand	C sub
qq	quelque	D e s
qqes	quelque	D e p
qqs	quelque	D e p
#qu'	que	A
#que	que	A
que	que	C sub
qu'	que	C sub
#que	que	R e sp
#qu'	que	R e sp
#que	que	R inte
#qu'	que	R inte
#que	que	R rel e sp
#qu'	que	R rel e sp
quand	quand	A inte
quand	quand	C sub
quel	quel	R m s
quel	quel	R rel m s
quelle	quel	R f s
quelle	quel	R rel f s
quelles	quel	R f p
quelles	quel	R rel f p
quelqu'	quelque	D e s
quelqu'un	quelqu'un	R m s
quelqu'une	quelqu'un	R f s
quelques-unes	quelqu'un	R f o
quelques-uns	quelqu'un	R m p
quels	quel	R m p
quels	quel	R rel m p
quiconque	quiconque	R e s
quoiqu'	quoique	C sub
s'	se	R pers obj 3 e sp
s'	si	C sub
sa	son	D f s
ses	son	D e p
sinon	sinon	C Coor
t'	te	R pers obj 2 s
ta	ton	D f s
tel	tel	R m s
telle	tel	R f s
telles	tel	R f p
tels	tel	R m p
tes	ton	D e p
un	un	R m s
une	un	D f s
une	un	R f s
unes	un	R f p
uns	un	R m p
versus	vs	P
voire	voire	C Coor
vos	votre	D e p
vot'	votre	D e p
vot'	votre	D e s
votre	votre	J e s
votres	votre	J e p
y	y	R pers obj 3 sp
ça	cela	R dem m s
ès	en+les	P+D e p
grand-parent	grand-parent	N m s
grand-parents	grand-parent	N m p
mini-disque	mini-disque	N m s
mini-disques	mini-disque	N m p
Strauss-Kahn	Strauss-Kahn	Z e sp
Spider-Man	Spider-Man	Z e sp
presse-ail	presse-ail	N m s
sourd-muet	sourd-muet	J m s
sourd-muets	sourd-muet	J m p
sourd-muette	sourd-muet	J f s
sourd-muettes	sourd-muet	J f p
épeurant	épeurant	J m s
épeurants	épeurant	J m p
épeurante	épeurant	J f s
épeurantes	épeurant	J f p
cinquante-et-un	cinquante-et-un	D m p
cinquante-et-une	cinquante-et-un	D f p
huitante-et-un	huitante-et-un	D m p
huitante-et-une	huitante-et-un	D f p
nonante-et-un	nonante-et-un	D m p
nonante-et-une	nonante-et-un	D f p
octante-et-un	octante-et-un	D m p
octante-et-une	octante-et-un	D f p
quarante-et-un	quarante-et-un	D m p
quarante-et-une	quarante-et-un	D f p
septante-et-un	septante-et-un	D m p
septante-et-une	septante-et-un	D f p
soixante-et-un	soixante-et-un	D m p
soixante-et-une	soixante-et-un	D f p
trente-et-un	trente-et-un	D m p
trente-et-une	trente-et-un	D f p
vingt-et-un	vingt-et-un	D m p
vingt-et-une	vingt-et-un	D f p
sous-espace	sous-espace	N m s
sous-espaces	sous-espace	N m p
MPEG-4	MPEG-4	N e sp
dent-de-lion	dent-de-lion	N f s
dent-de-lions	dent-de-lion	N f p
nid-de-poule	nid-de-poule	N m s
nid-de-poules	nid-de-poule	N m p
fouille-merde	fouille-merde	N m s
fouille-merdes	fouille-merde	N m p
garde-à-vous	garde-à-vous	N m sp
expert-comptable	expert-comptable	N e s
expert-comptables	expert-comptable	N e p
haute-technologie	haute-technologie	J e sp
cache-tétons	cache-tétons	N m sp
kilo-octet	kilo-octet	N m s
kilo-octets	kilo-octet	N m p
Charles-Magne	Charles-Magne	Z m s
Charles-magne	Charles-magne	Z m s
Hault-Volta	Hault-Volta	Z f s

#fixes to be done in Dicollecte
thérémine	thérémine	N m s
thérémines	thérémine	N m p
TPE	TPE	N e sp
Colo-Colo	Colo-Colo	Z e sp
cd-rom	cd-rom	M nonfin
CD-Rom	CD-Rom	M nonfin
Côtes-du-Rhône	Côtes-du-Rhône	Z f p
Côtes-du-Vivarais	Côtes-du-Vivarais	Z f p
Nouvelle-Angleterre	Nouvelle-Angleterre	Z f s
Grand-Place	Grand-Place	Z f s
anime	anime	N m s
animes	anime	N m p
carbone-carbone	carbone-carbone	J e sp
carbone-oxygène	carbone-oxygène	J e sp
carbone-hydrogène	carbone-hydrogène	J e sp

#from Dicollecte with typewriter apostrophe
Berre-l'Étang	Berre-l'Étang	Z e sp
Bois-d'Arcy	Bois-d'Arcy	Z e sp
Braine-l'Alleud	Braine-l'Alleud	Z e sp
Bruay-sur-l'Escaut	Bruay-sur-l'Escaut	Z e sp
Cantons-de-l'Est	Cantons-de-l'Est	N m p
Château-d'Olonne	Château-d'Olonne	Z e sp
Château-d'Œx	Château-d'Œx	Z e sp
Cléon-d'Andran	Cléon-d'Andran	Z e sp
Condé-sur-l'Escaut	Condé-sur-l'Escaut	Z e sp
Cournon-d'Auvergne	Cournon-d'Auvergne	Z e sp
Côte-d'Or	Côte-d'Or	N f sp
D'Holbach	D'Holbach	Z e sp
Fontaine-l'Évêque	Fontaine-l'Évêque	Z e sp
Isle-d'Abeau	Isle-d'Abeau	Z e sp
K'nex	K'nex	Z m sp
Morne-à-l'Eau	Morne-à-l'Eau	Z e sp
N'Djamena	N'Djamena	Z e sp
R'lyeh	R'lyeh	Z e sp
R'n'B	R'n'B	N m sp
Sables-d'Olonne	Sables-d'Olonne	Z e sp
Saint-Cyr-l'École	Saint-Cyr-l'École	Z e sp
Saint-Denis-d'Anjou	Saint-Denis-d'Anjou	Z e sp
Saint-Martin-d'Hères	Saint-Martin-d'Hères	Z e sp
Saint-Ouen-l'Aumône	Saint-Ouen-l'Aumône	Z e sp
Tain-l'Hermitage	Tain-l'Hermitage	Z e sp
Val-d'Oise	Val-d'Oise	N m sp
Val-d'Or	Val-d'Or	Z e sp
Ville-d'Avray	Ville-d'Avray	Z e sp
Villenave-d'Ornon	Villenave-d'Ornon	Z e sp
Villeneuve-d'Ascq	Villeneuve-d'Ascq	Z e sp
Xi'an	Xi'an	Z e sp
aujourd'hui	aujourd'hui	A
baha'i	baha'i	J m s
baha'i	baha'i	N m s
baha'ie	baha'i	J f s
baha'ie	baha'i	N f s
baha'ies	baha'i	J f p
baha'ies	baha'i	N f p
baha'is	baha'i	J m p
baha'is	baha'i	N m p
baha'isme	baha'isme	N m s
baha'ismes	baha'isme	N m p
bernard-l'ermite	bernard-l'ermite	N m sp
bernard-l'hermite	bernard-l'hermite	N m sp
bin's	bin's	N m sp
bouton-d'argent	bouton-d'argent	N m s
bouton-d'or	bouton-d'or	N m s
boutons-d'argent	boutons-d'argent	N m p
boutons-d'or	bouton-d'or	N m p
chef-d'œuvre	chef-d'œuvre	N m s
chefs-d'œuvre	chef-d'œuvre	N m p
ch'timi	ch'timi	J e s
ch'timi	ch'timi	N e s
ch'timis	ch'timi	J e p
ch'timis	ch'timi	N e p
coq-à-l'âne	coq-à-l'âne	N m sp
c'est-à-dire	c'est-à-dire	C coor
dos-d'âne	dos-d'âne	N m sp
droit-de-l'hommisme	droit-de-l'hommisme	N m s
droit-de-l'hommismes	droit-de-l'hommisme	N m p
droit-de-l'hommiste	droit-de-l'hommiste	J e s
droit-de-l'hommiste	droit-de-l'hommiste	N e s
droit-de-l'hommistes	droit-de-l'hommiste	J e p
droit-de-l'hommistes	droit-de-l'hommiste	N e p
duc-d'Albe	duc-d'Albe	N m s
ducs-d'Albe	ducs-d'Albe	N m p
d'aucuns	d'aucuns	R m p
entr'aima	entr'aimer	V ind psim 3 s
entr'aimaient	entr'aimer	V ind impa 3 p
entr'aimait	entr'aimer	V ind impa 3 s
entr'aimant	entr'aimer	V ppr
entr'aimassent	entr'aimer	V sub impa 3 p
entr'aimassiez	entr'aimer	V sub impa 2 p
entr'aimassions	entr'aimer	V sub impa 1 p
entr'aime	entr'aimer	V ind pres 3 s
entr'aime	entr'aimer	V sub pres 3 s
entr'aiment	entr'aimer	V ind pres 3 p
entr'aiment	entr'aimer	V sub pres 3 p
entr'aimer	entr'aimer	V inf
entr'aimera	entr'aimer	V ind futu 3 s
entr'aimeraient	entr'aimer	V con pres 3 p
entr'aimerait	entr'aimer	V con pres 3 s
entr'aimerez	entr'aimer	V ind futu 2 p
entr'aimeriez	entr'aimer	V con pres 2 p
entr'aimerions	entr'aimer	V con pres 1 p
entr'aimerons	entr'aimer	V ind futu 1 p
entr'aimeront	entr'aimer	V ind futu 3 p
entr'aimez	entr'aimer	V imp pres 2 p
entr'aimez	entr'aimer	V ind pres 2 p
entr'aimiez	entr'aimer	V ind impa 2 p
entr'aimiez	entr'aimer	V sub pres 2 p
entr'aimions	entr'aimer	V ind impa 1 p
entr'aimions	entr'aimer	V sub pres 1 p
entr'aimons	entr'aimer	V imp pres 1 p
entr'aimons	entr'aimer	V ind pres 1 p
entr'aimâmes	entr'aimer	V ind psim 1 p
entr'aimât	entr'aimer	V sub impa 3 s
entr'aimâtes	entr'aimer	V ind psim 2 p
entr'aimèrent	entr'aimer	V ind psim 3 p
entr'aimé	entr'aimer	J m s
entr'aimé	entr'aimer	V ppa m s
entr'aimée	entr'aimer	J f s
entr'aimée	entr'aimer	V ppa f s
entr'aimées	entr'aimer	J f p
entr'aimées	entr'aimer	V ppa f p
entr'aimés	entr'aimer	J m p
entr'aimés	entr'aimer	V ppa m p
entr'apercevaient	entr'apercevoir	V ind impa 3 p
entr'apercevais	entr'apercevoir	V ind impa 1 s
entr'apercevais	entr'apercevoir	V ind impa 2 s
entr'apercevait	entr'apercevoir	V ind impa 3 s
entr'apercevant	entr'apercevoir	V ppr
entr'apercevez	entr'apercevoir	V imp pres 2 p
entr'apercevez	entr'apercevoir	V ind pres 2 p
entr'aperceviez	entr'apercevoir	V ind impa 2 p
entr'aperceviez	entr'apercevoir	V sub pres 2 p
entr'apercevions	entr'apercevoir	V ind impa 1 p
entr'apercevions	entr'apercevoir	V sub pres 1 p
entr'apercevoir	entr'apercevoir	V inf
entr'apercevons	entr'apercevoir	V imp pres 1 p
entr'apercevons	entr'apercevoir	V ind pres 1 p
entr'apercevra	entr'apercevoir	V ind futu 3 s
entr'apercevrai	entr'apercevoir	V ind futu 1 s
entr'apercevraient	entr'apercevoir	V con pres 3 p
entr'apercevrais	entr'apercevoir	V con pres 1 s
entr'apercevrais	entr'apercevoir	V con pres 2 s
entr'apercevrait	entr'apercevoir	V con pres 3 s
entr'apercevras	entr'apercevoir	V ind futu 2 s
entr'apercevrez	entr'apercevoir	V ind futu 2 p
entr'apercevriez	entr'apercevoir	V con pres 2 p
entr'apercevrions	entr'apercevoir	V con pres 1 p
entr'apercevrons	entr'apercevoir	V ind futu 1 p
entr'apercevront	entr'apercevoir	V ind futu 3 p
entr'aperçois	entr'apercevoir	V imp pres 2 s
entr'aperçois	entr'apercevoir	V ind pres 1 s
entr'aperçois	entr'apercevoir	V ind pres 2 s
entr'aperçoit	entr'apercevoir	V ind pres 3 s
entr'aperçoive	entr'apercevoir	V sub pres 1 s
entr'aperçoive	entr'apercevoir	V sub pres 3 s
entr'aperçoivent	entr'apercevoir	V ind pres 3 p
entr'aperçoivent	entr'apercevoir	V sub pres 3 p
entr'aperçoives	entr'apercevoir	V sub pres 2 s
entr'aperçu	entr'apercevoir	J m s
entr'aperçu	entr'apercevoir	V ppa m s
entr'aperçue	entr'apercevoir	J f s
entr'aperçue	entr'apercevoir	V ppa f s
entr'aperçues	entr'apercevoir	J f p
entr'aperçues	entr'apercevoir	V ppa f p
entr'aperçurent	entr'apercevoir	V ind psim 3 p
entr'aperçus	entr'apercevoir	J m p
entr'aperçus	entr'apercevoir	V ind psim 1 s
entr'aperçus	entr'apercevoir	V ind psim 2 s
entr'aperçus	entr'apercevoir	V ppa m p
entr'aperçusse	entr'apercevoir	V sub impa 1 s
entr'aperçussent	entr'apercevoir	V sub impa 3 p
entr'aperçusses	entr'apercevoir	V sub impa 2 s
entr'aperçussiez	entr'apercevoir	V sub impa 2 p
entr'aperçussions	entr'apercevoir	V sub impa 1 p
entr'aperçut	entr'apercevoir	V ind psim 3 s
entr'aperçûmes	entr'apercevoir	V ind psim 1 p
entr'aperçût	entr'apercevoir	V sub impa 3 s
entr'aperçûtes	entr'apercevoir	V ind psim 2 p
entr'hiverner	entr'hiverner	V inf
entr'ouvert	entr'ouvrir	J m s
entr'ouvert	entr'ouvrir	V ppa m s
entr'ouverte	entr'ouvrir	J f s
entr'ouverte	entr'ouvrir	V ppa f s
entr'ouvertes	entr'ouvrir	J f p
entr'ouvertes	entr'ouvrir	V ppa f p
entr'ouverts	entr'ouvrir	J m p
entr'ouverts	entr'ouvrir	V ppa m p
entr'ouvraient	entr'ouvrir	V ind impa 3 p
entr'ouvrais	entr'ouvrir	V ind impa 1 s
entr'ouvrais	entr'ouvrir	V ind impa 2 s
entr'ouvrait	entr'ouvrir	V ind impa 3 s
entr'ouvrant	entr'ouvrir	V ppr
entr'ouvre	entr'ouvrir	V imp pres 2 s
entr'ouvre	entr'ouvrir	V ind pres 1 s
entr'ouvre	entr'ouvrir	V ind pres 3 s
entr'ouvre	entr'ouvrir	V sub pres 1 s
entr'ouvre	entr'ouvrir	V sub pres 3 s
entr'ouvrent	entr'ouvrir	V ind pres 3 p
entr'ouvrent	entr'ouvrir	V sub pres 3 p
entr'ouvres	entr'ouvrir	V ind pres 2 s
entr'ouvrez	entr'ouvrir	V imp pres 2 p
entr'ouvrez	entr'ouvrir	V ind pres 2 p
entr'ouvriez	entr'ouvrir	V ind impa 2 p
entr'ouvriez	entr'ouvrir	V sub pres 2 p
entr'ouvrions	entr'ouvrir	V ind impa 1 p
entr'ouvrions	entr'ouvrir	V sub pres 1 p
entr'ouvrir	entr'ouvrir	V inf
entr'ouvrira	entr'ouvrir	V ind futu 3 s
entr'ouvrirai	entr'ouvrir	V ind futu 1 s
entr'ouvriraient	entr'ouvrir	V con pres 3 p
entr'ouvrirais	entr'ouvrir	V con pres 1 s
entr'ouvrirais	entr'ouvrir	V con pres 2 s
entr'ouvrirait	entr'ouvrir	V con pres 3 s
entr'ouvriras	entr'ouvrir	V ind futu 2 s
entr'ouvrirent	entr'ouvrir	V ind psim 3 p
entr'ouvrirez	entr'ouvrir	V ind futu 2 p
entr'ouvririez	entr'ouvrir	V con pres 2 p
entr'ouvririons	entr'ouvrir	V con pres 1 p
entr'ouvrirons	entr'ouvrir	V ind futu 1 p
entr'ouvriront	entr'ouvrir	V ind futu 3 p
entr'ouvris	entr'ouvrir	V ind psim 1 s
entr'ouvris	entr'ouvrir	V ind psim 2 s
entr'ouvrisse	entr'ouvrir	V sub impa 1 s
entr'ouvrissent	entr'ouvrir	V sub impa 3 p
entr'ouvrisses	entr'ouvrir	V sub impa 2 s
entr'ouvrissiez	entr'ouvrir	V sub impa 2 p
entr'ouvrissions	entr'ouvrir	V sub impa 1 p
entr'ouvrit	entr'ouvrir	V ind psim 3 s
entr'ouvrons	entr'ouvrir	V imp pres 1 p
entr'ouvrons	entr'ouvrir	V ind pres 1 p
entr'ouvrîmes	entr'ouvrir	V ind psim 1 p
entr'ouvrît	entr'ouvrir	V sub impa 3 s
entr'ouvrîtes	entr'ouvrir	V ind psim 2 p
entr'égorge	entr'égorger	V ind pres 3 s
entr'égorge	entr'égorger	V sub pres 3 s
entr'égorgea	entr'égorger	V ind psim 3 s
entr'égorgeaient	entr'égorger	V ind impa 3 p
entr'égorgeait	entr'égorger	V ind impa 3 s
entr'égorgeant	entr'égorger	V ppr
entr'égorgeassent	entr'égorger	V sub impa 3 p
entr'égorgeassiez	entr'égorger	V sub impa 2 p
entr'égorgeassions	entr'égorger	V sub impa 1 p
entr'égorgent	entr'égorger	V ind pres 3 p
entr'égorgent	entr'égorger	V sub pres 3 p
entr'égorgeons	entr'égorger	V imp pres 1 p
entr'égorgeons	entr'égorger	V ind pres 1 p
entr'égorger	entr'égorger	V inf
entr'égorgera	entr'égorger	V ind futu 3 s
entr'égorgeraient	entr'égorger	V con pres 3 p
entr'égorgerait	entr'égorger	V con pres 3 s
entr'égorgerez	entr'égorger	V ind futu 2 p
entr'égorgeriez	entr'égorger	V con pres 2 p
entr'égorgerions	entr'égorger	V con pres 1 p
entr'égorgerons	entr'égorger	V ind futu 1 p
entr'égorgeront	entr'égorger	V ind futu 3 p
entr'égorgez	entr'égorger	V imp pres 2 p
entr'égorgez	entr'égorger	V ind pres 2 p
entr'égorgeâmes	entr'égorger	V ind psim 1 p
entr'égorgeât	entr'égorger	V sub impa 3 s
entr'égorgeâtes	entr'égorger	V ind psim 2 p
entr'égorgiez	entr'égorger	V ind impa 2 p
entr'égorgiez	entr'égorger	V sub pres 2 p
entr'égorgions	entr'égorger	V ind impa 1 p
entr'égorgions	entr'égorger	V sub pres 1 p
entr'égorgèrent	entr'égorger	V ind psim 3 p
entr'égorgé	entr'égorger	J m s
entr'égorgé	entr'égorger	V ppa m s
entr'égorgée	entr'égorger	J f s
entr'égorgée	entr'égorger	V ppa f s
entr'égorgées	entr'égorger	J f p
entr'égorgées	entr'égorger	V ppa f p
entr'égorgés	entr'égorger	J m p
entr'égorgés	entr'égorger	V ppa m p
feda'i	feda'i	N m s
fedda'i	fedda'i	N m s
fin'amor	fin'amor	N e s
fin'amors	fin'amor	N e p
hors-d'œuvre	hors-d'œuvre	N m sp
inch'Allah	inch'Allah	I
je-m'en-fichisme	je-m'en-fichisme	N m s
je-m'en-fichismes	je-m'en-fichisme	N m p
je-m'en-fichiste	je-m'en-fichiste	J e s
je-m'en-fichiste	je-m'en-fichiste	N e s
je-m'en-fichistes	je-m'en-fichiste	J e p
je-m'en-fichistes	je-m'en-fichiste	N e p
je-m'en-foutisme	je-m'en-foutisme	N m s
je-m'en-foutismes	je-m'en-foutisme	N m p
je-m'en-foutiste	je-m'en-foutiste	J e s
je-m'en-foutiste	je-m'en-foutiste	N e s
je-m'en-foutistes	je-m'en-foutiste	J e p
je-m'en-foutistes	je-m'en-foutiste	N e p
jusqu'au-boutisme	jusqu'au-boutisme	N m s
jusqu'au-boutismes	jusqu'au-boutisme	N m p
jusqu'au-boutiste	jusqu'au-boutiste	N e s
jusqu'au-boutistes	jusqu'au-boutiste	N e p
main-d'œuvre	main-d'œuvre	N f s
mains-d'œuvre	mains-d'œuvre	N f p
mam'selle	mam'selle	N f s
mam'selles	mam'selle	N f p
mam'zelle	mam'zelle	N f s
mam'zelles	mam'zelle	N f p
monte-en-l'air	monte-en-l'air	N e sp
m'as-tu-vu	m'as-tu-vu	N e sp
nid-d'abeilles	nid-d'abeilles	N m s
nids-d'abeilles	nids-d'abeilles	N m p
n'importe	n'importe	R
pas-d'âne	pas-d'âne	N m sp
patte-d'oie	patte-d'oie	N f s
pattes-d'oie	pattes-d'oie	N f p
petit-déj	petit-déj'	N m s
pied-d'alouette	pied-d'alouette	N m s
pied-d'oiseau	pied-d'oiseau	N m s
pieds-d'alouette	pieds-d'alouette	N m p
pieds-d'oiseau	pieds-d'oiseau	N m p
pin's	pin's	N m sp
pont-l'évêque	pont-l'évêque	N m sp
presqu'ile	presqu'ile	N f s
presqu'iles	presqu'ile	N f p
presqu'île	presqu'île	N f s
presqu'îles	presqu'île	N f p
prim'Holstein	prim'Holstein	J e sp
prim'Holstein	prim'Holstein	N e sp
prud'homal	prud'homal	J m s
prud'homale	prud'homal	J f s
prud'homales	prud'homal	J f p
prud'homaux	prud'homal	J m p
prud'homie	prud'homie	N f s
prud'homies	prud'homie	N f p
prud'homme	prud'homme	N m s
prud'hommes	prud'homme	N m p
p'tit	p'tit	J m s
p'tit	p'tit	N m s
p'tite	p'tit	J f s
p'tite	p'tit	N f s
p'tites	p'tit	J f p
p'tites	p'tit	N f p
p'tits	p'tit	J m p
p'tits	p'tit	N m p
quelqu'un	quelqu'un	R m s
quelqu'une	quelqu'une	R f s
queue-d'aronde	queue-d'aronde	N f s
queues-d'aronde	queues-d'aronde	N f s
qu'en-dira-t-on	qu'en-dira-t-on	N m sp
rock'n'roll	rock'n'roll	N m sp
sot-l'y-laisse	sot-l'y-laisse	N m sp
s'abader	s'abader	V inf
s'abriller	s'abriller	V inf
s'agir	s'agir	V inf
s'agira	s'agir	V ind futu 3 s
s'agirait	s'agir	V con pres 3 s
s'agissait	s'agir	V ind impa 3 s
s'agissant	s'agir	V ppr
s'agisse	s'agir	V sub pres 3 s
s'agit	s'agir	V ind pres 3 s
s'agît	s'agir	V sub impa 3 s
tape-à-l'œil	tape-à-l'œil	J e sp
tire-d'aile	tire-d'aile	A
tire-l'œil	tire-l'œil	N m sp
tout-à-l'égout	tout-à-l'égout	N m sp
traveler's	traveler's	J e sp
traveller's	traveller's	J e sp
trompe-l'œil	trompe-l'œil	N m s
tue-l'amour	tue-l'amour	N m sp
vau-l'eau	vau-l'eau	A
maman	maman	N f s
mamans	maman	N f p
papa	papa	N m s
papas	papa	N m p
dérapement	dérapement	N m s
dérapements	dérapement	N m p
1ère	1ère	N f s
ok	ok	N e sp
Ok	Ok	N e sp
Assécheur	Assécheur	N m s
Assécheurs	Assécheur	N m p
Edouard	Edouard	N m sp
T2	T2	N m s
A4	A4	N e sp
A5	A5	N e sp
L3	L3	N e sp
P7	P7	N e sp
LeBlanc	LeBlanc	Z e s
App	App	N f s
Apps	App	N f p
email	email	N m s
emails	email	N m p
d'Harvard	d'Harvard	Z e SP
truffade	truffade	N f s
truffades	truffade	N f p
CROUS	CROUS	N m s
PMR	PMR	N f sp
Dailymotion	Dailymotion	Z m sp
Nutella	Nutella	Z e s
OPCA	OPCA	N m sp
CPE	CPE	N e sp
Darty	Darty	Z e s
gaming	gaming	N m s
coronavirus	coronavirus	N m sp
covid	covid	N e s
covid-19	covid-19	N e s
Covid	Covid	N e s
Covid-19	Covid-19	N e s
COVID	COVID	N e s
COVID-19	COVID-19	N e s
Darty	Darty	Z m s
hello	hello	N m s
dématérialisable	dématérialisable	J e s
dématérialisable	dématérialisable	J e p
CEST	CEST	Z e sp
CET	CET	Z e sp
ADT	ADT	Z e sp
EDT	EDT	Z e sp
CDT	CDT	Z e sp
PDT	PDT	Z e sp
BST	BST	Z e sp
WEST	WEST	Z e sp
EEST	EEST	Z e sp
AEST	AEST	Z e sp
ACST	ACST	Z e sp
AWST	AWST	Z e sp
WAT	WAT	Z e sp
CAT	CAT	Z e sp
EAT	EAT	Z e sp
